companyname,numberoftransaction,maxprice,minprice,closingprice,tradedshares,amount,previousclosing,difference,date
Agriculture Development Bank Limited,40,690,677,685,14290,9764487,680,5,2016-05-23
Agriculture Development Bank Limited,49,695,685,690,7665,5286530,685,5,2016-05-24
Agriculture Development Bank Limited,43,692,671,682,13438,9073302,690,-8,2016-05-25
Agriculture Development Bank Limited,25,689,657,679,5751,3902538,682,-3,2016-05-26
Agriculture Development Bank Limited,42,679,660,679,10097,6749106,679,0,2016-05-29
Agriculture Development Bank Limited,31,679,665,666,6432,4287041,679,-13,2016-05-30
Agriculture Development Bank Limited,33,667,653,659,7732,5098912,666,-7,2016-05-31
Agriculture Development Bank Limited,51,665,648,656,10461,6845190,659,-3,2016-06-01
Agriculture Development Bank Limited,60,682,656,668,14888,9934706,656,12,2016-06-02
Agriculture Development Bank Limited,63,674,650,668,8658,5735256,668,0,2016-06-05
Agriculture Development Bank Limited,25,670,647,670,4113,2726752,668,2,2016-06-06
Agriculture Development Bank Limited,31,680,661,677,9201,6186237,670,7,2016-06-07
Agriculture Development Bank Limited,33,720,696,702,6052,4275171,720,-18,2016-06-23
Agriculture Development Bank Limited,59,689,676,677,11892,8086110,677,0,2016-06-08
Agriculture Development Bank Limited,45,694,677,677,7948,5422602,677,0,2016-06-09
Agriculture Development Bank Limited,19,689,668,675,4476,3027832,677,-2,2016-06-12
Agriculture Development Bank Limited,151,710,680,700,40671,28383419,675,25,2016-06-13
Agriculture Development Bank Limited,106,725,710,721,35182,25298420,700,21,2016-06-14
Agriculture Development Bank Limited,42,723,712,720,11057,7937373,721,-1,2016-06-15
Agriculture Development Bank Limited,49,722,697,713,14568,10267030,720,-7,2016-06-16
Agriculture Development Bank Limited,36,714,693,705,18341,12933260,713,-8,2016-06-19
Agriculture Development Bank Limited,50,710,697,700,10740,7545962,705,-5,2016-06-20
Agriculture Development Bank Limited,40,720,700,703,9949,7022531,700,3,2016-06-21
Agriculture Development Bank Limited,37,728,706,720,11454,8181899,703,17,2016-06-22
Agriculture Development Bank Limited,36,712,703,710,7223,5121182,702,8,2016-06-26
Agriculture Development Bank Limited,77,739,713,739,22093,15966204,710,29,2016-06-27
Agriculture Development Bank Limited,49,735,721,735,12542,9154895,739,-4,2016-06-28
Agriculture Development Bank Limited,32,732,724,727,10899,7932804,735,-8,2016-06-29
Agriculture Development Bank Limited,62,729,716,722,19936,14451845,727,-5,2016-06-30
Agriculture Development Bank Limited,47,720,713,719,11526,8282487,722,-3,2016-07-03
Agriculture Development Bank Limited,50,730,710,730,5677,4087850,719,11,2016-07-04
Agriculture Development Bank Limited,68,750,713,745,20430,14750377,730,15,2016-07-05
Agriculture Development Bank Limited,91,775,743,761,24816,18965190,745,16,2016-07-06
Agriculture Development Bank Limited,36,765,740,761,4691,3548440,761,0,2016-07-10
Agriculture Development Bank Limited,114,789,761,777,27375,21279724,761,16,2016-07-11
Agriculture Development Bank Limited,58,784,720,766,8705,6641752,777,-11,2016-07-12
Agriculture Development Bank Limited,46,768,740,760,10620,8007271,766,-6,2016-07-13
Agriculture Development Bank Limited,48,775,755,768,11763,8998421,760,8,2016-07-14
Agriculture Development Bank Limited,184,844,765,844,46553,38156850,768,76,2016-07-17
Agriculture Development Bank Limited,104,865,814,833,28713,24282672,844,-11,2016-07-18
Agriculture Development Bank Limited,203,899,830,888,53355,46055239,833,55,2016-07-19
Agriculture Development Bank Limited,272,976,900,976,73449,70610321,888,88,2016-07-20
Agriculture Development Bank Limited,200,1010,954,984,43680,42840235,976,8,2016-07-21
Agriculture Development Bank Limited,252,1065,985,1065,63729,64132381,984,81,2016-07-25
Agriculture Development Bank Limited,200,1113,1045,1082,37909,40983128,1065,17,2016-07-26
Agriculture Development Bank Limited,169,1099,1035,1081,40667,43100183,1082,-1,2016-07-27
Agriculture Development Bank Limited,143,1069,1029,1060,33191,34914371,1081,-21,2016-07-28
Agriculture Development Bank Limited,128,1068,1020,1038,28865,29774506,1060,-22,2016-07-31
Agriculture Development Bank Limited,154,1050,995,1030,33867,34223095,1038,-8,2016-08-01
Agriculture Development Bank Limited,141,1015,1000,1000,58079,58488030,1030,-30,2016-08-02
Agriculture Development Bank Limited,100,1019,982,1002,23444,23497177,1000,2,2016-08-03
Agriculture Development Bank Limited,143,995,955,970,30904,30373426,1002,-32,2016-08-04
Agriculture Development Bank Limited,136,1006,970,972,25130,25039877,970,2,2016-08-07
Agriculture Development Bank Limited,76,965,901,905,16460,15371467,972,-67,2016-08-08
Agriculture Development Bank Limited,16,995,923,995,3567,3473347,905,90,2016-08-09
Agriculture Development Bank Limited,191,1020,936,1010,53909,53784988,995,15,2016-08-10
Agriculture Development Bank Limited,145,1020,992,1020,33089,33098281,1010,10,2016-08-11
Agriculture Development Bank Limited,94,1001,955,968,20556,20035729,1020,-52,2016-08-14
Agriculture Development Bank Limited,144,1006,946,970,27993,27328435,968,2,2016-08-15
Agriculture Development Bank Limited,81,1005,985,999,19708,19578397,999,0,2016-08-31
Agriculture Development Bank Limited,141,1001,970,985,30158,29962681,970,15,2016-08-16
Agriculture Development Bank Limited,123,1010,972,1000,16569,16601481,985,15,2016-08-17
Agriculture Development Bank Limited,74,1013,985,995,8813,8816939,1000,-5,2016-08-21
Agriculture Development Bank Limited,64,1000,962,964,6697,6511253,995,-31,2016-08-22
Agriculture Development Bank Limited,80,983,948,970,12823,12308227,964,6,2016-08-23
Agriculture Development Bank Limited,68,984,951,970,7338,7059284,970,0,2016-08-24
Agriculture Development Bank Limited,57,980,958,965,5090,4924410,970,-5,2016-08-28
Agriculture Development Bank Limited,82,995,965,983,14088,13758972,965,18,2016-08-29
Agriculture Development Bank Limited,82,1002,983,999,16862,16755667,983,16,2016-08-30
Agriculture Development Bank Limited,115,1010,990,998,15887,15973715,999,-1,2016-09-01
Agriculture Development Bank Limited,85,1029,989,1020,13611,13681335,998,22,2016-09-04
Agriculture Development Bank Limited,159,1056,1020,1043,34803,36427617,1020,23,2016-09-05
Agriculture Development Bank Limited,106,1055,1011,1028,25608,26702176,1043,-15,2016-09-06
Agriculture Development Bank Limited,278,1065,1011,1065,62511,65481612,1028,37,2016-09-07
Agriculture Development Bank Limited,90,1058,1040,1054,15717,16504253,1065,-11,2016-09-08
Agriculture Development Bank Limited,151,1075,1042,1050,29449,30976283,1054,-4,2016-09-11
Agriculture Development Bank Limited,161,1060,1048,1050,29095,30665683,1050,0,2016-09-12
Agriculture Development Bank Limited,95,1059,1046,1050,11695,12301220,1050,0,2016-09-14
Agriculture Development Bank Limited,105,1052,1035,1050,11307,11817951,1050,0,2016-09-18
Agriculture Development Bank Limited,254,1071,1040,1044,42584,44752147,1050,-6,2016-09-20
Agriculture Development Bank Limited,169,1045,1020,1025,24012,24686690,1044,-19,2016-09-21
Agriculture Development Bank Limited,248,1032,997,1019,31362,31848766,1025,-6,2016-09-22
Agriculture Development Bank Limited,762,1020,990,995,114461,114824129,1019,-24,2016-09-25
Agriculture Development Bank Limited,61,690,659,675,10691,7175950,697,-22,2016-09-26
Agriculture Development Bank Limited,48,684,672,672,4456,3015421,675,-3,2016-09-27
Agriculture Development Bank Limited,18,677,670,672,1414,952154,672,0,2016-09-28
Agriculture Development Bank Limited,29,670,660,670,3261,2179255,672,-2,2016-09-29
Agriculture Development Bank Limited,35,684,670,680,4644,3147376,670,10,2016-10-02
Agriculture Development Bank Limited,24,690,670,672,2351,1602075,680,-8,2016-10-03
Agriculture Development Bank Limited,26,680,667,668,7550,5062162,672,-4,2016-10-04
Agriculture Development Bank Limited,13,680,667,680,1002,674106,668,12,2016-10-05
Agriculture Development Bank Limited,18,690,670,683,2238,1518931,680,3,2016-10-06
Agriculture Development Bank Limited,15,703,679,683,1795,1231305,683,0,2016-10-16
Agriculture Development Bank Limited,26,683,660,669,3931,2631477,683,-14,2016-10-17
Agriculture Development Bank Limited,19,675,661,670,1206,804747,669,1,2016-10-18
Agriculture Development Bank Limited,29,670,660,665,3950,2620054,670,-5,2016-10-19
Agriculture Development Bank Limited,23,677,661,669,2944,1967195,665,4,2016-10-20
Agriculture Development Bank Limited,38,665,655,655,6226,4100594,669,-14,2016-10-23
Agriculture Development Bank Limited,34,661,649,653,7673,5004546,655,-2,2016-10-24
Agriculture Development Bank Limited,32,650,640,645,3856,2481779,653,-8,2016-10-25
Agriculture Development Bank Limited,26,650,640,642,4364,2809908,645,-3,2016-10-26
Agriculture Development Bank Limited,21,645,630,638,2964,1899283,642,-4,2016-10-27
Agriculture Development Bank Limited,9,650,626,645,906,577224,638,7,2016-11-03
Agriculture Development Bank Limited,23,646,615,625,1784,1127016,645,-20,2016-11-07
Agriculture Development Bank Limited,45,630,605,610,5340,3293823,625,-15,2016-11-08
Agriculture Development Bank Limited,53,613,594,600,5406,3247293,610,-10,2016-11-09
Agriculture Development Bank Limited,50,607,596,600,4874,2927348,600,0,2016-11-10
Agriculture Development Bank Limited,37,610,598,600,7038,4235385,600,0,2016-11-13
Agriculture Development Bank Limited,51,609,595,600,6752,4045871,600,0,2016-11-14
Agriculture Development Bank Limited,41,612,590,596,7995,4812885,600,-4,2016-11-15
Agriculture Development Bank Limited,39,600,588,595,4803,2861582,596,-1,2016-11-16
Agriculture Development Bank Limited,41,595,580,580,5087,2979229,595,-15,2016-11-17
Agriculture Development Bank Limited,34,571,530,556,6046,3314277,580,-24,2016-11-20
Agriculture Development Bank Limited,54,565,541,555,6653,3669875,556,-1,2016-11-21
Agriculture Development Bank Limited,44,560,538,550,6174,3389711,555,-5,2016-11-22
Agriculture Development Bank Limited,64,540,520,525,9827,5206229,550,-25,2016-11-23
Agriculture Development Bank Limited,62,540,523,527,10536,5553951,525,2,2016-11-24
Agriculture Development Bank Limited,95,528,500,502,14556,7400232,527,-25,2016-11-27
Agriculture Development Bank Limited,96,535,480,525,20030,9903603,502,23,2016-11-28
Agriculture Development Bank Limited,71,560,505,555,6827,3685039,525,30,2016-11-29
Agriculture Development Bank Limited,108,589,550,576,17082,9590594,555,21,2016-11-30
Agriculture Development Bank Limited,91,590,556,575,12639,7301002,576,-1,2016-12-01
Agriculture Development Bank Limited,43,571,558,558,3739,2095270,575,-17,2016-12-04
Agriculture Development Bank Limited,31,558,530,545,3418,1858251,558,-13,2016-12-05
Agriculture Development Bank Limited,37,555,540,550,3030,1658237,545,5,2016-12-06
Agriculture Development Bank Limited,24,553,543,550,1850,1014612,550,0,2016-12-07
Agriculture Development Bank Limited,32,550,540,540,4444,2408365,550,-10,2016-12-08
Agriculture Development Bank Limited,27,541,529,530,3290,1755127,540,-10,2016-12-11
Agriculture Development Bank Limited,11,530,515,525,1484,775586,530,-5,2016-12-12
Agriculture Development Bank Limited,30,535,525,530,5246,2776288,525,5,2016-12-14
Agriculture Development Bank Limited,27,542,530,542,4365,2336919,530,12,2016-12-15
Agriculture Development Bank Limited,52,540,525,540,6847,3651601,542,-2,2016-12-18
Agriculture Development Bank Limited,53,535,520,520,6963,3662720,540,-20,2016-12-19
Agriculture Development Bank Limited,47,530,505,520,9974,5158258,520,0,2016-12-20
Agriculture Development Bank Limited,32,525,500,511,6654,3429880,520,-9,2016-12-21
Agriculture Development Bank Limited,46,513,506,513,8026,4103396,511,2,2016-12-22
Agriculture Development Bank Limited,57,510,497,497,7763,3894717,513,-16,2016-12-26
Agriculture Development Bank Limited,54,506,483,495,10568,5233623,497,-2,2016-12-27
Agriculture Development Bank Limited,30,505,495,498,5725,2863189,495,3,2016-12-28
Agriculture Development Bank Limited,115,526,502,526,19494,10089179,498,28,2016-12-29
Agriculture Development Bank Limited,125,555,535,545,18373,10076866,526,19,2017-01-01
Agriculture Development Bank Limited,138,560,545,545,19457,10709727,545,0,2017-01-02
Agriculture Development Bank Limited,78,550,530,530,8202,4415197,545,-15,2017-01-03
Agriculture Development Bank Limited,39,535,510,530,6130,3225775,530,0,2017-01-04
Agriculture Development Bank Limited,37,533,520,528,8287,4378949,530,-2,2017-01-05
Agriculture Development Bank Limited,26,529,520,524,5593,2926079,528,-4,2017-01-08
Agriculture Development Bank Limited,35,540,521,540,5545,2947042,524,16,2017-01-09
Agriculture Development Bank Limited,41,550,540,540,4148,2249676,540,0,2017-01-10
Agriculture Development Bank Limited,32,550,540,540,8359,4558612,540,0,2017-01-11
Agriculture Development Bank Limited,30,546,531,542,5428,2925146,540,2,2017-01-12
Agriculture Development Bank Limited,21,542,530,534,2339,1253888,542,-8,2017-01-15
Agriculture Development Bank Limited,25,536,527,527,2058,1091490,534,-7,2017-01-16
Agriculture Development Bank Limited,24,529,523,523,3270,1719022,527,-4,2017-01-17
Agriculture Development Bank Limited,21,530,520,520,3386,1783070,523,-3,2017-01-18
Agriculture Development Bank Limited,22,529,521,528,1913,1002025,520,8,2017-01-19
Agriculture Development Bank Limited,32,531,526,526,2773,1466139,528,-2,2017-01-22
Agriculture Development Bank Limited,28,524,520,520,2679,1395359,526,-6,2017-01-23
Agriculture Development Bank Limited,40,530,500,508,7839,4008784,520,-12,2017-01-24
Agriculture Development Bank Limited,148,505,480,490,25727,12653108,508,-18,2017-01-25
Agriculture Development Bank Limited,159,490,455,460,33136,15482268,490,-30,2017-01-26
Agriculture Development Bank Limited,69,465,442,442,12799,5774559,460,-18,2017-01-30
Agriculture Development Bank Limited,37,464,435,458,11409,5152834,442,16,2017-01-31
Agriculture Development Bank Limited,60,485,465,483,9886,4711204,458,25,2017-02-01
Agriculture Development Bank Limited,94,500,480,483,15620,7632898,483,0,2017-02-02
Agriculture Development Bank Limited,27,492,470,470,3121,1489850,483,-13,2017-02-05
Agriculture Development Bank Limited,47,468,455,455,5122,2362049,470,-15,2017-02-06
Agriculture Development Bank Limited,35,463,451,455,4245,1938381,455,0,2017-02-07
Agriculture Development Bank Limited,77,460,448,450,9700,4386164,455,-5,2017-02-08
Agriculture Development Bank Limited,78,453,440,445,12428,5537810,450,-5,2017-02-09
Agriculture Development Bank Limited,75,453,416,429,11551,4886512,445,-16,2017-02-12
Agriculture Development Bank Limited,58,443,413,440,11039,4662838,429,11,2017-02-13
Agriculture Development Bank Limited,82,447,424,437,13085,5708474,440,-3,2017-02-14
Agriculture Development Bank Limited,47,456,442,453,12899,5819825,437,16,2017-02-15
Agriculture Development Bank Limited,98,460,450,453,16259,7356534,453,0,2017-02-16
Agriculture Development Bank Limited,118,452,441,445,23260,10365716,453,-8,2017-02-19
Agriculture Development Bank Limited,98,455,440,440,17150,7643190,445,-5,2017-02-20
Agriculture Development Bank Limited,98,465,437,439,18863,8376472,440,-1,2017-02-21
Agriculture Development Bank Limited,102,442,430,434,22813,9908821,439,-5,2017-02-22
Agriculture Development Bank Limited,69,442,427,440,14367,6260776,434,6,2017-02-23
Agriculture Development Bank Limited,40,445,430,434,6391,2788327,440,-6,2017-02-26
Agriculture Development Bank Limited,91,426,417,421,16732,7032221,434,-13,2017-02-28
Agriculture Development Bank Limited,55,430,421,430,5008,2135041,421,9,2017-03-01
Agriculture Development Bank Limited,57,435,425,435,5828,2521303,430,5,2017-03-02
Agriculture Development Bank Limited,79,448,432,443,12347,5458931,435,8,2017-03-05
Agriculture Development Bank Limited,126,484,460,484,26819,12587312,461,23,2017-03-21
Agriculture Development Bank Limited,75,456,446,449,9615,4316175,443,6,2017-03-06
Agriculture Development Bank Limited,48,443,439,439,5596,2467237,449,-10,2017-03-07
Agriculture Development Bank Limited,37,452,444,445,3547,1583560,439,6,2017-03-09
Agriculture Development Bank Limited,34,450,440,440,5870,2600359,445,-5,2017-03-13
Agriculture Development Bank Limited,67,450,440,441,9273,4113210,440,1,2017-03-14
Agriculture Development Bank Limited,36,449,443,448,3091,1376749,441,7,2017-03-15
Agriculture Development Bank Limited,49,452,441,445,9046,4012644,448,-3,2017-03-16
Agriculture Development Bank Limited,67,454,445,451,10196,4592620,445,6,2017-03-19
Agriculture Development Bank Limited,88,465,455,461,16216,7455757,451,10,2017-03-20
Agriculture Development Bank Limited,207,515,485,492,46018,23059369,484,8,2017-03-22
Agriculture Development Bank Limited,238,514,493,511,42052,21317008,492,19,2017-03-23
Agriculture Development Bank Limited,330,562,512,562,86224,47708756,511,51,2017-03-26
Agriculture Development Bank Limited,275,606,573,595,63335,37423649,562,33,2017-03-28
Agriculture Development Bank Limited,535,615,550,565,122754,70858145,595,-30,2017-03-29
Agriculture Development Bank Limited,695,577,555,574,151987,86067068,565,9,2017-03-30
Agriculture Development Bank Limited,334,525,487,504,86048,43752580,478,26,2017-04-03
Agriculture Development Bank Limited,165,508,480,495,38622,19049502,504,-9,2017-04-04
Agriculture Development Bank Limited,163,495,474,482,42085,20121788,495,-13,2017-04-06
Agriculture Development Bank Limited,130,485,470,472,26361,12443931,482,-10,2017-04-09
Agriculture Development Bank Limited,109,485,467,471,24705,11622539,472,-1,2017-04-10
Agriculture Development Bank Limited,125,494,470,489,29427,14275730,471,18,2017-04-11
Agriculture Development Bank Limited,167,500,480,480,43976,21570036,489,-9,2017-04-12
Agriculture Development Bank Limited,130,482,468,472,25576,12157715,480,-8,2017-04-13
Agriculture Development Bank Limited,90,481,457,460,14433,6817342,472,-12,2017-04-16
Agriculture Development Bank Limited,121,460,443,450,26897,12146144,460,-10,2017-04-18
Agriculture Development Bank Limited,96,469,453,463,15551,7173984,450,13,2017-04-19
Agriculture Development Bank Limited,139,483,463,465,32994,15564848,463,2,2017-04-20
Agriculture Development Bank Limited,147,511,472,472,45549,21857591,465,7,2017-04-23
Agriculture Development Bank Limited,116,474,466,469,23133,10859181,472,-3,2017-04-24
Agriculture Development Bank Limited,100,472,464,469,17195,8041381,469,0,2017-04-25
Agriculture Development Bank Limited,53,472,465,467,9098,4257990,469,-2,2017-04-26
Agriculture Development Bank Limited,71,475,463,466,15743,7381184,467,-1,2017-04-27
Agriculture Development Bank Limited,97,470,454,459,18728,8571257,466,-7,2017-04-30
Agriculture Development Bank Limited,99,468,445,461,22562,10244556,459,2,2017-05-02
Agriculture Development Bank Limited,69,478,457,461,13689,6359865,461,0,2017-05-03
Agriculture Development Bank Limited,68,478,454,460,10579,4862372,461,-1,2017-05-04
Agriculture Development Bank Limited,57,464,453,454,5619,2567369,460,-6,2017-05-07
Agriculture Development Bank Limited,74,465,446,460,16791,7593535,454,6,2017-05-08
Agriculture Development Bank Limited,69,461,452,457,21081,9605186,460,-3,2017-05-09
Agriculture Development Bank Limited,76,466,461,464,12423,5755865,457,7,2017-05-11
Agriculture Development Bank Limited,48,471,460,465,10542,4873562,464,1,2017-05-15
Agriculture Development Bank Limited,55,465,455,456,7225,3308817,465,-9,2017-05-16
Agriculture Development Bank Limited,41,460,454,455,4811,2194661,456,-1,2017-05-17
Agriculture Development Bank Limited,49,458,450,451,6117,2771963,455,-4,2017-05-18
Agriculture Development Bank Limited,72,460,444,450,10460,4687103,451,-1,2017-05-21
Agriculture Development Bank Limited,32,450,441,448,3174,1418900,450,-2,2017-05-22
Agriculture Development Bank Limited,46,455,443,450,6912,3118403,448,2,2017-05-23
Agriculture Development Bank Limited,52,456,448,455,11662,5282774,450,5,2017-05-24
Agriculture Development Bank Limited,72,455,445,450,9086,4093677,455,-5,2017-05-28
Agriculture Development Bank Limited,43,450,441,444,7182,3193641,450,-6,2017-05-30
Agriculture Development Bank Limited,79,455,439,450,8727,3874255,444,6,2017-05-31
Agriculture Development Bank Limited,99,459,444,446,14518,6514331,450,-4,2017-06-01
Agriculture Development Bank Limited,71,450,440,445,10779,4796056,446,-1,2017-06-04
Agriculture Development Bank Limited,73,450,443,443,12176,5438368,445,-2,2017-06-05
Agriculture Development Bank Limited,88,458,448,454,10899,4918322,443,11,2017-06-06
Agriculture Development Bank Limited,72,463,450,453,14334,6502554,454,-1,2017-06-07
Agriculture Development Bank Limited,45,452,444,449,6842,3058885,453,-4,2017-06-08
Agriculture Development Bank Limited,52,448,440,444,7886,3493484,449,-5,2017-06-11
Agriculture Development Bank Limited,89,446,434,445,9184,4039315,444,1,2017-06-12
Agriculture Development Bank Limited,73,444,435,435,13963,6114368,445,-10,2017-06-13
Agriculture Development Bank Limited,63,440,434,435,8869,3869751,435,0,2017-06-14
Agriculture Development Bank Limited,97,442,432,440,15064,6569564,435,5,2017-06-15
Agriculture Development Bank Limited,137,440,428,431,19261,8290076,440,-9,2017-06-18
Agriculture Development Bank Limited,125,431,417,427,21359,9040694,431,-4,2017-06-19
Agriculture Development Bank Limited,98,429,415,423,12740,5380466,427,-4,2017-06-20
Agriculture Development Bank Limited,54,425,417,421,6334,2673676,423,-2,2017-06-21
Agriculture Development Bank Limited,105,429,420,421,16465,6949115,421,0,2017-06-22
Agriculture Development Bank Limited,75,426,419,423,10516,4451695,421,2,2017-06-25
Agriculture Development Bank Limited,82,425,420,422,11352,4795475,423,-1,2017-06-27
Agriculture Development Bank Limited,61,428,415,428,10162,4287790,422,6,2017-06-28
Agriculture Development Bank Limited,94,430,419,428,14946,6315356,428,0,2017-07-02
Agriculture Development Bank Limited,51,430,420,423,7794,3311499,428,-5,2017-07-03
Agriculture Development Bank Limited,80,426,419,420,13712,5768673,423,-3,2017-07-04
Agriculture Development Bank Limited,73,425,419,425,11348,4786382,420,5,2017-07-05
Agriculture Development Bank Limited,93,437,425,437,18660,7970364,425,12,2017-07-06
Agriculture Development Bank Limited,95,446,430,441,20091,8794058,437,4,2017-07-09
Agriculture Development Bank Limited,81,440,430,433,12785,5585373,441,-8,2017-07-10
Agriculture Development Bank Limited,68,440,430,435,9864,4318391,433,2,2017-07-11
Agriculture Development Bank Limited,63,440,432,432,8794,3825056,435,-3,2017-07-12
Agriculture Development Bank Limited,84,437,430,435,12875,5549593,432,3,2017-07-13
Agriculture Development Bank Limited,47,435,430,433,4465,1927023,435,-2,2017-07-16
Agriculture Development Bank Limited,74,448,433,448,16129,7096066,433,15,2017-07-17
Agriculture Development Bank Limited,181,472,449,472,27796,12739662,448,24,2017-07-18
Agriculture Development Bank Limited,94,459,450,453,14097,6379143,454,-1,2017-08-03
Agriculture Development Bank Limited,121,470,460,460,21239,9884869,472,-12,2017-07-19
Agriculture Development Bank Limited,88,465,454,461,10954,5040009,460,1,2017-07-20
Agriculture Development Bank Limited,88,465,455,459,16709,7668931,461,-2,2017-07-23
Agriculture Development Bank Limited,91,460,454,455,13393,6112032,459,-4,2017-07-24
Agriculture Development Bank Limited,78,461,454,458,16138,7380111,455,3,2017-07-25
Agriculture Development Bank Limited,96,460,448,450,22953,10401083,458,-8,2017-07-26
Agriculture Development Bank Limited,75,460,450,460,11335,5133609,450,10,2017-07-27
Agriculture Development Bank Limited,60,461,445,451,9537,4331121,460,-9,2017-07-30
Agriculture Development Bank Limited,76,459,450,453,12315,5598249,451,2,2017-07-31
Agriculture Development Bank Limited,87,469,450,454,9280,4235329,453,1,2017-08-01
Agriculture Development Bank Limited,56,456,453,454,12168,5532203,454,0,2017-08-02
Agriculture Development Bank Limited,104,456,450,454,18930,8598441,453,1,2017-08-06
Agriculture Development Bank Limited,87,463,452,453,11926,5419900,454,-1,2017-08-07
Agriculture Development Bank Limited,123,460,444,450,17516,7934355,453,-3,2017-08-09
Agriculture Development Bank Limited,97,454,443,450,21245,9497817,450,0,2017-08-10
Agriculture Development Bank Limited,86,449,440,445,14415,6423464,450,-5,2017-08-13
Agriculture Development Bank Limited,96,446,441,441,15104,6699557,445,-4,2017-08-15
Agriculture Development Bank Limited,84,448,442,444,11304,5021857,441,3,2017-08-16
Agriculture Development Bank Limited,75,449,438,443,23326,10279553,444,-1,2017-08-17
Agriculture Development Bank Limited,89,444,435,440,16054,7075869,443,-3,2017-08-20
Agriculture Development Bank Limited,46,442,432,438,5674,2474784,440,-2,2017-08-21
Agriculture Development Bank Limited,79,442,436,441,12396,5447828,438,3,2017-08-22
Agriculture Development Bank Limited,52,442,438,441,7718,3396666,441,0,2017-08-23
Agriculture Development Bank Limited,44,453,434,443,11438,5093781,441,2,2017-08-24
Agriculture Development Bank Limited,62,451,443,446,3889,1732805,443,3,2017-08-27
Agriculture Development Bank Limited,61,452,444,446,7897,3519687,446,0,2017-08-28
Agriculture Development Bank Limited,83,443,435,438,14820,6508340,446,-8,2017-08-30
Agriculture Development Bank Limited,83,438,432,437,15528,6769346,438,-1,2017-08-31
Agriculture Development Bank Limited,94,439,426,430,33009,14133477,437,-7,2017-09-04
Agriculture Development Bank Limited,111,440,425,438,11603,4994219,430,8,2017-09-06
Agriculture Development Bank Limited,89,438,426,428,34082,14711435,438,-10,2017-09-07
Agriculture Development Bank Limited,126,431,423,425,37704,16076730,428,-3,2017-09-10
Agriculture Development Bank Limited,65,430,420,424,17950,7592940,425,-1,2017-09-11
Agriculture Development Bank Limited,98,426,420,421,27903,11782776,424,-3,2017-09-12
Agriculture Development Bank Limited,111,423,418,420,32249,13538906,421,-1,2017-09-13
Agriculture Development Bank Limited,115,447,419,447,42524,18361183,420,27,2017-09-14
Agriculture Development Bank Limited,159,459,438,447,49764,22001355,447,0,2017-09-17
Agriculture Development Bank Limited,119,452,443,443,33400,14877419,447,-4,2017-09-18
Agriculture Development Bank Limited,65,443,435,439,10450,4599400,443,-4,2017-09-20
Agriculture Development Bank Limited,76,433,425,431,17649,7561101,432,-1,2017-10-09
Agriculture Development Bank Limited,42,443,439,441,3718,1638796,439,2,2017-09-24
Agriculture Development Bank Limited,29,448,440,448,2882,1272835,441,7,2017-09-25
Agriculture Development Bank Limited,35,449,443,448,5132,2286875,448,0,2017-09-26
Agriculture Development Bank Limited,20,453,446,453,3164,1415634,448,5,2017-10-03
Agriculture Development Bank Limited,40,450,437,440,6475,2854121,453,-13,2017-10-04
Agriculture Development Bank Limited,91,432,420,432,15759,6712529,440,-8,2017-10-08
Agriculture Development Bank Limited,89,438,423,427,19003,8118044,431,-4,2017-10-10
Agriculture Development Bank Limited,65,431,425,428,11993,5132940,427,1,2017-10-11
Agriculture Development Bank Limited,45,435,428,429,5474,2357856,428,1,2017-10-12
Agriculture Development Bank Limited,49,433,427,433,5553,2393186,429,4,2017-10-15
Agriculture Development Bank Limited,87,451,434,442,18696,8294486,433,9,2017-10-16
Agriculture Development Bank Limited,64,450,436,449,12124,5388922,442,7,2017-10-17
Agriculture Development Bank Limited,53,450,438,444,12688,5628714,449,-5,2017-10-18
Agriculture Development Bank Limited,44,458,436,450,11183,5051656,444,6,2017-10-22
Agriculture Development Bank Limited,79,455,445,449,12644,5695162,450,-1,2017-10-23
Agriculture Development Bank Limited,59,452,445,448,9549,4278475,449,-1,2017-10-24
Agriculture Development Bank Limited,93,451,444,449,17137,7675865,448,1,2017-10-25
Agriculture Development Bank Limited,51,447,440,442,7203,3185825,449,-7,2017-10-29
Agriculture Development Bank Limited,71,443,437,437,13723,6029799,442,-5,2017-10-30
Agriculture Development Bank Limited,38,440,433,437,8889,3866223,437,0,2017-10-31
Agriculture Development Bank Limited,51,437,429,434,6291,2725033,437,-3,2017-11-01
Agriculture Development Bank Limited,58,442,430,440,8331,3632384,434,6,2017-11-02
Agriculture Development Bank Limited,84,440,424,430,16936,7255084,440,-10,2017-11-05
Agriculture Development Bank Limited,139,430,420,429,29796,12642926,430,-1,2017-11-06
Agriculture Development Bank Limited,80,436,420,422,26141,11088659,429,-7,2017-11-07
Agriculture Development Bank Limited,126,422,414,416,17305,7217966,422,-6,2017-11-08
Agriculture Development Bank Limited,64,427,412,415,9434,3918031,416,-1,2017-11-09
Agriculture Development Bank Limited,59,425,415,423,9098,3815462,415,8,2017-11-12
Agriculture Development Bank Limited,69,428,420,428,14684,6245012,423,5,2017-11-13
Agriculture Development Bank Limited,65,434,424,432,14580,6256963,428,4,2017-11-14
Agriculture Development Bank Limited,56,432,426,428,3596,1544399,432,-4,2017-11-15
Agriculture Development Bank Limited,56,435,420,420,13740,5797379,428,-8,2017-11-16
Agriculture Development Bank Limited,72,422,412,420,13373,5575148,420,0,2017-11-19
Agriculture Development Bank Limited,33,422,418,421,4579,1923518,420,1,2017-11-20
Agriculture Development Bank Limited,30,425,421,423,4762,2015105,421,2,2017-11-21
Agriculture Development Bank Limited,39,429,421,425,5998,2539736,423,2,2017-11-22
Agriculture Development Bank Limited,52,430,425,425,7260,3103718,425,0,2017-11-23
Agriculture Development Bank Limited,71,441,425,432,10953,4710293,425,7,2017-11-26
Agriculture Development Bank Limited,42,435,430,430,6918,2983035,432,-2,2017-11-27
Agriculture Development Bank Limited,40,432,425,431,12551,5401048,430,1,2017-11-28
Agriculture Development Bank Limited,87,439,430,436,19013,8283527,431,5,2017-11-29
Agriculture Development Bank Limited,63,438,431,437,10518,4566994,436,1,2017-11-30
Agriculture Development Bank Limited,46,437,430,435,10306,4465824,437,-2,2017-12-04
Agriculture Development Bank Limited,29,426,419,422,3192,1350383,424,-2,2017-12-20
Agriculture Development Bank Limited,51,442,430,431,6588,2837524,435,-4,2017-12-05
Agriculture Development Bank Limited,47,437,426,435,9725,4204614,431,4,2017-12-06
Agriculture Development Bank Limited,46,451,428,430,11646,5072147,435,-5,2017-12-10
Agriculture Development Bank Limited,51,433,424,431,12873,5506814,430,1,2017-12-11
Agriculture Development Bank Limited,46,431,426,427,15642,6693617,431,-4,2017-12-12
Agriculture Development Bank Limited,22,431,421,428,4262,1812383,427,1,2017-12-13
Agriculture Development Bank Limited,59,433,424,425,5967,2540238,428,-3,2017-12-14
Agriculture Development Bank Limited,35,430,423,423,6121,2599496,425,-2,2017-12-17
Agriculture Development Bank Limited,39,426,422,426,4333,1839010,423,3,2017-12-18
Agriculture Development Bank Limited,38,426,421,424,8052,3410220,426,-2,2017-12-19
Agriculture Development Bank Limited,28,423,417,420,7557,3178267,422,-2,2017-12-21
Agriculture Development Bank Limited,48,428,420,421,7917,3341185,420,1,2017-12-24
Agriculture Development Bank Limited,30,426,411,420,7244,3040975,421,-1,2017-12-26
Agriculture Development Bank Limited,73,418,408,415,11368,4701950,420,-5,2017-12-27
Agriculture Development Bank Limited,74,417,400,410,9917,4064962,415,-5,2017-12-28
Agriculture Development Bank Limited,93,409,400,402,27546,11089087,410,-8,2017-12-31
Agriculture Development Bank Limited,48,414,405,414,6665,2726955,402,12,2018-01-01
Agriculture Development Bank Limited,240,430,416,425,55870,23639633,414,11,2018-01-02
Agriculture Development Bank Limited,115,428,419,422,15373,6515991,425,-3,2018-01-03
Agriculture Development Bank Limited,61,421,416,421,5788,2425843,422,-1,2018-01-04
Agriculture Development Bank Limited,91,429,416,423,18051,7598573,421,2,2018-01-07
Agriculture Development Bank Limited,57,430,420,425,8389,3558019,423,2,2018-01-08
Agriculture Development Bank Limited,44,427,422,425,7302,3105363,425,0,2018-01-09
Agriculture Development Bank Limited,70,427,421,425,7277,3089550,425,0,2018-01-10
Agriculture Development Bank Limited,66,427,417,420,10523,4415231,425,-5,2018-01-14
Agriculture Development Bank Limited,34,421,415,417,4270,1778362,420,-3,2018-01-16
Agriculture Development Bank Limited,48,417,409,413,6401,2647102,417,-4,2018-01-17
Agriculture Development Bank Limited,153,420,413,419,21733,9065805,413,6,2018-01-21
Agriculture Development Bank Limited,108,422,418,420,18056,7571323,419,1,2018-01-22
Agriculture Development Bank Limited,98,421,415,416,15725,6564115,420,-4,2018-01-23
Agriculture Development Bank Limited,86,420,412,419,14131,5896929,416,3,2018-01-24
Agriculture Development Bank Limited,141,420,417,420,13110,5476669,419,1,2018-01-25
Agriculture Development Bank Limited,341,423,415,415,49337,20640167,420,-5,2018-01-28
Agriculture Development Bank Limited,62,347,340,340,8266,2828715,346,-6,2018-01-29
Agriculture Development Bank Limited,42,344,340,344,4790,1636893,340,4,2018-01-31
Agriculture Development Bank Limited,53,345,343,344,6191,2133740,344,0,2018-02-01
Agriculture Development Bank Limited,57,350,342,350,8959,3116418,344,6,2018-02-04
Agriculture Development Bank Limited,57,350,342,342,8109,2793340,350,-8,2018-02-05
Agriculture Development Bank Limited,44,347,340,347,5214,1780333,342,5,2018-02-06
Agriculture Development Bank Limited,25,346,341,342,5012,1715421,347,-5,2018-02-07
Agriculture Development Bank Limited,39,345,336,342,3523,1208072,342,0,2018-02-08
Agriculture Development Bank Limited,33,342,335,338,3932,1323562,340,-2,2018-02-25
Agriculture Development Bank Limited,28,343,341,342,1760,601865,342,0,2018-02-11
Agriculture Development Bank Limited,35,342,340,340,3785,1289922,342,-2,2018-02-12
Agriculture Development Bank Limited,36,342,335,340,4167,1408438,340,0,2018-02-14
Agriculture Development Bank Limited,58,350,341,350,7548,2607158,340,10,2018-02-15
Agriculture Development Bank Limited,91,359,348,350,11904,4191852,350,0,2018-02-18
Agriculture Development Bank Limited,52,351,340,340,6728,2317045,350,-10,2018-02-20
Agriculture Development Bank Limited,23,341,339,340,2461,836966,340,0,2018-02-21
Agriculture Development Bank Limited,47,342,338,340,4099,1394160,340,0,2018-02-22
Agriculture Development Bank Limited,34,337,335,335,4951,1661667,338,-3,2018-02-26
Agriculture Development Bank Limited,42,342,332,338,4409,1484882,335,3,2018-02-27
Agriculture Development Bank Limited,39,339,334,334,13018,4369744,338,-4,2018-02-28
Agriculture Development Bank Limited,61,330,325,328,16726,5461805,334,-6,2018-03-04
Agriculture Development Bank Limited,64,330,323,324,16594,5384502,328,-4,2018-03-05
Agriculture Development Bank Limited,51,328,320,327,5748,1861617,324,3,2018-03-06
Agriculture Development Bank Limited,45,333,327,330,6817,2256339,327,3,2018-03-07
Agriculture Development Bank Limited,43,331,326,326,6491,2131371,330,-4,2018-03-11
Agriculture Development Bank Limited,28,331,326,328,10231,3365920,326,2,2018-03-12
Agriculture Development Bank Limited,46,333,327,333,8561,2828509,328,5,2018-03-13
Agriculture Development Bank Limited,36,335,328,335,8410,2787208,333,2,2018-03-14
Agriculture Development Bank Limited,58,337,330,335,10440,3496620,335,0,2018-03-15
Agriculture Development Bank Limited,39,339,333,334,5791,1934030,335,-1,2018-03-18
Agriculture Development Bank Limited,30,335,325,325,5937,1939750,334,-9,2018-03-19
Agriculture Development Bank Limited,25,327,321,323,2133,689613,325,-2,2018-03-20
Agriculture Development Bank Limited,73,321,314,316,11081,3509629,323,-7,2018-03-21
Agriculture Development Bank Limited,55,320,310,316,6600,2077888,316,0,2018-03-22
Agriculture Development Bank Limited,86,313,299,300,10390,3161312,316,-16,2018-03-26
Agriculture Development Bank Limited,86,326,283,316,16469,4927113,300,16,2018-03-27
Agriculture Development Bank Limited,99,317,307,311,12154,3801930,316,-5,2018-03-28
Agriculture Development Bank Limited,66,320,311,318,8252,2610653,311,7,2018-03-29
Agriculture Development Bank Limited,56,320,308,313,6979,2181409,318,-5,2018-04-01
Agriculture Development Bank Limited,33,318,310,314,6267,1957517,313,1,2018-04-02
Agriculture Development Bank Limited,33,318,310,315,3431,1080948,314,1,2018-04-03
Agriculture Development Bank Limited,81,326,315,325,12813,4139091,315,10,2018-04-04
Agriculture Development Bank Limited,103,335,321,331,22167,7296728,325,6,2018-04-05
Agriculture Development Bank Limited,115,348,331,340,17000,5765359,331,9,2018-04-08
Agriculture Development Bank Limited,80,346,334,335,13810,4682890,340,-5,2018-04-09
Agriculture Development Bank Limited,37,337,325,334,6099,2023472,335,-1,2018-04-10
Agriculture Development Bank Limited,45,335,328,335,5135,1702717,334,1,2018-04-11
Agriculture Development Bank Limited,39,340,332,337,9067,3064628,335,2,2018-04-12
Agriculture Development Bank Limited,27,340,326,340,7648,2538264,337,3,2018-04-15
Agriculture Development Bank Limited,44,341,335,338,5765,1952451,340,-2,2018-04-16
Agriculture Development Bank Limited,84,343,336,337,17345,5875128,338,-1,2018-04-17
Agriculture Development Bank Limited,76,354,337,345,17497,6018812,337,8,2018-04-18
Agriculture Development Bank Limited,93,353,347,351,24467,8591259,345,6,2018-04-19
Agriculture Development Bank Limited,139,370,352,369,36790,13381295,351,18,2018-04-22
Agriculture Development Bank Limited,142,382,360,360,39505,14550792,369,-9,2018-04-23
Agriculture Development Bank Limited,93,365,345,359,16417,5863413,360,-1,2018-04-24
Agriculture Development Bank Limited,73,360,351,352,10118,3576536,359,-7,2018-04-25
Agriculture Development Bank Limited,73,354,345,348,10047,3496945,352,-4,2018-04-26
Agriculture Development Bank Limited,70,348,337,344,10608,3637412,348,-4,2018-04-29
Agriculture Development Bank Limited,45,342,338,341,5447,1851294,344,-3,2018-05-02
Agriculture Development Bank Limited,79,352,343,346,9858,3429602,341,5,2018-05-03
Agriculture Development Bank Limited,78,346,343,343,9671,3330659,346,-3,2018-05-06
Agriculture Development Bank Limited,62,345,339,343,6251,2139147,343,0,2018-05-07
Agriculture Development Bank Limited,33,343,340,343,5181,1766629,343,0,2018-05-08
Agriculture Development Bank Limited,50,347,344,344,6849,2366426,343,1,2018-05-09
Agriculture Development Bank Limited,66,346,337,343,11575,3945761,344,-1,2018-05-10
Agriculture Development Bank Limited,42,344,338,341,4201,1434612,343,-2,2018-05-14
Agriculture Development Bank Limited,29,342,337,339,2916,987956,341,-2,2018-05-15
Agriculture Development Bank Limited,29,344,337,341,3039,1034751,339,2,2018-05-16
Agriculture Development Bank Limited,42,343,339,339,6983,2384710,341,-2,2018-05-17
Agriculture Development Bank Limited,45,344,338,340,9261,3153251,339,1,2018-05-20
Agriculture Development Bank Limited,60,340,335,340,10925,3694072,340,0,2018-05-21
Agriculture Development Bank Limited,59,340,335,337,6973,2356133,340,-3,2018-05-22