companyname,numberoftransaction,maxprice,minprice,closingprice,tradedshares,amount,previousclosing,difference,date
Asian Life Insurance Co. Limited,24,1500,1477,1491,4264,6329896,1490,1,2016-05-23
Asian Life Insurance Co. Limited,29,1500,1470,1480,6737,10017480,1491,-11,2016-05-24
Asian Life Insurance Co. Limited,31,1500,1460,1460,5313,7852884,1480,-20,2016-05-25
Asian Life Insurance Co. Limited,16,1475,1412,1470,2250,3266243,1460,10,2016-05-26
Asian Life Insurance Co. Limited,19,1477,1460,1460,4736,6955158,1470,-10,2016-05-29
Asian Life Insurance Co. Limited,38,1484,1453,1478,8201,11994288,1460,18,2016-05-30
Asian Life Insurance Co. Limited,29,1490,1470,1470,7004,10339705,1478,-8,2016-05-31
Asian Life Insurance Co. Limited,22,1475,1460,1465,3566,5237994,1470,-5,2016-06-01
Asian Life Insurance Co. Limited,15,1465,1440,1444,2162,3121255,1465,-21,2016-06-02
Asian Life Insurance Co. Limited,27,1435,1400,1400,4786,6716692,1444,-44,2016-06-05
Asian Life Insurance Co. Limited,8,1428,1407,1410,575,814345,1400,10,2016-06-06
Asian Life Insurance Co. Limited,18,1448,1412,1434,4480,6418070,1410,24,2016-06-07
Asian Life Insurance Co. Limited,188,1989,1880,1880,31702,61252329,1880,0,2016-06-23
Asian Life Insurance Co. Limited,25,1485,1440,1485,8101,11922413,1434,51,2016-06-08
Asian Life Insurance Co. Limited,96,1610,1470,1575,21723,33148695,1485,90,2016-06-09
Asian Life Insurance Co. Limited,69,1600,1515,1551,17744,27980743,1575,-24,2016-06-12
Asian Life Insurance Co. Limited,63,1585,1525,1585,24210,37665887,1551,34,2016-06-13
Asian Life Insurance Co. Limited,95,1645,1590,1635,26431,42638068,1585,50,2016-06-14
Asian Life Insurance Co. Limited,156,1755,1667,1745,32064,54845457,1635,110,2016-06-15
Asian Life Insurance Co. Limited,192,1919,1779,1870,39483,73846350,1745,125,2016-06-16
Asian Life Insurance Co. Limited,128,1900,1740,1790,28046,51136409,1870,-80,2016-06-19
Asian Life Insurance Co. Limited,64,1805,1700,1733,9451,16513139,1790,-57,2016-06-20
Asian Life Insurance Co. Limited,41,1775,1745,1770,6139,10820643,1733,37,2016-06-21
Asian Life Insurance Co. Limited,101,1892,1770,1880,28042,51172388,1770,110,2016-06-22
Asian Life Insurance Co. Limited,52,1885,1845,1850,8974,16735577,1880,-30,2016-06-26
Asian Life Insurance Co. Limited,60,1860,1790,1790,10132,18522116,1850,-60,2016-06-27
Asian Life Insurance Co. Limited,60,1850,1760,1816,12863,23127474,1790,26,2016-06-28
Asian Life Insurance Co. Limited,43,1880,1820,1820,7227,13265806,1816,4,2016-06-29
Asian Life Insurance Co. Limited,24,1837,1821,1822,2998,5483396,1820,2,2016-06-30
Asian Life Insurance Co. Limited,34,1820,1770,1770,8371,14969000,1822,-52,2016-07-03
Asian Life Insurance Co. Limited,27,1790,1751,1790,8086,14280610,1770,20,2016-07-04
Asian Life Insurance Co. Limited,20,1790,1745,1790,4305,7570011,1790,0,2016-07-05
Asian Life Insurance Co. Limited,41,1790,1750,1750,7831,13857758,1790,-40,2016-07-06
Asian Life Insurance Co. Limited,43,1780,1735,1758,8742,15289979,1750,8,2016-07-10
Asian Life Insurance Co. Limited,29,1740,1715,1720,4437,7656355,1758,-38,2016-07-11
Asian Life Insurance Co. Limited,29,1730,1641,1695,4506,7635940,1720,-25,2016-07-12
Asian Life Insurance Co. Limited,25,1700,1653,1700,3960,6630186,1695,5,2016-07-13
Asian Life Insurance Co. Limited,20,1750,1700,1710,4467,7687821,1700,10,2016-07-14
Asian Life Insurance Co. Limited,28,1754,1657,1715,7656,13092066,1710,5,2016-07-17
Asian Life Insurance Co. Limited,44,1886,1715,1886,7605,14059544,1715,171,2016-07-18
Asian Life Insurance Co. Limited,27,1930,1785,1800,7339,13333816,1886,-86,2016-07-19
Asian Life Insurance Co. Limited,52,1830,1800,1815,12992,23455301,1800,15,2016-07-20
Asian Life Insurance Co. Limited,33,1830,1790,1812,4188,7604710,1815,-3,2016-07-21
Asian Life Insurance Co. Limited,40,1855,1810,1836,19383,35367253,1812,24,2016-07-25
Asian Life Insurance Co. Limited,39,1870,1840,1860,5801,10776609,1836,24,2016-07-26
Asian Life Insurance Co. Limited,47,1890,1821,1840,9745,18164696,1860,-20,2016-07-27
Asian Life Insurance Co. Limited,42,1880,1815,1871,5123,9529242,1840,31,2016-07-28
Asian Life Insurance Co. Limited,40,1881,1844,1850,12028,22411139,1871,-21,2016-07-31
Asian Life Insurance Co. Limited,42,1880,1830,1870,9300,17237394,1850,20,2016-08-01
Asian Life Insurance Co. Limited,52,1880,1841,1860,9599,17896460,1870,-10,2016-08-02
Asian Life Insurance Co. Limited,45,1874,1803,1837,14180,26188066,1860,-23,2016-08-03
Asian Life Insurance Co. Limited,44,1835,1750,1770,6954,12520560,1837,-67,2016-08-04
Asian Life Insurance Co. Limited,31,1815,1753,1756,5026,8942760,1770,-14,2016-08-07
Asian Life Insurance Co. Limited,26,1726,1665,1665,3979,6753044,1756,-91,2016-08-08
Asian Life Insurance Co. Limited,3,1731,1698,1731,630,1090200,1665,66,2016-08-09
Asian Life Insurance Co. Limited,50,1836,1696,1760,8352,14790668,1731,29,2016-08-10
Asian Life Insurance Co. Limited,26,1770,1750,1764,3643,6394106,1760,4,2016-08-11
Asian Life Insurance Co. Limited,21,1735,1699,1700,3154,5385522,1764,-64,2016-08-14
Asian Life Insurance Co. Limited,31,1666,1601,1630,3971,6495437,1700,-70,2016-08-15
Asian Life Insurance Co. Limited,10,1749,1721,1721,1326,2294830,1740,-19,2016-08-31
Asian Life Insurance Co. Limited,22,1695,1595,1695,4907,7883961,1630,65,2016-08-16
Asian Life Insurance Co. Limited,21,1728,1690,1707,3077,5255802,1695,12,2016-08-17
Asian Life Insurance Co. Limited,8,1725,1650,1650,1173,1963103,1707,-57,2016-08-21
Asian Life Insurance Co. Limited,26,1650,1595,1595,3424,5538892,1650,-55,2016-08-22
Asian Life Insurance Co. Limited,28,1639,1588,1605,3078,4930431,1595,10,2016-08-23
Asian Life Insurance Co. Limited,40,1765,1637,1764,5654,9830135,1605,159,2016-08-24
Asian Life Insurance Co. Limited,29,1799,1730,1746,3103,5450410,1764,-18,2016-08-28
Asian Life Insurance Co. Limited,13,1780,1730,1745,1984,3459985,1746,-1,2016-08-29
Asian Life Insurance Co. Limited,14,1750,1711,1740,2183,3797686,1745,-5,2016-08-30
Asian Life Insurance Co. Limited,8,1730,1711,1711,1850,3186888,1721,-10,2016-09-01
Asian Life Insurance Co. Limited,9,1730,1710,1730,1593,2733154,1711,19,2016-09-04
Asian Life Insurance Co. Limited,9,1725,1700,1725,3044,5209082,1730,-5,2016-09-05
Asian Life Insurance Co. Limited,27,1730,1705,1725,4382,7547359,1725,0,2016-09-06
Asian Life Insurance Co. Limited,11,1735,1720,1720,3006,5178635,1725,-5,2016-09-07
Asian Life Insurance Co. Limited,17,1775,1720,1775,2847,4949135,1720,55,2016-09-08
Asian Life Insurance Co. Limited,27,1810,1775,1775,5224,9337882,1775,0,2016-09-11
Asian Life Insurance Co. Limited,37,1805,1772,1799,5974,10716436,1775,24,2016-09-12
Asian Life Insurance Co. Limited,34,1820,1785,1805,5648,10151057,1799,6,2016-09-14
Asian Life Insurance Co. Limited,25,1805,1735,1795,3226,5701959,1805,-10,2016-09-18
Asian Life Insurance Co. Limited,1,1790,1790,1790,100,179000,1795,-5,2016-09-20
Asian Life Insurance Co. Limited,14,1790,1736,1745,3269,5724365,1790,-45,2016-09-21
Asian Life Insurance Co. Limited,20,1750,1725,1745,2752,4791677,1745,0,2016-09-22
Asian Life Insurance Co. Limited,10,1745,1685,1700,1508,2567592,1745,-45,2016-09-25
Asian Life Insurance Co. Limited,24,1730,1690,1730,6243,10677910,1700,30,2016-09-26
Asian Life Insurance Co. Limited,8,1745,1705,1730,934,1624967,1730,0,2016-09-27
Asian Life Insurance Co. Limited,5,1720,1707,1720,348,597003,1730,-10,2016-09-28
Asian Life Insurance Co. Limited,10,1720,1712,1715,995,1708095,1720,-5,2016-09-29
Asian Life Insurance Co. Limited,4,1720,1700,1720,655,1122817,1715,5,2016-10-02
Asian Life Insurance Co. Limited,9,1740,1706,1726,1473,2544258,1720,6,2016-10-03
Asian Life Insurance Co. Limited,14,1765,1750,1765,3684,6468510,1726,39,2016-10-04
Asian Life Insurance Co. Limited,2,1755,1750,1755,155,271525,1765,-10,2016-10-05
Asian Life Insurance Co. Limited,10,1775,1755,1763,549,971380,1755,8,2016-10-06
Asian Life Insurance Co. Limited,2,1779,1755,1779,157,277935,1763,16,2016-10-16
Asian Life Insurance Co. Limited,20,1750,1725,1736,4174,7234877,1779,-43,2016-10-17
Asian Life Insurance Co. Limited,9,1759,1715,1759,1943,3372562,1736,23,2016-10-18
Asian Life Insurance Co. Limited,10,1742,1730,1731,1469,2550583,1759,-28,2016-10-19
Asian Life Insurance Co. Limited,18,1750,1730,1740,2392,4158497,1731,9,2016-10-20
Asian Life Insurance Co. Limited,3,1760,1739,1740,169,296021,1740,0,2016-10-23
Asian Life Insurance Co. Limited,13,1740,1720,1740,1323,2287270,1740,0,2016-10-24
Asian Life Insurance Co. Limited,10,1744,1712,1740,945,1643207,1740,0,2016-10-25
Asian Life Insurance Co. Limited,13,1740,1715,1740,3416,5884210,1740,0,2016-10-26
Asian Life Insurance Co. Limited,3,1720,1712,1712,272,466536,1740,-28,2016-10-27
Asian Life Insurance Co. Limited,3,1712,1700,1700,101,172684,1712,-12,2016-11-03
Asian Life Insurance Co. Limited,24,1760,1670,1735,4396,7613365,1700,35,2016-11-07
Asian Life Insurance Co. Limited,42,1800,1760,1787,9803,17336672,1735,52,2016-11-08
Asian Life Insurance Co. Limited,31,1783,1730,1760,5794,10117510,1787,-27,2016-11-09
Asian Life Insurance Co. Limited,18,1774,1730,1730,3797,6616480,1760,-30,2016-11-10
Asian Life Insurance Co. Limited,19,1740,1710,1740,2870,4971054,1730,10,2016-11-13
Asian Life Insurance Co. Limited,14,1738,1716,1738,5512,9538696,1740,-2,2016-11-14
Asian Life Insurance Co. Limited,9,1743,1716,1716,1746,3023149,1738,-22,2016-11-15
Asian Life Insurance Co. Limited,41,1795,1725,1780,6002,10589064,1716,64,2016-11-16
Asian Life Insurance Co. Limited,28,1760,1710,1735,6330,10937605,1780,-45,2016-11-17
Asian Life Insurance Co. Limited,17,1705,1642,1662,2327,3911327,1735,-73,2016-11-20
Asian Life Insurance Co. Limited,19,1700,1630,1680,2469,4088992,1662,18,2016-11-21
Asian Life Insurance Co. Limited,21,1700,1653,1666,3577,5944364,1680,-14,2016-11-22
Asian Life Insurance Co. Limited,15,1650,1570,1580,1026,1628235,1666,-86,2016-11-23
Asian Life Insurance Co. Limited,29,1611,1450,1480,3482,5194388,1580,-100,2016-11-24
Asian Life Insurance Co. Limited,22,1470,1338,1338,1862,2639744,1480,-142,2016-11-27
Asian Life Insurance Co. Limited,75,1410,1205,1410,17926,22908380,1338,72,2016-11-28
Asian Life Insurance Co. Limited,55,1479,1324,1479,16225,22286853,1410,69,2016-11-29
Asian Life Insurance Co. Limited,46,1601,1448,1601,7540,11526923,1479,122,2016-11-30
Asian Life Insurance Co. Limited,49,1600,1520,1580,7854,12328908,1601,-21,2016-12-01
Asian Life Insurance Co. Limited,42,1570,1489,1510,11384,17569500,1580,-70,2016-12-04
Asian Life Insurance Co. Limited,51,1521,1471,1475,10764,16031725,1510,-35,2016-12-05
Asian Life Insurance Co. Limited,45,1519,1472,1500,9130,13657173,1475,25,2016-12-06
Asian Life Insurance Co. Limited,14,1539,1507,1507,2520,3841241,1500,7,2016-12-07
Asian Life Insurance Co. Limited,26,1525,1464,1470,7060,10436411,1507,-37,2016-12-08
Asian Life Insurance Co. Limited,29,1499,1422,1450,6106,8781236,1470,-20,2016-12-11
Asian Life Insurance Co. Limited,42,1455,1420,1440,12735,18246037,1450,-10,2016-12-12
Asian Life Insurance Co. Limited,27,1468,1422,1450,3169,4583382,1440,10,2016-12-14
Asian Life Insurance Co. Limited,30,1520,1455,1500,8580,12690006,1450,50,2016-12-15
Asian Life Insurance Co. Limited,32,1525,1472,1525,5577,8409793,1500,25,2016-12-18
Asian Life Insurance Co. Limited,12,1530,1488,1490,808,1206900,1525,-35,2016-12-19
Asian Life Insurance Co. Limited,24,1480,1451,1451,3083,4496788,1490,-39,2016-12-20
Asian Life Insurance Co. Limited,49,1451,1420,1420,6970,9960065,1451,-31,2016-12-21
Asian Life Insurance Co. Limited,22,1450,1420,1420,2723,3912966,1420,0,2016-12-22
Asian Life Insurance Co. Limited,30,1410,1382,1384,3588,4992584,1420,-36,2016-12-26
Asian Life Insurance Co. Limited,34,1370,1304,1330,6532,8756015,1384,-54,2016-12-27
Asian Life Insurance Co. Limited,19,1383,1330,1377,3101,4207156,1330,47,2016-12-28
Asian Life Insurance Co. Limited,40,1465,1369,1400,7869,11132887,1377,23,2016-12-29
Asian Life Insurance Co. Limited,24,1428,1400,1410,7194,10130400,1400,10,2017-01-01
Asian Life Insurance Co. Limited,11,1438,1405,1411,2672,3789812,1410,1,2017-01-02
Asian Life Insurance Co. Limited,18,1411,1360,1375,2163,2973015,1411,-36,2017-01-03
Asian Life Insurance Co. Limited,6,1425,1374,1390,480,669308,1375,15,2017-01-04
Asian Life Insurance Co. Limited,10,1390,1375,1375,1940,2676800,1390,-15,2017-01-05
Asian Life Insurance Co. Limited,17,1390,1375,1390,1596,2201090,1375,15,2017-01-08
Asian Life Insurance Co. Limited,4,1422,1366,1422,395,548650,1390,32,2017-01-09
Asian Life Insurance Co. Limited,18,1458,1408,1430,1429,2058370,1422,8,2017-01-10
Asian Life Insurance Co. Limited,12,1458,1420,1420,1404,2003445,1430,-10,2017-01-11
Asian Life Insurance Co. Limited,6,1420,1400,1420,417,589446,1420,0,2017-01-12
Asian Life Insurance Co. Limited,6,1400,1392,1400,1429,1990220,1420,-20,2017-01-15
Asian Life Insurance Co. Limited,7,1400,1372,1385,2140,2945000,1400,-15,2017-01-16
Asian Life Insurance Co. Limited,14,1400,1360,1400,2447,3398550,1385,15,2017-01-17
Asian Life Insurance Co. Limited,6,1393,1390,1390,783,1089620,1400,-10,2017-01-18
Asian Life Insurance Co. Limited,25,1400,1380,1380,3482,4833920,1390,-10,2017-01-19
Asian Life Insurance Co. Limited,10,1407,1380,1380,2230,3089090,1380,0,2017-01-22
Asian Life Insurance Co. Limited,22,1377,1350,1360,3307,4496740,1380,-20,2017-01-23
Asian Life Insurance Co. Limited,31,1350,1320,1320,5175,6902860,1360,-40,2017-01-24
Asian Life Insurance Co. Limited,23,1320,1269,1269,1991,2565795,1320,-51,2017-01-25
Asian Life Insurance Co. Limited,27,1300,1245,1245,2837,3618235,1269,-24,2017-01-26
Asian Life Insurance Co. Limited,63,1244,1121,1121,12860,14623335,1245,-124,2017-01-30
Asian Life Insurance Co. Limited,79,1163,1056,1100,18638,20427973,1121,-21,2017-01-31
Asian Life Insurance Co. Limited,27,1173,1100,1173,6271,7065811,1100,73,2017-02-01
Asian Life Insurance Co. Limited,33,1195,1128,1135,5617,6527240,1173,-38,2017-02-02
Asian Life Insurance Co. Limited,19,1160,1110,1130,2510,2862800,1135,-5,2017-02-05
Asian Life Insurance Co. Limited,22,1150,1110,1110,1826,2054795,1130,-20,2017-02-06
Asian Life Insurance Co. Limited,6,1110,1090,1090,889,973190,1110,-20,2017-02-07
Asian Life Insurance Co. Limited,43,1095,1048,1075,6116,6480364,1090,-15,2017-02-08
Asian Life Insurance Co. Limited,53,1055,1014,1015,9101,9360448,1075,-60,2017-02-09
Asian Life Insurance Co. Limited,60,1035,956,956,6921,6834687,1015,-59,2017-02-12
Asian Life Insurance Co. Limited,38,998,902,998,4789,4428254,956,42,2017-02-13
Asian Life Insurance Co. Limited,39,1000,960,1000,4561,4474822,998,2,2017-02-14
Asian Life Insurance Co. Limited,129,1100,1015,1100,16582,17538033,1000,100,2017-02-15
Asian Life Insurance Co. Limited,170,1185,1106,1178,17461,20027130,1100,78,2017-02-16
Asian Life Insurance Co. Limited,122,1243,1125,1230,14697,17535935,1178,52,2017-02-19
Asian Life Insurance Co. Limited,138,1290,1200,1230,17330,21932852,1230,0,2017-02-20
Asian Life Insurance Co. Limited,81,1285,1201,1220,10922,13471815,1230,-10,2017-02-21
Asian Life Insurance Co. Limited,36,1219,1186,1188,4475,5369113,1220,-32,2017-02-22
Asian Life Insurance Co. Limited,12,1200,1176,1176,2277,2703174,1188,-12,2017-02-23
Asian Life Insurance Co. Limited,47,1156,1118,1118,3660,4154645,1176,-58,2017-02-26
Asian Life Insurance Co. Limited,50,1160,1096,1099,5208,5797108,1118,-19,2017-02-28
Asian Life Insurance Co. Limited,25,1160,1110,1160,2941,3347737,1099,61,2017-03-01
Asian Life Insurance Co. Limited,44,1183,1140,1176,5593,6500391,1160,16,2017-03-02
Asian Life Insurance Co. Limited,83,1263,1186,1250,8591,10531118,1176,74,2017-03-05
Asian Life Insurance Co. Limited,93,1280,1240,1258,11818,14921371,1260,-2,2017-03-21
Asian Life Insurance Co. Limited,120,1300,1250,1265,8299,10569287,1250,15,2017-03-06
Asian Life Insurance Co. Limited,69,1255,1222,1228,8238,10215444,1265,-37,2017-03-07
Asian Life Insurance Co. Limited,50,1280,1235,1255,5881,7406194,1228,27,2017-03-09
Asian Life Insurance Co. Limited,86,1305,1272,1296,11920,15327820,1255,41,2017-03-13
Asian Life Insurance Co. Limited,130,1313,1274,1300,17526,22660543,1296,4,2017-03-14
Asian Life Insurance Co. Limited,243,1304,1265,1299,29126,37608457,1300,-1,2017-03-15
Asian Life Insurance Co. Limited,24,1110,1085,1100,2331,2555250,1083,17,2017-03-16
Asian Life Insurance Co. Limited,20,1150,1100,1149,3400,3867590,1100,49,2017-03-19
Asian Life Insurance Co. Limited,84,1263,1162,1260,13133,15979765,1149,111,2017-03-20
Asian Life Insurance Co. Limited,69,1283,1220,1220,9589,12061951,1258,-38,2017-03-22
Asian Life Insurance Co. Limited,26,1244,1205,1220,3691,4504470,1220,0,2017-03-23
Asian Life Insurance Co. Limited,56,1319,1197,1280,7798,10057903,1220,60,2017-03-26
Asian Life Insurance Co. Limited,50,1350,1305,1348,7093,9468732,1280,68,2017-03-28
Asian Life Insurance Co. Limited,84,1374,1300,1300,9747,13057319,1348,-48,2017-03-29
Asian Life Insurance Co. Limited,30,1345,1315,1325,1891,2516865,1300,25,2017-03-30
Asian Life Insurance Co. Limited,8,1457,1351,1457,1010,1460270,1325,132,2017-04-02
Asian Life Insurance Co. Limited,291,1602,1486,1580,52051,83086113,1457,123,2017-04-03
Asian Life Insurance Co. Limited,139,1639,1520,1590,18912,30041886,1580,10,2017-04-04
Asian Life Insurance Co. Limited,145,1610,1561,1595,20908,33275457,1590,5,2017-04-06
Asian Life Insurance Co. Limited,49,1610,1580,1590,5539,8821420,1595,-5,2017-04-09
Asian Life Insurance Co. Limited,124,1630,1560,1611,28644,45800811,1590,21,2017-04-10
Asian Life Insurance Co. Limited,129,1690,1615,1680,22809,37551556,1611,69,2017-04-11
Asian Life Insurance Co. Limited,130,1709,1620,1620,23367,39366081,1680,-60,2017-04-12
Asian Life Insurance Co. Limited,81,1660,1590,1620,13242,21490254,1620,0,2017-04-13
Asian Life Insurance Co. Limited,55,1620,1566,1566,7330,11619850,1620,-54,2017-04-16
Asian Life Insurance Co. Limited,74,1560,1447,1510,9177,13885769,1566,-56,2017-04-18
Asian Life Insurance Co. Limited,56,1618,1511,1610,6385,10017535,1510,100,2017-04-19
Asian Life Insurance Co. Limited,100,1674,1600,1630,14439,23557140,1610,20,2017-04-20
Asian Life Insurance Co. Limited,80,1695,1617,1660,10945,18195323,1630,30,2017-04-23
Asian Life Insurance Co. Limited,67,1670,1615,1632,6965,11393154,1660,-28,2017-04-24
Asian Life Insurance Co. Limited,57,1640,1601,1625,8483,13791833,1632,-7,2017-04-25
Asian Life Insurance Co. Limited,21,1621,1600,1621,2485,3994367,1625,-4,2017-04-26
Asian Life Insurance Co. Limited,31,1629,1582,1601,3731,5988223,1621,-20,2017-04-27
Asian Life Insurance Co. Limited,38,1600,1560,1585,3298,5195280,1601,-16,2017-04-30
Asian Life Insurance Co. Limited,15,1620,1571,1594,3109,4949843,1585,9,2017-05-02
Asian Life Insurance Co. Limited,31,1600,1575,1575,5939,9404474,1594,-19,2017-05-03
Asian Life Insurance Co. Limited,16,1575,1561,1567,2301,3609653,1575,-8,2017-05-04
Asian Life Insurance Co. Limited,47,1580,1550,1564,5864,9116906,1567,-3,2017-05-07
Asian Life Insurance Co. Limited,24,1565,1550,1563,2275,3542357,1564,-1,2017-05-08
Asian Life Insurance Co. Limited,12,1585,1551,1584,2027,3185021,1563,21,2017-05-09
Asian Life Insurance Co. Limited,28,1608,1570,1570,4330,6809910,1584,-14,2017-05-11
Asian Life Insurance Co. Limited,19,1600,1560,1565,3390,5315440,1570,-5,2017-05-15
Asian Life Insurance Co. Limited,25,1585,1550,1561,2327,3644339,1565,-4,2017-05-16
Asian Life Insurance Co. Limited,19,1560,1552,1553,2757,4293527,1561,-8,2017-05-17
Asian Life Insurance Co. Limited,23,1555,1550,1555,1693,2627913,1553,2,2017-05-18
Asian Life Insurance Co. Limited,27,1559,1510,1526,3530,5423310,1555,-29,2017-05-21
Asian Life Insurance Co. Limited,36,1522,1498,1510,6480,9754783,1526,-16,2017-05-22
Asian Life Insurance Co. Limited,20,1540,1510,1515,5255,7998675,1510,5,2017-05-23
Asian Life Insurance Co. Limited,28,1535,1500,1534,2959,4478948,1515,19,2017-05-24
Asian Life Insurance Co. Limited,17,1530,1505,1505,2562,3885037,1534,-29,2017-05-28
Asian Life Insurance Co. Limited,50,1505,1475,1475,6092,9109239,1505,-30,2017-05-30
Asian Life Insurance Co. Limited,44,1503,1452,1501,4552,6683635,1475,26,2017-05-31
Asian Life Insurance Co. Limited,29,1500,1485,1489,3170,4728564,1501,-12,2017-06-01
Asian Life Insurance Co. Limited,23,1480,1455,1475,2727,4003075,1489,-14,2017-06-04
Asian Life Insurance Co. Limited,14,1498,1450,1491,2684,3977727,1475,16,2017-06-05
Asian Life Insurance Co. Limited,22,1530,1500,1518,2531,3827485,1491,27,2017-06-06
Asian Life Insurance Co. Limited,28,1530,1500,1506,4286,6487680,1518,-12,2017-06-07
Asian Life Insurance Co. Limited,57,1545,1510,1514,6924,10524740,1506,8,2017-06-08
Asian Life Insurance Co. Limited,60,1503,1490,1490,8528,12750018,1514,-24,2017-06-11
Asian Life Insurance Co. Limited,25,1499,1446,1474,1370,2017765,1490,-16,2017-06-12
Asian Life Insurance Co. Limited,13,1490,1470,1476,580,860896,1474,2,2017-06-13
Asian Life Insurance Co. Limited,20,1504,1480,1490,2391,3555673,1476,14,2017-06-14
Asian Life Insurance Co. Limited,22,1516,1480,1488,2169,3233762,1490,-2,2017-06-15
Asian Life Insurance Co. Limited,55,1519,1487,1500,5563,8376235,1488,12,2017-06-18
Asian Life Insurance Co. Limited,21,1501,1470,1487,1339,1979059,1500,-13,2017-06-19
Asian Life Insurance Co. Limited,15,1500,1465,1480,864,1278040,1487,-7,2017-06-20
Asian Life Insurance Co. Limited,23,1500,1461,1465,1831,2704734,1480,-15,2017-06-21
Asian Life Insurance Co. Limited,11,1494,1466,1466,496,733936,1465,1,2017-06-22
Asian Life Insurance Co. Limited,31,1490,1466,1466,4317,6347898,1466,0,2017-06-25
Asian Life Insurance Co. Limited,23,1489,1460,1487,2186,3233030,1466,21,2017-06-27
Asian Life Insurance Co. Limited,18,1486,1475,1486,2202,3257664,1487,-1,2017-06-28
Asian Life Insurance Co. Limited,22,1485,1450,1450,1760,2563088,1486,-36,2017-07-02
Asian Life Insurance Co. Limited,19,1460,1450,1452,1298,1884910,1450,2,2017-07-03
Asian Life Insurance Co. Limited,18,1469,1446,1446,988,1440256,1452,-6,2017-07-04
Asian Life Insurance Co. Limited,30,1455,1441,1455,3800,5499608,1446,9,2017-07-05
Asian Life Insurance Co. Limited,37,1484,1445,1484,8837,12872794,1455,29,2017-07-06
Asian Life Insurance Co. Limited,34,1512,1445,1473,5260,7803560,1484,-11,2017-07-09
Asian Life Insurance Co. Limited,20,1475,1445,1452,1904,2782613,1473,-21,2017-07-10
Asian Life Insurance Co. Limited,23,1480,1455,1470,5674,8312935,1452,18,2017-07-11
Asian Life Insurance Co. Limited,12,1470,1460,1460,1930,2821000,1470,-10,2017-07-12
Asian Life Insurance Co. Limited,40,1465,1450,1458,6010,8733359,1460,-2,2017-07-13
Asian Life Insurance Co. Limited,21,1469,1445,1460,2404,3494676,1458,2,2017-07-16
Asian Life Insurance Co. Limited,17,1490,1468,1480,1914,2844325,1460,20,2017-07-17
Asian Life Insurance Co. Limited,83,1554,1481,1554,15229,23082333,1480,74,2017-07-18
Asian Life Insurance Co. Limited,43,1640,1599,1611,4116,6660030,1631,-20,2017-08-03
Asian Life Insurance Co. Limited,65,1565,1525,1530,10115,15566547,1554,-24,2017-07-19
Asian Life Insurance Co. Limited,28,1555,1530,1542,1731,2673740,1530,12,2017-07-20
Asian Life Insurance Co. Limited,75,1600,1552,1574,8665,13665731,1542,32,2017-07-23
Asian Life Insurance Co. Limited,80,1594,1570,1585,8700,13766792,1574,11,2017-07-24
Asian Life Insurance Co. Limited,137,1634,1580,1634,19548,31320674,1585,49,2017-07-25
Asian Life Insurance Co. Limited,129,1695,1635,1695,13266,22126519,1634,61,2017-07-26
Asian Life Insurance Co. Limited,85,1723,1660,1667,8895,14858435,1695,-28,2017-07-27
Asian Life Insurance Co. Limited,83,1680,1639,1680,7398,12244953,1667,13,2017-07-30
Asian Life Insurance Co. Limited,45,1670,1627,1631,4293,7053875,1680,-49,2017-07-31
Asian Life Insurance Co. Limited,48,1647,1625,1635,4029,6579839,1631,4,2017-08-01
Asian Life Insurance Co. Limited,24,1645,1630,1631,1632,2666433,1635,-4,2017-08-02
Asian Life Insurance Co. Limited,45,1600,1575,1587,5172,8212227,1611,-24,2017-08-06
Asian Life Insurance Co. Limited,64,1600,1587,1600,7566,12061386,1587,13,2017-08-07
Asian Life Insurance Co. Limited,73,1630,1605,1628,11446,18542837,1600,28,2017-08-09
Asian Life Insurance Co. Limited,49,1628,1597,1624,7625,12250034,1628,-4,2017-08-10
Asian Life Insurance Co. Limited,47,1615,1599,1601,5097,8160110,1624,-23,2017-08-13
Asian Life Insurance Co. Limited,28,1603,1580,1580,2096,3326125,1601,-21,2017-08-15
Asian Life Insurance Co. Limited,40,1600,1580,1593,8272,13159389,1580,13,2017-08-16
Asian Life Insurance Co. Limited,37,1595,1579,1590,4066,6432103,1593,-3,2017-08-17
Asian Life Insurance Co. Limited,25,1590,1575,1585,2594,4103439,1590,-5,2017-08-20
Asian Life Insurance Co. Limited,17,1590,1575,1581,1180,1867472,1585,-4,2017-08-21
Asian Life Insurance Co. Limited,30,1612,1570,1600,3339,5295519,1581,19,2017-08-22
Asian Life Insurance Co. Limited,29,1601,1588,1601,3050,4856479,1600,1,2017-08-23
Asian Life Insurance Co. Limited,26,1620,1594,1613,1587,2547483,1601,12,2017-08-24
Asian Life Insurance Co. Limited,55,1615,1590,1600,4425,7094349,1613,-13,2017-08-27
Asian Life Insurance Co. Limited,14,1600,1572,1600,1592,2529540,1600,0,2017-08-28
Asian Life Insurance Co. Limited,43,1600,1580,1596,3018,4789125,1600,-4,2017-08-30
Asian Life Insurance Co. Limited,33,1596,1541,1555,3384,5272960,1596,-41,2017-08-31
Asian Life Insurance Co. Limited,64,1555,1500,1508,8672,13172345,1555,-47,2017-09-04
Asian Life Insurance Co. Limited,14,1549,1490,1535,708,1082024,1508,27,2017-09-06
Asian Life Insurance Co. Limited,17,1565,1525,1550,2487,3820310,1535,15,2017-09-07
Asian Life Insurance Co. Limited,22,1550,1505,1520,3205,4893327,1550,-30,2017-09-10
Asian Life Insurance Co. Limited,36,1525,1492,1514,5964,8982065,1520,-6,2017-09-11
Asian Life Insurance Co. Limited,41,1505,1460,1470,4496,6642025,1514,-44,2017-09-12
Asian Life Insurance Co. Limited,38,1495,1453,1461,5097,7476900,1470,-9,2017-09-13
Asian Life Insurance Co. Limited,25,1503,1450,1503,2164,3201171,1461,42,2017-09-14
Asian Life Insurance Co. Limited,47,1533,1490,1508,11371,17028440,1503,5,2017-09-17
Asian Life Insurance Co. Limited,15,1508,1490,1498,1626,2431787,1508,-10,2017-09-18
Asian Life Insurance Co. Limited,16,1500,1479,1489,1304,1942630,1498,-9,2017-09-20
Asian Life Insurance Co. Limited,16,1468,1440,1468,2804,4058340,1441,27,2017-10-09
Asian Life Insurance Co. Limited,12,1495,1490,1491,1710,2552045,1489,2,2017-09-24
Asian Life Insurance Co. Limited,10,1499,1490,1492,1561,2329274,1491,1,2017-09-25
Asian Life Insurance Co. Limited,17,1505,1498,1505,2383,3574850,1492,13,2017-09-26
Asian Life Insurance Co. Limited,5,1505,1486,1495,870,1296300,1505,-10,2017-10-03
Asian Life Insurance Co. Limited,2,1500,1500,1500,345,517500,1495,5,2017-10-04
Asian Life Insurance Co. Limited,31,1471,1441,1441,2315,3352605,1500,-59,2017-10-08
Asian Life Insurance Co. Limited,8,1485,1461,1465,514,754382,1468,-3,2017-10-10
Asian Life Insurance Co. Limited,13,1470,1460,1460,1980,2893477,1465,-5,2017-10-11
Asian Life Insurance Co. Limited,8,1470,1463,1470,574,841724,1460,10,2017-10-12
Asian Life Insurance Co. Limited,12,1475,1450,1475,452,660140,1470,5,2017-10-15
Asian Life Insurance Co. Limited,19,1514,1473,1514,1914,2863324,1475,39,2017-10-16
Asian Life Insurance Co. Limited,25,1538,1504,1519,1934,2929718,1514,5,2017-10-17
Asian Life Insurance Co. Limited,22,1549,1501,1549,2688,4090264,1519,30,2017-10-18
Asian Life Insurance Co. Limited,5,1577,1535,1535,119,183925,1549,-14,2017-10-22
Asian Life Insurance Co. Limited,10,1549,1522,1530,872,1330653,1535,-5,2017-10-23
Asian Life Insurance Co. Limited,14,1510,1495,1510,713,1070505,1530,-20,2017-10-24
Asian Life Insurance Co. Limited,24,1520,1480,1520,3823,5700665,1510,10,2017-10-25
Asian Life Insurance Co. Limited,13,1520,1490,1492,1720,2578828,1520,-28,2017-10-29
Asian Life Insurance Co. Limited,5,1490,1489,1490,186,277024,1492,-2,2017-10-30
Asian Life Insurance Co. Limited,10,1515,1480,1480,478,710345,1490,-10,2017-10-31
Asian Life Insurance Co. Limited,19,1461,1440,1456,2454,3562969,1480,-24,2017-11-01
Asian Life Insurance Co. Limited,33,1456,1435,1450,3583,5180878,1456,-6,2017-11-02
Asian Life Insurance Co. Limited,54,1445,1425,1426,5768,8245346,1450,-24,2017-11-05
Asian Life Insurance Co. Limited,25,1450,1421,1424,4142,5918782,1426,-2,2017-11-06
Asian Life Insurance Co. Limited,28,1430,1405,1425,2412,3426248,1424,1,2017-11-07
Asian Life Insurance Co. Limited,13,1410,1390,1397,949,1325952,1425,-28,2017-11-08
Asian Life Insurance Co. Limited,24,1420,1366,1399,3336,4650658,1397,2,2017-11-09
Asian Life Insurance Co. Limited,3,1407,1405,1407,250,351556,1399,8,2017-11-12
Asian Life Insurance Co. Limited,30,1437,1395,1437,5009,7070634,1407,30,2017-11-13
Asian Life Insurance Co. Limited,21,1467,1432,1440,2327,3350347,1437,3,2017-11-14
Asian Life Insurance Co. Limited,18,1435,1415,1435,1847,2638120,1440,-5,2017-11-15
Asian Life Insurance Co. Limited,9,1430,1420,1420,809,1151300,1435,-15,2017-11-16
Asian Life Insurance Co. Limited,11,1420,1380,1393,3164,4424950,1420,-27,2017-11-19
Asian Life Insurance Co. Limited,17,1410,1392,1410,1381,1923906,1393,17,2017-11-20
Asian Life Insurance Co. Limited,21,1420,1390,1400,2527,3546905,1410,-10,2017-11-21
Asian Life Insurance Co. Limited,13,1405,1400,1405,1195,1675400,1400,5,2017-11-22
Asian Life Insurance Co. Limited,16,1410,1400,1402,594,833769,1405,-3,2017-11-23
Asian Life Insurance Co. Limited,13,1449,1400,1437,976,1393445,1402,35,2017-11-26
Asian Life Insurance Co. Limited,16,1440,1410,1421,2335,3324480,1437,-16,2017-11-27
Asian Life Insurance Co. Limited,5,1435,1425,1425,613,878545,1421,4,2017-11-28
Asian Life Insurance Co. Limited,7,1468,1425,1440,636,924121,1425,15,2017-11-29
Asian Life Insurance Co. Limited,13,1468,1447,1460,991,1447390,1440,20,2017-11-30
Asian Life Insurance Co. Limited,8,1449,1430,1440,626,900973,1460,-20,2017-12-04
Asian Life Insurance Co. Limited,14,1440,1432,1433,1686,2416992,1449,-16,2017-12-20
Asian Life Insurance Co. Limited,53,1485,1455,1485,4497,6622093,1440,45,2017-12-05
Asian Life Insurance Co. Limited,49,1512,1482,1512,7248,10877681,1485,27,2017-12-06
Asian Life Insurance Co. Limited,9,1500,1479,1499,1121,1663843,1512,-13,2017-12-10
Asian Life Insurance Co. Limited,14,1498,1453,1482,2054,3054349,1499,-17,2017-12-11
Asian Life Insurance Co. Limited,22,1455,1435,1437,1681,2426623,1482,-45,2017-12-12
Asian Life Insurance Co. Limited,11,1462,1435,1462,1248,1817430,1437,25,2017-12-13
Asian Life Insurance Co. Limited,17,1460,1449,1449,2111,3064869,1462,-13,2017-12-14
Asian Life Insurance Co. Limited,10,1452,1440,1440,497,716544,1449,-9,2017-12-17
Asian Life Insurance Co. Limited,27,1455,1438,1441,6659,9619438,1440,1,2017-12-18
Asian Life Insurance Co. Limited,17,1449,1440,1449,846,1219417,1441,8,2017-12-19
Asian Life Insurance Co. Limited,20,1430,1410,1425,3110,4420200,1433,-8,2017-12-21
Asian Life Insurance Co. Limited,15,1450,1425,1425,1913,2735065,1425,0,2017-12-24
Asian Life Insurance Co. Limited,22,1405,1393,1394,3234,4514240,1425,-31,2017-12-26
Asian Life Insurance Co. Limited,31,1399,1371,1380,4427,6133885,1394,-14,2017-12-27
Asian Life Insurance Co. Limited,30,1395,1360,1384,4164,5704809,1380,4,2017-12-28
Asian Life Insurance Co. Limited,10,1380,1363,1372,760,1042110,1384,-12,2017-12-31
Asian Life Insurance Co. Limited,28,1404,1365,1403,4831,6694213,1372,31,2018-01-01
Asian Life Insurance Co. Limited,24,1419,1380,1381,2506,3487987,1403,-22,2018-01-02
Asian Life Insurance Co. Limited,10,1381,1365,1366,870,1194555,1381,-15,2018-01-03
Asian Life Insurance Co. Limited,27,1380,1361,1361,3546,4847995,1366,-5,2018-01-04
Asian Life Insurance Co. Limited,9,1388,1344,1375,386,527582,1361,14,2018-01-07
Asian Life Insurance Co. Limited,44,1450,1399,1450,8299,11743359,1375,75,2018-01-08
Asian Life Insurance Co. Limited,49,1452,1420,1420,6091,8717803,1450,-30,2018-01-09
Asian Life Insurance Co. Limited,58,1448,1391,1400,3810,5368806,1420,-20,2018-01-10
Asian Life Insurance Co. Limited,31,1401,1375,1383,2268,3141006,1400,-17,2018-01-14
Asian Life Insurance Co. Limited,35,1390,1359,1365,4454,6092179,1383,-18,2018-01-16
Asian Life Insurance Co. Limited,56,1353,1338,1339,8799,11847723,1365,-26,2018-01-17
Asian Life Insurance Co. Limited,177,1350,1316,1316,18945,25263216,1339,-23,2018-01-21
Asian Life Insurance Co. Limited,32,911,885,891,2651,2362711,911,-20,2018-01-22
Asian Life Insurance Co. Limited,20,890,878,878,1075,947476,891,-13,2018-01-23
Asian Life Insurance Co. Limited,8,880,878,879,1094,961598,878,1,2018-01-24
Asian Life Insurance Co. Limited,29,905,880,905,2893,2578212,879,26,2018-01-25
Asian Life Insurance Co. Limited,23,905,880,887,2316,2055396,905,-18,2018-01-28
Asian Life Insurance Co. Limited,11,885,875,883,836,735647,887,-4,2018-01-29
Asian Life Insurance Co. Limited,13,884,870,880,810,708718,883,-3,2018-01-31
Asian Life Insurance Co. Limited,12,885,876,877,1447,1269856,880,-3,2018-02-01
Asian Life Insurance Co. Limited,19,880,872,872,1401,1226052,877,-5,2018-02-04
Asian Life Insurance Co. Limited,10,870,865,865,665,576850,872,-7,2018-02-05
Asian Life Insurance Co. Limited,2,865,860,865,113,97430,865,0,2018-02-06
Asian Life Insurance Co. Limited,16,860,840,840,995,843338,865,-25,2018-02-07
Asian Life Insurance Co. Limited,22,855,841,855,2709,2291961,840,15,2018-02-08
Asian Life Insurance Co. Limited,8,846,840,840,291,245514,845,-5,2018-02-25
Asian Life Insurance Co. Limited,12,867,846,867,1642,1394472,855,12,2018-02-11
Asian Life Insurance Co. Limited,12,861,845,855,871,739981,867,-12,2018-02-12
Asian Life Insurance Co. Limited,19,860,842,860,1626,1378330,855,5,2018-02-14
Asian Life Insurance Co. Limited,20,902,860,902,2508,2178427,860,42,2018-02-15
Asian Life Insurance Co. Limited,32,920,875,890,2937,2629463,902,-12,2018-02-18
Asian Life Insurance Co. Limited,9,890,856,872,1154,1002944,890,-18,2018-02-20
Asian Life Insurance Co. Limited,5,860,854,854,251,214632,872,-18,2018-02-21
Asian Life Insurance Co. Limited,11,855,843,845,738,626365,854,-9,2018-02-22
Asian Life Insurance Co. Limited,16,835,811,820,1275,1051105,840,-20,2018-02-26
Asian Life Insurance Co. Limited,16,835,812,820,1458,1200240,820,0,2018-02-27
Asian Life Insurance Co. Limited,13,820,800,805,1490,1198460,820,-15,2018-02-28
Asian Life Insurance Co. Limited,20,805,745,759,2044,1596315,805,-46,2018-03-04
Asian Life Insurance Co. Limited,22,752,731,731,1463,1083675,759,-28,2018-03-05
Asian Life Insurance Co. Limited,23,758,710,758,2165,1553630,731,27,2018-03-06
Asian Life Insurance Co. Limited,25,765,743,761,2514,1890416,758,3,2018-03-07
Asian Life Insurance Co. Limited,37,746,704,707,4184,3013592,761,-54,2018-03-11
Asian Life Insurance Co. Limited,22,719,700,700,1481,1042100,707,-7,2018-03-12
Asian Life Insurance Co. Limited,4,705,702,705,370,260150,700,5,2018-03-13
Asian Life Insurance Co. Limited,1,710,710,710,38,26980,705,5,2018-03-14
Asian Life Insurance Co. Limited,10,724,702,702,1055,745188,710,-8,2018-03-15
Asian Life Insurance Co. Limited,20,702,697,702,1349,944278,702,0,2018-03-18
Asian Life Insurance Co. Limited,13,700,689,689,1099,761310,702,-13,2018-03-19
Asian Life Insurance Co. Limited,30,690,663,663,2337,1565425,689,-26,2018-03-20
Asian Life Insurance Co. Limited,18,660,635,640,1600,1034368,663,-23,2018-03-21
Asian Life Insurance Co. Limited,27,646,600,633,3874,2380056,640,-7,2018-03-22
Asian Life Insurance Co. Limited,27,621,570,570,2440,1448740,633,-63,2018-03-26
Asian Life Insurance Co. Limited,60,608,529,581,7171,4108749,570,11,2018-03-27
Asian Life Insurance Co. Limited,74,591,560,560,8019,4606467,581,-21,2018-03-28
Asian Life Insurance Co. Limited,26,591,571,584,2040,1184795,560,24,2018-03-29
Asian Life Insurance Co. Limited,30,586,560,580,3028,1750108,584,-4,2018-04-01
Asian Life Insurance Co. Limited,8,591,580,589,383,223885,580,9,2018-04-02
Asian Life Insurance Co. Limited,19,600,579,600,1864,1090342,589,11,2018-04-03
Asian Life Insurance Co. Limited,25,624,605,620,2317,1418245,600,20,2018-04-04
Asian Life Insurance Co. Limited,57,650,600,650,8414,5338842,620,30,2018-04-05
Asian Life Insurance Co. Limited,68,715,640,680,9002,6204792,650,30,2018-04-08
Asian Life Insurance Co. Limited,83,730,680,700,8861,6263742,680,20,2018-04-09
Asian Life Insurance Co. Limited,52,725,675,680,4394,3058645,700,-20,2018-04-10
Asian Life Insurance Co. Limited,45,693,653,693,5321,3579513,680,13,2018-04-11
Asian Life Insurance Co. Limited,54,717,696,700,8218,5793229,693,7,2018-04-12
Asian Life Insurance Co. Limited,37,718,672,718,4093,2840028,700,18,2018-04-15
Asian Life Insurance Co. Limited,137,789,715,789,17368,12994977,718,71,2018-04-16
Asian Life Insurance Co. Limited,181,867,785,867,18025,14720153,789,78,2018-04-17
Asian Life Insurance Co. Limited,171,890,827,830,19435,16699971,867,-37,2018-04-18
Asian Life Insurance Co. Limited,107,872,838,860,15448,13238797,830,30,2018-04-19
Asian Life Insurance Co. Limited,74,914,865,914,10547,9371044,860,54,2018-04-22
Asian Life Insurance Co. Limited,112,940,865,870,13566,12251528,914,-44,2018-04-23
Asian Life Insurance Co. Limited,71,900,845,882,9228,8096065,870,12,2018-04-24
Asian Life Insurance Co. Limited,67,886,860,874,11250,9775575,882,-8,2018-04-25
Asian Life Insurance Co. Limited,124,857,830,831,17824,15025909,874,-43,2018-04-26
Asian Life Insurance Co. Limited,35,847,816,831,6798,5627804,831,0,2018-04-29
Asian Life Insurance Co. Limited,15,858,825,858,3182,2676058,831,27,2018-05-02
Asian Life Insurance Co. Limited,35,869,852,852,6112,5232273,858,-6,2018-05-03
Asian Life Insurance Co. Limited,24,859,851,853,3883,3311650,852,1,2018-05-06
Asian Life Insurance Co. Limited,14,855,850,854,2565,2188182,853,1,2018-05-07
Asian Life Insurance Co. Limited,114,885,856,878,14113,12202385,854,24,2018-05-08
Asian Life Insurance Co. Limited,64,885,875,875,4386,3862284,878,-3,2018-05-09
Asian Life Insurance Co. Limited,28,890,865,870,2628,2292373,875,-5,2018-05-10
Asian Life Insurance Co. Limited,21,863,853,858,2369,2033050,870,-12,2018-05-14
Asian Life Insurance Co. Limited,16,848,840,840,2613,2206090,858,-18,2018-05-15
Asian Life Insurance Co. Limited,17,856,850,850,2375,2024825,840,10,2018-05-16
Asian Life Insurance Co. Limited,35,867,851,853,2531,2164830,850,3,2018-05-17
Asian Life Insurance Co. Limited,24,817,804,804,4220,3417750,820,-16,2018-05-20
Asian Life Insurance Co. Limited,14,802,790,790,2160,1708340,804,-14,2018-05-21
Asian Life Insurance Co. Limited,15,785,766,777,2485,1930031,790,-13,2018-05-22
