companyname,numberoftransaction,maxprice,minprice,closingprice,tradedshares,amount,previousclosing,difference,date
Bank of Kathmandu Ltd.,7,510,473,510,4437,2248769,464,46,2016-09-28
Bank of Kathmandu Ltd.,5,561,520,561,50,27010,510,51,2016-09-29
Bank of Kathmandu Ltd.,6,617,572,617,469,288233,561,56,2016-10-02
Bank of Kathmandu Ltd.,7,678,629,678,420,283410,617,61,2016-10-03
Bank of Kathmandu Ltd.,17,745,691,745,3322,2473540,678,67,2016-10-04
Bank of Kathmandu Ltd.,1258,819,755,787,381177,298821622,745,42,2016-10-05
Bank of Kathmandu Ltd.,653,794,775,780,178136,139315580,787,-7,2016-10-06
Bank of Kathmandu Ltd.,229,780,755,764,58598,44628295,780,-16,2016-10-16
Bank of Kathmandu Ltd.,304,770,736,752,75678,56632146,764,-12,2016-10-17
Bank of Kathmandu Ltd.,246,753,715,740,51936,38553106,752,-12,2016-10-18
Bank of Kathmandu Ltd.,173,751,735,738,34634,25557977,740,-2,2016-10-19
Bank of Kathmandu Ltd.,202,744,739,741,40919,30330712,738,3,2016-10-20
Bank of Kathmandu Ltd.,230,750,723,730,48414,35292211,741,-11,2016-10-23
Bank of Kathmandu Ltd.,193,728,713,719,35840,25731388,730,-11,2016-10-24
Bank of Kathmandu Ltd.,157,730,706,720,39244,27867100,719,1,2016-10-25
Bank of Kathmandu Ltd.,170,720,707,718,36563,26063174,720,-2,2016-10-26
Bank of Kathmandu Ltd.,205,729,714,719,45651,32855530,718,1,2016-10-27
Bank of Kathmandu Ltd.,105,720,710,713,22970,16445127,719,-6,2016-11-03
Bank of Kathmandu Ltd.,153,714,705,706,49484,35049382,713,-7,2016-11-07
Bank of Kathmandu Ltd.,197,707,691,700,53317,37143505,706,-6,2016-11-08
Bank of Kathmandu Ltd.,177,700,666,688,42648,29353179,700,-12,2016-11-09
Bank of Kathmandu Ltd.,263,693,670,688,63495,43164697,688,0,2016-11-10
Bank of Kathmandu Ltd.,175,688,666,676,42870,29120790,688,-12,2016-11-13
Bank of Kathmandu Ltd.,205,705,666,698,60427,41620122,676,22,2016-11-14
Bank of Kathmandu Ltd.,257,710,692,698,66240,46245204,698,0,2016-11-15
Bank of Kathmandu Ltd.,115,700,690,691,19983,13853338,698,-7,2016-11-16
Bank of Kathmandu Ltd.,223,690,660,675,53578,36194636,691,-16,2016-11-17
Bank of Kathmandu Ltd.,346,688,638,655,77691,50652743,675,-20,2016-11-20
Bank of Kathmandu Ltd.,271,669,631,658,67806,44022568,655,3,2016-11-21
Bank of Kathmandu Ltd.,290,659,615,644,58544,37697393,658,-14,2016-11-22
Bank of Kathmandu Ltd.,402,650,620,630,77629,49037931,644,-14,2016-11-23
Bank of Kathmandu Ltd.,317,654,620,629,63443,40128467,630,-1,2016-11-24
Bank of Kathmandu Ltd.,338,635,611,617,73178,45405731,629,-12,2016-11-27
Bank of Kathmandu Ltd.,398,650,595,646,109608,67365565,617,29,2016-11-28
Bank of Kathmandu Ltd.,459,658,609,651,96962,62635770,646,5,2016-11-29
Bank of Kathmandu Ltd.,511,675,652,669,90494,60208034,651,18,2016-11-30
Bank of Kathmandu Ltd.,415,682,654,669,66851,44807863,669,0,2016-12-01
Bank of Kathmandu Ltd.,228,681,649,660,40874,27080926,669,-9,2016-12-04
Bank of Kathmandu Ltd.,240,660,646,653,45679,29750945,660,-7,2016-12-05
Bank of Kathmandu Ltd.,197,670,647,660,38914,25497642,653,7,2016-12-06
Bank of Kathmandu Ltd.,171,673,633,658,31067,20399428,660,-2,2016-12-07
Bank of Kathmandu Ltd.,150,658,650,656,20692,13528561,658,-2,2016-12-08
Bank of Kathmandu Ltd.,206,658,640,641,34307,22225577,656,-15,2016-12-11
Bank of Kathmandu Ltd.,161,648,620,637,26635,16925878,641,-4,2016-12-12
Bank of Kathmandu Ltd.,145,645,635,639,25739,16442300,637,2,2016-12-14
Bank of Kathmandu Ltd.,144,651,635,650,27803,17887178,639,11,2016-12-15
Bank of Kathmandu Ltd.,262,650,638,646,41502,26637395,650,-4,2016-12-18
Bank of Kathmandu Ltd.,196,650,636,643,34377,21994583,646,-3,2016-12-19
Bank of Kathmandu Ltd.,171,640,625,625,25930,16437553,643,-18,2016-12-20
Bank of Kathmandu Ltd.,166,627,620,621,29990,18687145,625,-4,2016-12-21
Bank of Kathmandu Ltd.,105,626,615,620,19840,12332470,621,-1,2016-12-22
Bank of Kathmandu Ltd.,260,615,600,603,55924,33782626,620,-17,2016-12-26
Bank of Kathmandu Ltd.,206,609,578,595,43724,25960533,603,-8,2016-12-27
Bank of Kathmandu Ltd.,167,607,592,600,29792,17824865,595,5,2016-12-28
Bank of Kathmandu Ltd.,223,625,596,615,42205,25813924,600,15,2016-12-29
Bank of Kathmandu Ltd.,193,631,620,625,29831,18595774,615,10,2017-01-01
Bank of Kathmandu Ltd.,214,640,623,625,37538,23650798,625,0,2017-01-02
Bank of Kathmandu Ltd.,160,627,610,612,25697,15894419,625,-13,2017-01-03
Bank of Kathmandu Ltd.,116,618,600,614,16585,10162839,612,2,2017-01-04
Bank of Kathmandu Ltd.,119,632,603,612,21291,13111973,614,-2,2017-01-05
Bank of Kathmandu Ltd.,98,614,606,613,149829,91243153,612,1,2017-01-08
Bank of Kathmandu Ltd.,76,616,610,616,14193,8704056,613,3,2017-01-09
Bank of Kathmandu Ltd.,81,626,617,621,16048,9987547,616,5,2017-01-10
Bank of Kathmandu Ltd.,78,626,619,619,11953,7429264,621,-2,2017-01-11
Bank of Kathmandu Ltd.,60,620,614,614,11035,6811290,619,-5,2017-01-12
Bank of Kathmandu Ltd.,51,616,610,612,10360,6339781,614,-2,2017-01-15
Bank of Kathmandu Ltd.,44,613,608,609,7024,4284353,612,-3,2017-01-16
Bank of Kathmandu Ltd.,73,611,600,610,19781,12020579,609,1,2017-01-17
Bank of Kathmandu Ltd.,43,613,608,611,11726,7163864,610,1,2017-01-18
Bank of Kathmandu Ltd.,56,611,601,609,9518,5793197,611,-2,2017-01-19
Bank of Kathmandu Ltd.,56,611,605,606,12086,7338585,609,-3,2017-01-22
Bank of Kathmandu Ltd.,92,607,600,603,17889,10770634,606,-3,2017-01-23
Bank of Kathmandu Ltd.,106,603,590,596,21459,12776623,603,-7,2017-01-24
Bank of Kathmandu Ltd.,106,596,578,585,18628,10866042,596,-11,2017-01-25
Bank of Kathmandu Ltd.,168,585,565,570,32501,18644181,585,-15,2017-01-26
Bank of Kathmandu Ltd.,189,573,537,540,37872,20671684,570,-30,2017-01-30
Bank of Kathmandu Ltd.,102,560,510,545,16759,8955600,540,5,2017-01-31
Bank of Kathmandu Ltd.,113,573,548,573,24179,13625747,545,28,2017-02-01
Bank of Kathmandu Ltd.,167,595,560,570,28786,16529866,573,-3,2017-02-02
Bank of Kathmandu Ltd.,81,565,553,558,8133,4548835,570,-12,2017-02-05
Bank of Kathmandu Ltd.,70,561,544,550,12842,7071894,558,-8,2017-02-06
Bank of Kathmandu Ltd.,65,550,534,548,7990,4338677,550,-2,2017-02-07
Bank of Kathmandu Ltd.,89,550,535,541,15736,8511349,548,-7,2017-02-08
Bank of Kathmandu Ltd.,143,540,525,526,24053,12776920,541,-15,2017-02-09
Bank of Kathmandu Ltd.,144,525,500,508,25795,13269350,526,-18,2017-02-12
Bank of Kathmandu Ltd.,216,527,490,525,52492,26344511,508,17,2017-02-13
Bank of Kathmandu Ltd.,158,528,512,519,26751,13932842,525,-6,2017-02-14
Bank of Kathmandu Ltd.,138,531,513,531,39286,20487911,519,12,2017-02-15
Bank of Kathmandu Ltd.,333,548,526,548,76411,40961688,531,17,2017-02-16
Bank of Kathmandu Ltd.,321,558,539,548,57690,31654601,548,0,2017-02-19
Bank of Kathmandu Ltd.,286,559,544,546,58284,32133075,548,-2,2017-02-20
Bank of Kathmandu Ltd.,247,564,539,539,43351,23744428,546,-7,2017-02-21
Bank of Kathmandu Ltd.,182,545,530,531,27687,14853621,539,-8,2017-02-22
Bank of Kathmandu Ltd.,493,536,529,529,87307,46478112,531,-2,2017-02-23
Bank of Kathmandu Ltd.,110,426,408,412,21747,9044099,430,-18,2017-02-26
Bank of Kathmandu Ltd.,73,412,401,409,13178,5361811,412,-3,2017-02-28
Bank of Kathmandu Ltd.,46,416,409,415,8384,3457952,409,6,2017-03-01
Bank of Kathmandu Ltd.,54,418,413,417,8740,3633825,415,2,2017-03-02
Bank of Kathmandu Ltd.,80,420,410,418,15674,6548196,417,1,2017-03-05
Bank of Kathmandu Ltd.,104,445,427,445,27748,12224575,434,11,2017-03-21
Bank of Kathmandu Ltd.,71,435,417,423,12979,5497401,418,5,2017-03-06
Bank of Kathmandu Ltd.,48,423,415,416,8537,3550995,423,-7,2017-03-07
Bank of Kathmandu Ltd.,32,421,415,415,4446,1850555,416,-1,2017-03-09
Bank of Kathmandu Ltd.,18,423,415,417,2969,1239109,415,2,2017-03-13
Bank of Kathmandu Ltd.,71,418,409,409,13746,5679666,417,-8,2017-03-14
Bank of Kathmandu Ltd.,37,412,406,409,8811,3614036,409,0,2017-03-15
Bank of Kathmandu Ltd.,49,417,409,411,16417,6748735,409,2,2017-03-16
Bank of Kathmandu Ltd.,71,415,409,415,22955,9484747,411,4,2017-03-19
Bank of Kathmandu Ltd.,109,438,417,434,24270,10356719,415,19,2017-03-20
Bank of Kathmandu Ltd.,171,462,435,440,32282,14648477,445,-5,2017-03-22
Bank of Kathmandu Ltd.,133,454,435,450,23724,10575205,440,10,2017-03-23
Bank of Kathmandu Ltd.,140,475,446,465,34806,16158039,450,15,2017-03-26
Bank of Kathmandu Ltd.,132,498,460,490,54876,26550543,465,25,2017-03-28
Bank of Kathmandu Ltd.,229,516,474,474,59171,29101053,490,-16,2017-03-29
Bank of Kathmandu Ltd.,112,485,463,470,30548,14443957,474,-4,2017-03-30
Bank of Kathmandu Ltd.,93,510,479,510,46216,22835590,470,40,2017-04-02
Bank of Kathmandu Ltd.,228,560,495,505,72939,38601135,510,-5,2017-04-03
Bank of Kathmandu Ltd.,142,511,496,500,39066,19711214,505,-5,2017-04-04
Bank of Kathmandu Ltd.,144,508,491,500,39265,19634485,500,0,2017-04-06
Bank of Kathmandu Ltd.,140,525,504,516,40237,20713633,500,16,2017-04-09
Bank of Kathmandu Ltd.,196,541,510,530,67764,35562651,516,14,2017-04-10
Bank of Kathmandu Ltd.,205,558,534,547,56543,30964003,530,17,2017-04-11
Bank of Kathmandu Ltd.,161,557,530,530,38975,21399528,547,-17,2017-04-12
Bank of Kathmandu Ltd.,146,539,510,529,32412,17112733,530,-1,2017-04-13
Bank of Kathmandu Ltd.,136,530,510,513,43820,22631133,529,-16,2017-04-16
Bank of Kathmandu Ltd.,148,520,496,505,29882,15111380,513,-8,2017-04-18
Bank of Kathmandu Ltd.,84,525,505,525,21860,11259709,505,20,2017-04-19
Bank of Kathmandu Ltd.,157,535,515,522,43532,22806468,525,-3,2017-04-20
Bank of Kathmandu Ltd.,189,563,522,530,50236,27031813,522,8,2017-04-23
Bank of Kathmandu Ltd.,98,530,515,516,29763,15496090,530,-14,2017-04-24
Bank of Kathmandu Ltd.,115,520,508,511,36694,18785833,516,-5,2017-04-25
Bank of Kathmandu Ltd.,88,513,504,510,31274,15885583,511,-1,2017-04-26
Bank of Kathmandu Ltd.,81,520,504,508,22245,11338734,510,-2,2017-04-27
Bank of Kathmandu Ltd.,74,514,504,510,16811,8528460,508,2,2017-04-30
Bank of Kathmandu Ltd.,114,512,500,510,33513,16912286,510,0,2017-05-02
Bank of Kathmandu Ltd.,78,524,505,508,20443,10485177,510,-2,2017-05-03
Bank of Kathmandu Ltd.,78,512,501,503,17748,8971473,508,-5,2017-05-04
Bank of Kathmandu Ltd.,79,500,490,498,25421,12530732,503,-5,2017-05-07
Bank of Kathmandu Ltd.,54,503,490,493,16141,7951360,498,-5,2017-05-08
Bank of Kathmandu Ltd.,57,502,494,497,20264,10067992,493,4,2017-05-09
Bank of Kathmandu Ltd.,88,506,498,502,24585,12302492,497,5,2017-05-11
Bank of Kathmandu Ltd.,30,512,500,503,5764,2901032,502,1,2017-05-15
Bank of Kathmandu Ltd.,56,504,494,498,10804,5375813,503,-5,2017-05-16
Bank of Kathmandu Ltd.,36,501,492,493,7338,3631507,498,-5,2017-05-17
Bank of Kathmandu Ltd.,58,493,485,492,12584,6158716,493,-1,2017-05-18
Bank of Kathmandu Ltd.,69,490,480,480,15327,7430820,492,-12,2017-05-21
Bank of Kathmandu Ltd.,88,498,455,498,77897,35754650,480,18,2017-05-22
Bank of Kathmandu Ltd.,62,498,485,492,16724,8233975,498,-6,2017-05-23
Bank of Kathmandu Ltd.,45,490,483,490,8857,4311429,492,-2,2017-05-24
Bank of Kathmandu Ltd.,106,485,477,480,29795,14344462,490,-10,2017-05-28
Bank of Kathmandu Ltd.,91,480,470,471,34372,16260319,480,-9,2017-05-30
Bank of Kathmandu Ltd.,137,480,460,470,61568,28768412,471,-1,2017-05-31
Bank of Kathmandu Ltd.,146,479,465,470,51745,24382793,470,0,2017-06-01
Bank of Kathmandu Ltd.,125,479,460,465,25983,12104217,470,-5,2017-06-04
Bank of Kathmandu Ltd.,102,479,458,472,36567,17129558,465,7,2017-06-05
Bank of Kathmandu Ltd.,117,490,466,490,29021,13791878,472,18,2017-06-06
Bank of Kathmandu Ltd.,166,495,470,477,32131,15411937,490,-13,2017-06-07
Bank of Kathmandu Ltd.,62,479,473,473,12984,6174721,477,-4,2017-06-08
Bank of Kathmandu Ltd.,99,470,457,463,15500,7184362,473,-10,2017-06-11
Bank of Kathmandu Ltd.,86,468,452,460,16267,7497170,463,-3,2017-06-12
Bank of Kathmandu Ltd.,56,470,461,469,11297,5264044,460,9,2017-06-13
Bank of Kathmandu Ltd.,63,473,460,470,17376,8112519,469,1,2017-06-14
Bank of Kathmandu Ltd.,72,476,463,463,13300,6247390,470,-7,2017-06-15
Bank of Kathmandu Ltd.,70,467,456,464,12812,5931878,463,1,2017-06-18
Bank of Kathmandu Ltd.,93,460,453,456,24698,11262716,464,-8,2017-06-19
Bank of Kathmandu Ltd.,117,460,445,454,24078,10838984,456,-2,2017-06-20
Bank of Kathmandu Ltd.,86,454,445,453,19146,8641244,454,-1,2017-06-21
Bank of Kathmandu Ltd.,72,460,453,453,7694,3498893,453,0,2017-06-22
Bank of Kathmandu Ltd.,91,461,452,457,14073,6428150,453,4,2017-06-25
Bank of Kathmandu Ltd.,73,465,453,455,14092,6452782,457,-2,2017-06-27
Bank of Kathmandu Ltd.,59,458,452,456,11217,5106731,455,1,2017-06-28
Bank of Kathmandu Ltd.,86,456,443,448,17371,7789931,456,-8,2017-07-02
Bank of Kathmandu Ltd.,82,456,450,455,16608,7513917,448,7,2017-07-03
Bank of Kathmandu Ltd.,52,455,448,450,9075,4097085,455,-5,2017-07-04
Bank of Kathmandu Ltd.,76,450,443,450,16520,7400106,450,0,2017-07-05
Bank of Kathmandu Ltd.,119,463,452,463,27679,12636881,450,13,2017-07-06
Bank of Kathmandu Ltd.,128,475,452,458,32270,14976293,463,-5,2017-07-09
Bank of Kathmandu Ltd.,56,467,457,461,14147,6512713,458,3,2017-07-10
Bank of Kathmandu Ltd.,58,465,457,462,12872,5937273,461,1,2017-07-11
Bank of Kathmandu Ltd.,66,468,462,462,9652,4485666,462,0,2017-07-12
Bank of Kathmandu Ltd.,74,465,460,462,11332,5238576,462,0,2017-07-13
Bank of Kathmandu Ltd.,50,464,456,462,7342,3386387,462,0,2017-07-16
Bank of Kathmandu Ltd.,82,472,462,470,15778,7355825,462,8,2017-07-17
Bank of Kathmandu Ltd.,143,476,467,476,29290,13802789,470,6,2017-07-18
Bank of Kathmandu Ltd.,123,494,480,485,23051,11161768,485,0,2017-08-03
Bank of Kathmandu Ltd.,114,480,465,470,23422,11148743,476,-6,2017-07-19
Bank of Kathmandu Ltd.,73,480,472,472,14142,6724028,470,2,2017-07-20
Bank of Kathmandu Ltd.,83,472,464,464,15817,7378138,472,-8,2017-07-23
Bank of Kathmandu Ltd.,62,465,460,461,14829,6839750,464,-3,2017-07-24
Bank of Kathmandu Ltd.,90,470,452,459,26374,12144838,461,-2,2017-07-25
Bank of Kathmandu Ltd.,114,470,455,458,23893,11004879,459,-1,2017-07-26
Bank of Kathmandu Ltd.,173,484,461,484,43141,20404616,458,26,2017-07-27
Bank of Kathmandu Ltd.,264,503,473,494,85128,41973929,484,10,2017-07-30
Bank of Kathmandu Ltd.,221,503,485,487,53248,26352667,494,-7,2017-07-31
Bank of Kathmandu Ltd.,76,490,481,484,14489,7025155,487,-3,2017-08-01
Bank of Kathmandu Ltd.,96,485,479,485,14875,7165354,484,1,2017-08-02
Bank of Kathmandu Ltd.,125,489,476,486,20499,9958744,485,1,2017-08-06
Bank of Kathmandu Ltd.,109,490,485,488,21021,10231097,486,2,2017-08-07
Bank of Kathmandu Ltd.,106,492,480,480,19588,9459627,488,-8,2017-08-09
Bank of Kathmandu Ltd.,81,485,475,476,13119,6285843,480,-4,2017-08-10
Bank of Kathmandu Ltd.,156,500,479,481,34530,16646317,476,5,2017-08-13
Bank of Kathmandu Ltd.,116,480,474,475,27295,13019006,481,-6,2017-08-15
Bank of Kathmandu Ltd.,81,480,468,477,14726,7036256,475,2,2017-08-16
Bank of Kathmandu Ltd.,68,480,474,478,8530,4064231,477,1,2017-08-17
Bank of Kathmandu Ltd.,138,480,463,465,18926,8837314,478,-13,2017-08-20
Bank of Kathmandu Ltd.,40,465,456,462,5894,2710898,465,-3,2017-08-21
Bank of Kathmandu Ltd.,58,469,457,467,9914,4578215,462,5,2017-08-22
Bank of Kathmandu Ltd.,65,471,460,460,16701,7731512,467,-7,2017-08-23
Bank of Kathmandu Ltd.,53,465,458,462,9422,4347058,460,2,2017-08-24
Bank of Kathmandu Ltd.,69,465,458,458,12806,5901946,462,-4,2017-08-27
Bank of Kathmandu Ltd.,64,460,450,453,20395,9243286,458,-5,2017-08-28
Bank of Kathmandu Ltd.,129,455,442,445,28917,12862856,453,-8,2017-08-30
Bank of Kathmandu Ltd.,133,445,435,435,24713,10844478,445,-10,2017-08-31
Bank of Kathmandu Ltd.,150,435,423,424,32246,13769757,435,-11,2017-09-04
Bank of Kathmandu Ltd.,66,440,425,435,15314,6596712,424,11,2017-09-06
Bank of Kathmandu Ltd.,74,435,426,428,11484,4918857,435,-7,2017-09-07
Bank of Kathmandu Ltd.,88,428,420,420,15342,6482757,428,-8,2017-09-10
Bank of Kathmandu Ltd.,61,430,415,420,11686,4929648,420,0,2017-09-11
Bank of Kathmandu Ltd.,80,422,416,420,14092,5905546,420,0,2017-09-12
Bank of Kathmandu Ltd.,69,422,415,419,18376,7700323,420,-1,2017-09-13
Bank of Kathmandu Ltd.,57,434,420,433,12294,5243772,419,14,2017-09-14
Bank of Kathmandu Ltd.,96,440,426,440,15457,6717090,433,7,2017-09-17
Bank of Kathmandu Ltd.,83,448,438,443,11810,5208837,440,3,2017-09-18
Bank of Kathmandu Ltd.,43,451,425,438,11701,5197002,443,-5,2017-09-20
Bank of Kathmandu Ltd.,47,425,420,425,7869,3329861,426,-1,2017-10-09
Bank of Kathmandu Ltd.,68,445,433,435,15164,6598424,438,-3,2017-09-24
Bank of Kathmandu Ltd.,42,439,427,439,9113,3964136,435,4,2017-09-25
Bank of Kathmandu Ltd.,58,443,433,434,12120,5277699,439,-5,2017-09-26
Bank of Kathmandu Ltd.,15,436,426,434,4001,1735098,434,0,2017-10-03
Bank of Kathmandu Ltd.,32,436,431,434,7230,3133709,434,0,2017-10-04
Bank of Kathmandu Ltd.,71,430,419,426,19432,8215898,434,-8,2017-10-08
Bank of Kathmandu Ltd.,70,429,420,425,15622,6625722,425,0,2017-10-10
Bank of Kathmandu Ltd.,56,426,421,424,12823,5440352,425,-1,2017-10-11
Bank of Kathmandu Ltd.,39,426,420,424,8288,3510351,424,0,2017-10-12
Bank of Kathmandu Ltd.,30,434,425,432,6175,2639993,424,8,2017-10-15
Bank of Kathmandu Ltd.,85,448,430,445,252428,108534706,432,13,2017-10-16
Bank of Kathmandu Ltd.,80,450,437,443,12280,5427308,445,-2,2017-10-17
Bank of Kathmandu Ltd.,66,452,442,450,11979,5369349,443,7,2017-10-18
Bank of Kathmandu Ltd.,49,458,447,447,8055,3652957,450,-3,2017-10-22
Bank of Kathmandu Ltd.,103,452,445,449,22132,9960987,447,2,2017-10-23
Bank of Kathmandu Ltd.,40,452,449,449,11336,5104533,449,0,2017-10-24
Bank of Kathmandu Ltd.,39,448,442,444,5196,2309275,449,-5,2017-10-25
Bank of Kathmandu Ltd.,48,445,439,440,11166,4926941,444,-4,2017-10-29
Bank of Kathmandu Ltd.,35,445,440,440,7113,3141768,440,0,2017-10-30
Bank of Kathmandu Ltd.,39,442,438,438,7396,3247282,440,-2,2017-10-31
Bank of Kathmandu Ltd.,36,440,433,435,5652,2465833,438,-3,2017-11-01
Bank of Kathmandu Ltd.,39,436,430,435,8399,3636339,435,0,2017-11-02
Bank of Kathmandu Ltd.,158,433,413,415,28314,11846079,435,-20,2017-11-05
Bank of Kathmandu Ltd.,62,431,408,414,10803,4494790,415,-1,2017-11-06
Bank of Kathmandu Ltd.,58,422,414,414,15411,6414819,414,0,2017-11-07
Bank of Kathmandu Ltd.,92,414,405,410,20047,8201017,414,-4,2017-11-08
Bank of Kathmandu Ltd.,140,410,400,404,37712,15204611,410,-6,2017-11-09
Bank of Kathmandu Ltd.,91,408,400,408,25785,10385932,404,4,2017-11-12
Bank of Kathmandu Ltd.,66,414,408,414,11555,4747882,408,6,2017-11-13
Bank of Kathmandu Ltd.,66,422,413,419,11146,4643405,414,5,2017-11-14
Bank of Kathmandu Ltd.,75,422,413,413,13502,5623616,419,-6,2017-11-15
Bank of Kathmandu Ltd.,73,413,404,404,15242,6199140,413,-9,2017-11-16
Bank of Kathmandu Ltd.,61,407,401,402,17641,7131271,404,-2,2017-11-19
Bank of Kathmandu Ltd.,65,404,400,404,31209,12497478,402,2,2017-11-20
Bank of Kathmandu Ltd.,73,410,402,403,16320,6588128,404,-1,2017-11-21
Bank of Kathmandu Ltd.,50,411,403,406,15434,6259483,403,3,2017-11-22
Bank of Kathmandu Ltd.,85,411,406,408,17588,7185611,406,2,2017-11-23
Bank of Kathmandu Ltd.,86,412,406,411,15240,6241584,408,3,2017-11-26
Bank of Kathmandu Ltd.,73,415,409,409,13278,5465053,411,-2,2017-11-27
Bank of Kathmandu Ltd.,73,411,407,409,13219,5410121,409,0,2017-11-28
Bank of Kathmandu Ltd.,116,423,410,416,23393,9671097,409,7,2017-11-29
Bank of Kathmandu Ltd.,48,418,410,412,6918,2860260,416,-4,2017-11-30
Bank of Kathmandu Ltd.,69,417,410,410,11894,4919090,412,-2,2017-12-04
Bank of Kathmandu Ltd.,129,423,410,421,40474,16911457,414,7,2017-12-20
Bank of Kathmandu Ltd.,66,410,406,409,12503,5095201,410,-1,2017-12-05
Bank of Kathmandu Ltd.,50,418,410,418,10398,4328001,409,9,2017-12-06
Bank of Kathmandu Ltd.,61,433,412,413,12203,5116016,418,-5,2017-12-10
Bank of Kathmandu Ltd.,77,415,405,410,18191,7451408,413,-3,2017-12-11
Bank of Kathmandu Ltd.,52,410,406,407,10993,4485774,410,-3,2017-12-12
Bank of Kathmandu Ltd.,43,416,400,412,10074,4144257,407,5,2017-12-13
Bank of Kathmandu Ltd.,35,415,407,409,13078,5350694,412,-3,2017-12-14
Bank of Kathmandu Ltd.,56,414,409,413,20124,8279624,409,4,2017-12-17
Bank of Kathmandu Ltd.,78,418,411,418,24285,10114712,413,5,2017-12-18
Bank of Kathmandu Ltd.,54,420,414,414,8516,3533826,418,-4,2017-12-19
Bank of Kathmandu Ltd.,97,426,417,418,27398,11482586,421,-3,2017-12-21
Bank of Kathmandu Ltd.,76,420,415,415,15142,6326577,418,-3,2017-12-24
Bank of Kathmandu Ltd.,63,414,410,410,13819,5683203,415,-5,2017-12-26
Bank of Kathmandu Ltd.,98,410,395,405,20576,8338094,410,-5,2017-12-27
Bank of Kathmandu Ltd.,99,410,397,402,23512,9466520,405,-3,2017-12-28
Bank of Kathmandu Ltd.,91,403,397,401,22108,8838611,402,-1,2017-12-31
Bank of Kathmandu Ltd.,60,410,403,409,18032,7322976,401,8,2018-01-01
Bank of Kathmandu Ltd.,91,415,405,407,24488,10061679,409,-2,2018-01-02
Bank of Kathmandu Ltd.,80,407,401,402,18022,7271390,407,-5,2018-01-03
Bank of Kathmandu Ltd.,77,407,401,405,17768,7164022,402,3,2018-01-04
Bank of Kathmandu Ltd.,45,409,405,405,10670,4338156,405,0,2018-01-07
Bank of Kathmandu Ltd.,79,409,404,405,24371,9883701,405,0,2018-01-08
Bank of Kathmandu Ltd.,73,410,405,409,15188,6201942,405,4,2018-01-09
Bank of Kathmandu Ltd.,70,416,407,414,21984,9073185,409,5,2018-01-10
Bank of Kathmandu Ltd.,72,415,408,410,11021,4526242,414,-4,2018-01-14
Bank of Kathmandu Ltd.,53,409,405,406,10370,4221987,410,-4,2018-01-16
Bank of Kathmandu Ltd.,50,409,401,407,9587,3882031,406,1,2018-01-17
Bank of Kathmandu Ltd.,82,408,402,403,14651,5920480,407,-4,2018-01-21
Bank of Kathmandu Ltd.,61,405,403,405,9353,3777216,403,2,2018-01-22
Bank of Kathmandu Ltd.,43,404,401,402,7910,3182444,405,-3,2018-01-23
Bank of Kathmandu Ltd.,40,403,401,402,8308,3335610,402,0,2018-01-24
Bank of Kathmandu Ltd.,66,407,400,401,15710,6313700,402,-1,2018-01-25
Bank of Kathmandu Ltd.,54,405,400,401,12547,5026648,401,0,2018-01-28
Bank of Kathmandu Ltd.,70,400,394,397,13014,5158458,401,-4,2018-01-29
Bank of Kathmandu Ltd.,55,402,391,394,10468,4133161,397,-3,2018-01-31
Bank of Kathmandu Ltd.,76,399,391,393,22218,8759313,394,-1,2018-02-01
Bank of Kathmandu Ltd.,72,396,390,390,14249,5585467,393,-3,2018-02-04
Bank of Kathmandu Ltd.,48,391,386,389,7735,3003668,390,-1,2018-02-05
Bank of Kathmandu Ltd.,75,387,383,385,17852,6875041,389,-4,2018-02-06
Bank of Kathmandu Ltd.,57,385,378,379,13312,5069202,385,-6,2018-02-07
Bank of Kathmandu Ltd.,68,383,376,380,13774,5220362,379,1,2018-02-08
Bank of Kathmandu Ltd.,44,376,373,373,8238,3081404,375,-2,2018-02-25
Bank of Kathmandu Ltd.,47,380,375,376,8481,3192010,380,-4,2018-02-11
Bank of Kathmandu Ltd.,60,377,370,375,11942,4450887,376,-1,2018-02-12
Bank of Kathmandu Ltd.,52,376,372,376,12203,4555733,375,1,2018-02-14
Bank of Kathmandu Ltd.,128,391,377,391,37572,14441915,376,15,2018-02-15
Bank of Kathmandu Ltd.,111,400,384,387,24095,9466436,391,-4,2018-02-18
Bank of Kathmandu Ltd.,74,396,378,378,15358,5878648,387,-9,2018-02-20
Bank of Kathmandu Ltd.,125,378,370,370,31726,11816515,378,-8,2018-02-21
Bank of Kathmandu Ltd.,65,376,368,375,14138,5255204,370,5,2018-02-22
Bank of Kathmandu Ltd.,73,371,369,370,14415,5335563,373,-3,2018-02-26
Bank of Kathmandu Ltd.,67,377,370,370,14315,5328660,370,0,2018-02-27
Bank of Kathmandu Ltd.,78,370,365,366,20063,7348767,370,-4,2018-02-28
Bank of Kathmandu Ltd.,81,368,352,360,16285,5814777,366,-6,2018-03-04
Bank of Kathmandu Ltd.,57,362,350,355,17095,6044801,360,-5,2018-03-05
Bank of Kathmandu Ltd.,85,362,348,358,23924,8435871,355,3,2018-03-06
Bank of Kathmandu Ltd.,75,370,362,370,14659,5355293,358,12,2018-03-07
Bank of Kathmandu Ltd.,55,377,355,357,11472,4112074,370,-13,2018-03-11
Bank of Kathmandu Ltd.,40,364,354,358,7507,2685544,357,1,2018-03-12
Bank of Kathmandu Ltd.,34,362,358,362,7335,2640202,358,4,2018-03-13
Bank of Kathmandu Ltd.,29,364,361,362,4636,1678682,362,0,2018-03-14
Bank of Kathmandu Ltd.,36,365,363,363,8801,3207550,362,1,2018-03-15
Bank of Kathmandu Ltd.,39,364,361,361,9424,3410588,363,-2,2018-03-18
Bank of Kathmandu Ltd.,40,362,355,355,5554,1984318,361,-6,2018-03-19
Bank of Kathmandu Ltd.,46,355,350,355,11647,4098548,355,0,2018-03-20
Bank of Kathmandu Ltd.,70,353,343,344,13930,4818671,355,-11,2018-03-21
Bank of Kathmandu Ltd.,79,350,331,340,13659,4636088,344,-4,2018-03-22
Bank of Kathmandu Ltd.,207,334,308,310,45346,14262500,340,-30,2018-03-26
Bank of Kathmandu Ltd.,124,322,294,316,24965,7576032,310,6,2018-03-27
Bank of Kathmandu Ltd.,133,322,304,310,22860,7141442,316,-6,2018-03-28
Bank of Kathmandu Ltd.,74,320,307,317,23880,7504394,310,7,2018-03-29
Bank of Kathmandu Ltd.,75,317,308,311,15133,4713257,317,-6,2018-04-01
Bank of Kathmandu Ltd.,43,318,309,313,6123,1907548,311,2,2018-04-02
Bank of Kathmandu Ltd.,36,316,310,316,7698,2414961,313,3,2018-04-03
Bank of Kathmandu Ltd.,50,322,317,321,10372,3320996,316,5,2018-04-04
Bank of Kathmandu Ltd.,96,330,320,325,18275,5965287,321,4,2018-04-05
Bank of Kathmandu Ltd.,105,342,329,339,22524,7573215,325,14,2018-04-08
Bank of Kathmandu Ltd.,111,345,333,335,17989,6113508,339,-4,2018-04-09
Bank of Kathmandu Ltd.,70,336,329,329,13447,4462814,335,-6,2018-04-10
Bank of Kathmandu Ltd.,48,334,325,334,6439,2110672,329,5,2018-04-11
Bank of Kathmandu Ltd.,54,340,333,334,6179,2067780,334,0,2018-04-12
Bank of Kathmandu Ltd.,44,334,321,331,8017,2635218,334,-3,2018-04-15
Bank of Kathmandu Ltd.,37,337,332,335,7165,2392057,331,4,2018-04-16
Bank of Kathmandu Ltd.,39,340,332,336,9010,3027448,335,1,2018-04-17
Bank of Kathmandu Ltd.,66,366,335,350,16440,5667225,336,14,2018-04-18
Bank of Kathmandu Ltd.,131,361,350,356,30277,10769591,350,6,2018-04-19
Bank of Kathmandu Ltd.,111,367,354,365,30818,11119956,356,9,2018-04-22
Bank of Kathmandu Ltd.,123,368,353,358,31536,11419427,365,-7,2018-04-23
Bank of Kathmandu Ltd.,44,362,351,353,10130,3594494,358,-5,2018-04-24
Bank of Kathmandu Ltd.,50,354,348,349,10398,3637651,353,-4,2018-04-25
Bank of Kathmandu Ltd.,51,352,341,342,8851,3046309,349,-7,2018-04-26
Bank of Kathmandu Ltd.,57,342,334,335,9756,3290186,342,-7,2018-04-29
Bank of Kathmandu Ltd.,37,341,330,340,5713,1902375,335,5,2018-05-02
Bank of Kathmandu Ltd.,48,342,336,339,14024,4764086,340,-1,2018-05-03
Bank of Kathmandu Ltd.,55,340,333,335,11605,3891825,339,-4,2018-05-06
Bank of Kathmandu Ltd.,32,334,330,332,3275,1086426,335,-3,2018-05-07
Bank of Kathmandu Ltd.,27,335,330,335,3816,1269678,332,3,2018-05-08
Bank of Kathmandu Ltd.,28,338,333,334,7303,2445184,335,-1,2018-05-09
Bank of Kathmandu Ltd.,51,340,334,335,9607,3222571,334,1,2018-05-10
Bank of Kathmandu Ltd.,49,335,329,331,8533,2836440,335,-4,2018-05-14
Bank of Kathmandu Ltd.,36,335,327,334,5505,1808936,331,3,2018-05-15
Bank of Kathmandu Ltd.,24,335,328,328,4255,1404675,334,-6,2018-05-16
Bank of Kathmandu Ltd.,29,334,330,331,3940,1303358,328,3,2018-05-17
Bank of Kathmandu Ltd.,46,337,326,333,10862,3574140,331,2,2018-05-20
Bank of Kathmandu Ltd.,28,330,327,330,4287,1408629,333,-3,2018-05-21
Bank of Kathmandu Ltd.,25,328,325,326,6847,2233565,330,-4,2018-05-22