companyname,numberoftransaction,maxprice,minprice,closingprice,tradedshares,amount,previousclosing,difference,date
Ace Development Bank Ltd.,13,389,380,389,2984,1145477,381,8,2016-05-23
Ace Development Bank Ltd.,13,389,381,381,4989,1923399,389,-8,2016-05-24
Ace Development Bank Ltd.,5,380,375,380,2315,870700,381,-1,2016-05-25
Ace Development Bank Ltd.,13,380,371,375,5827,2182338,380,-5,2016-05-26
Ace Development Bank Ltd.,20,381,371,373,8867,3325871,375,-2,2016-05-29
Ace Development Bank Ltd.,17,380,370,380,7883,2927118,373,7,2016-05-30
Ace Development Bank Ltd.,22,383,376,380,7553,2867693,380,0,2016-05-31
Ace Development Bank Ltd.,4,375,370,374,441,164834,380,-6,2016-06-01
Ace Development Bank Ltd.,9,371,363,370,4300,1576900,374,-4,2016-06-02
Ace Development Bank Ltd.,15,373,367,367,3897,1441366,370,-3,2016-06-05
Ace Development Bank Ltd.,9,371,367,371,2799,1034462,367,4,2016-06-06
Ace Development Bank Ltd.,18,380,370,375,7411,2780873,371,4,2016-06-07
Ace Development Bank Ltd.,29,398,378,391,8758,3394094,390,1,2016-06-23
Ace Development Bank Ltd.,10,382,371,376,2857,1074010,375,1,2016-06-08
Ace Development Bank Ltd.,20,381,368,368,10207,3797662,376,-8,2016-06-09
Ace Development Bank Ltd.,12,384,372,380,11292,4262004,368,12,2016-06-12
Ace Development Bank Ltd.,19,386,375,376,8607,3263539,380,-4,2016-06-13
Ace Development Bank Ltd.,22,379,372,377,8315,3126845,376,1,2016-06-14
Ace Development Bank Ltd.,40,390,375,390,13652,5232084,377,13,2016-06-15
Ace Development Bank Ltd.,29,393,384,385,10063,3916865,390,-5,2016-06-16
Ace Development Bank Ltd.,41,412,388,388,15661,6217219,385,3,2016-06-19
Ace Development Bank Ltd.,31,402,389,394,6678,2637924,388,6,2016-06-20
Ace Development Bank Ltd.,12,397,390,391,3878,1520298,394,-3,2016-06-21
Ace Development Bank Ltd.,30,400,390,390,7639,2998972,391,-1,2016-06-22
Ace Development Bank Ltd.,17,398,381,385,5203,2013708,391,-6,2016-06-26
Ace Development Bank Ltd.,17,400,392,393,4553,1798620,385,8,2016-06-27
Ace Development Bank Ltd.,37,402,395,395,12640,5024118,393,2,2016-06-28
Ace Development Bank Ltd.,33,399,395,398,10130,4022406,395,3,2016-06-29
Ace Development Bank Ltd.,23,399,392,397,7819,3103064,398,-1,2016-06-30
Ace Development Bank Ltd.,65,420,400,405,24965,10185630,397,8,2016-07-03
Ace Development Bank Ltd.,54,418,409,410,19876,8189342,405,5,2016-07-04
Ace Development Bank Ltd.,22,415,406,413,7906,3245092,410,3,2016-07-05
Ace Development Bank Ltd.,46,420,413,416,17772,7400162,413,3,2016-07-06
Ace Development Bank Ltd.,40,424,415,424,18856,7915189,416,8,2016-07-10
Ace Development Bank Ltd.,12,432,412,412,3237,1356850,424,-12,2016-07-11
Ace Development Bank Ltd.,44,424,405,407,18552,7651722,412,-5,2016-07-12
Ace Development Bank Ltd.,28,415,392,410,5956,2374967,407,3,2016-07-13
Ace Development Bank Ltd.,17,421,412,413,4894,2032114,410,3,2016-07-14
Ace Development Bank Ltd.,22,429,407,421,6941,2901317,413,8,2016-07-17
Ace Development Bank Ltd.,38,430,418,425,13173,5617877,421,4,2016-07-18
Ace Development Bank Ltd.,43,434,424,434,12628,5424341,425,9,2016-07-19
Ace Development Bank Ltd.,38,438,428,428,14310,6174900,434,-6,2016-07-20
Ace Development Bank Ltd.,27,439,427,433,12090,5250421,428,5,2016-07-21
Ace Development Bank Ltd.,114,464,438,453,52399,23708756,433,20,2016-07-25
Ace Development Bank Ltd.,104,489,462,485,35078,16539677,453,32,2016-07-26
Ace Development Bank Ltd.,100,510,465,480,29311,14199986,485,-5,2016-07-27
Ace Development Bank Ltd.,57,491,465,473,21678,10385416,480,-7,2016-07-28
Ace Development Bank Ltd.,35,470,457,463,11094,5124467,473,-10,2016-07-31
Ace Development Bank Ltd.,56,460,435,460,18758,8357148,463,-3,2016-08-01
Ace Development Bank Ltd.,40,452,435,437,14740,6501032,460,-23,2016-08-02
Ace Development Bank Ltd.,221,480,445,453,72499,33705675,437,16,2016-08-03
Ace Development Bank Ltd.,102,457,440,440,21754,9760505,453,-13,2016-08-04
Ace Development Bank Ltd.,4,448,440,445,3439,1528472,440,5,2016-08-07
Agriculture Development Bank Limited,40,690,677,685,14290,9764487,680,5,2016-05-23
Agriculture Development Bank Limited,49,695,685,690,7665,5286530,685,5,2016-05-24
Agriculture Development Bank Limited,43,692,671,682,13438,9073302,690,-8,2016-05-25
Agriculture Development Bank Limited,25,689,657,679,5751,3902538,682,-3,2016-05-26
Agriculture Development Bank Limited,42,679,660,679,10097,6749106,679,0,2016-05-29
Agriculture Development Bank Limited,31,679,665,666,6432,4287041,679,-13,2016-05-30
Agriculture Development Bank Limited,33,667,653,659,7732,5098912,666,-7,2016-05-31
Agriculture Development Bank Limited,51,665,648,656,10461,6845190,659,-3,2016-06-01
Agriculture Development Bank Limited,60,682,656,668,14888,9934706,656,12,2016-06-02
Agriculture Development Bank Limited,63,674,650,668,8658,5735256,668,0,2016-06-05
Agriculture Development Bank Limited,25,670,647,670,4113,2726752,668,2,2016-06-06
Agriculture Development Bank Limited,31,680,661,677,9201,6186237,670,7,2016-06-07
Agriculture Development Bank Limited,33,720,696,702,6052,4275171,720,-18,2016-06-23
Agriculture Development Bank Limited,59,689,676,677,11892,8086110,677,0,2016-06-08
Agriculture Development Bank Limited,45,694,677,677,7948,5422602,677,0,2016-06-09
Agriculture Development Bank Limited,19,689,668,675,4476,3027832,677,-2,2016-06-12
Agriculture Development Bank Limited,151,710,680,700,40671,28383419,675,25,2016-06-13
Agriculture Development Bank Limited,106,725,710,721,35182,25298420,700,21,2016-06-14
Agriculture Development Bank Limited,42,723,712,720,11057,7937373,721,-1,2016-06-15
Agriculture Development Bank Limited,49,722,697,713,14568,10267030,720,-7,2016-06-16
Agriculture Development Bank Limited,36,714,693,705,18341,12933260,713,-8,2016-06-19
Agriculture Development Bank Limited,50,710,697,700,10740,7545962,705,-5,2016-06-20
Agriculture Development Bank Limited,40,720,700,703,9949,7022531,700,3,2016-06-21
Agriculture Development Bank Limited,37,728,706,720,11454,8181899,703,17,2016-06-22
Agriculture Development Bank Limited,36,712,703,710,7223,5121182,702,8,2016-06-26
Agriculture Development Bank Limited,77,739,713,739,22093,15966204,710,29,2016-06-27
Agriculture Development Bank Limited,49,735,721,735,12542,9154895,739,-4,2016-06-28
Agriculture Development Bank Limited,32,732,724,727,10899,7932804,735,-8,2016-06-29
Agriculture Development Bank Limited,62,729,716,722,19936,14451845,727,-5,2016-06-30
Agriculture Development Bank Limited,47,720,713,719,11526,8282487,722,-3,2016-07-03
Agriculture Development Bank Limited,50,730,710,730,5677,4087850,719,11,2016-07-04
Agriculture Development Bank Limited,68,750,713,745,20430,14750377,730,15,2016-07-05
Agriculture Development Bank Limited,91,775,743,761,24816,18965190,745,16,2016-07-06
Agriculture Development Bank Limited,36,765,740,761,4691,3548440,761,0,2016-07-10
Agriculture Development Bank Limited,114,789,761,777,27375,21279724,761,16,2016-07-11
Agriculture Development Bank Limited,58,784,720,766,8705,6641752,777,-11,2016-07-12
Agriculture Development Bank Limited,46,768,740,760,10620,8007271,766,-6,2016-07-13
Agriculture Development Bank Limited,48,775,755,768,11763,8998421,760,8,2016-07-14
Agriculture Development Bank Limited,184,844,765,844,46553,38156850,768,76,2016-07-17
Agriculture Development Bank Limited,104,865,814,833,28713,24282672,844,-11,2016-07-18
Agriculture Development Bank Limited,203,899,830,888,53355,46055239,833,55,2016-07-19
Agriculture Development Bank Limited,272,976,900,976,73449,70610321,888,88,2016-07-20
Agriculture Development Bank Limited,200,1010,954,984,43680,42840235,976,8,2016-07-21
Agriculture Development Bank Limited,252,1065,985,1065,63729,64132381,984,81,2016-07-25
Agriculture Development Bank Limited,200,1113,1045,1082,37909,40983128,1065,17,2016-07-26
Agriculture Development Bank Limited,169,1099,1035,1081,40667,43100183,1082,-1,2016-07-27
Agriculture Development Bank Limited,143,1069,1029,1060,33191,34914371,1081,-21,2016-07-28
Agriculture Development Bank Limited,128,1068,1020,1038,28865,29774506,1060,-22,2016-07-31
Agriculture Development Bank Limited,154,1050,995,1030,33867,34223095,1038,-8,2016-08-01
Agriculture Development Bank Limited,141,1015,1000,1000,58079,58488030,1030,-30,2016-08-02
Agriculture Development Bank Limited,100,1019,982,1002,23444,23497177,1000,2,2016-08-03
Agriculture Development Bank Limited,143,995,955,970,30904,30373426,1002,-32,2016-08-04
Agriculture Development Bank Limited,136,1006,970,972,25130,25039877,970,2,2016-08-07
Agriculture Development Bank Limited,76,965,901,905,16460,15371467,972,-67,2016-08-08
Agriculture Development Bank Limited,16,995,923,995,3567,3473347,905,90,2016-08-09
Agriculture Development Bank Limited,191,1020,936,1010,53909,53784988,995,15,2016-08-10
Agriculture Development Bank Limited,145,1020,992,1020,33089,33098281,1010,10,2016-08-11
Agriculture Development Bank Limited,94,1001,955,968,20556,20035729,1020,-52,2016-08-14
Agriculture Development Bank Limited,144,1006,946,970,27993,27328435,968,2,2016-08-15
Agriculture Development Bank Limited,81,1005,985,999,19708,19578397,999,0,2016-08-31
Agriculture Development Bank Limited,141,1001,970,985,30158,29962681,970,15,2016-08-16
Agriculture Development Bank Limited,123,1010,972,1000,16569,16601481,985,15,2016-08-17
Agriculture Development Bank Limited,74,1013,985,995,8813,8816939,1000,-5,2016-08-21
Agriculture Development Bank Limited,64,1000,962,964,6697,6511253,995,-31,2016-08-22
Agriculture Development Bank Limited,80,983,948,970,12823,12308227,964,6,2016-08-23
Agriculture Development Bank Limited,68,984,951,970,7338,7059284,970,0,2016-08-24
Agriculture Development Bank Limited,57,980,958,965,5090,4924410,970,-5,2016-08-28
Agriculture Development Bank Limited,82,995,965,983,14088,13758972,965,18,2016-08-29
Agriculture Development Bank Limited,82,1002,983,999,16862,16755667,983,16,2016-08-30
Agriculture Development Bank Limited,115,1010,990,998,15887,15973715,999,-1,2016-09-01
Agriculture Development Bank Limited,85,1029,989,1020,13611,13681335,998,22,2016-09-04
Agriculture Development Bank Limited,159,1056,1020,1043,34803,36427617,1020,23,2016-09-05
Agriculture Development Bank Limited,106,1055,1011,1028,25608,26702176,1043,-15,2016-09-06
Agriculture Development Bank Limited,278,1065,1011,1065,62511,65481612,1028,37,2016-09-07
Agriculture Development Bank Limited,90,1058,1040,1054,15717,16504253,1065,-11,2016-09-08
Agriculture Development Bank Limited,151,1075,1042,1050,29449,30976283,1054,-4,2016-09-11
Agriculture Development Bank Limited,161,1060,1048,1050,29095,30665683,1050,0,2016-09-12
Agriculture Development Bank Limited,95,1059,1046,1050,11695,12301220,1050,0,2016-09-14
Agriculture Development Bank Limited,105,1052,1035,1050,11307,11817951,1050,0,2016-09-18
Agriculture Development Bank Limited,254,1071,1040,1044,42584,44752147,1050,-6,2016-09-20
Agriculture Development Bank Limited,169,1045,1020,1025,24012,24686690,1044,-19,2016-09-21
Agriculture Development Bank Limited,248,1032,997,1019,31362,31848766,1025,-6,2016-09-22
Agriculture Development Bank Limited,762,1020,990,995,114461,114824129,1019,-24,2016-09-25
Agriculture Development Bank Limited,61,690,659,675,10691,7175950,697,-22,2016-09-26
Agriculture Development Bank Limited,48,684,672,672,4456,3015421,675,-3,2016-09-27
Agriculture Development Bank Limited,18,677,670,672,1414,952154,672,0,2016-09-28
Agriculture Development Bank Limited,29,670,660,670,3261,2179255,672,-2,2016-09-29
Agriculture Development Bank Limited,35,684,670,680,4644,3147376,670,10,2016-10-02
Agriculture Development Bank Limited,24,690,670,672,2351,1602075,680,-8,2016-10-03
Agriculture Development Bank Limited,26,680,667,668,7550,5062162,672,-4,2016-10-04
Agriculture Development Bank Limited,13,680,667,680,1002,674106,668,12,2016-10-05
Agriculture Development Bank Limited,18,690,670,683,2238,1518931,680,3,2016-10-06
Agriculture Development Bank Limited,15,703,679,683,1795,1231305,683,0,2016-10-16
Agriculture Development Bank Limited,26,683,660,669,3931,2631477,683,-14,2016-10-17
Agriculture Development Bank Limited,19,675,661,670,1206,804747,669,1,2016-10-18
Agriculture Development Bank Limited,29,670,660,665,3950,2620054,670,-5,2016-10-19
Agriculture Development Bank Limited,23,677,661,669,2944,1967195,665,4,2016-10-20
Agriculture Development Bank Limited,38,665,655,655,6226,4100594,669,-14,2016-10-23
Agriculture Development Bank Limited,34,661,649,653,7673,5004546,655,-2,2016-10-24
Agriculture Development Bank Limited,32,650,640,645,3856,2481779,653,-8,2016-10-25
Agriculture Development Bank Limited,26,650,640,642,4364,2809908,645,-3,2016-10-26
Agriculture Development Bank Limited,21,645,630,638,2964,1899283,642,-4,2016-10-27
Agriculture Development Bank Limited,9,650,626,645,906,577224,638,7,2016-11-03
Agriculture Development Bank Limited,23,646,615,625,1784,1127016,645,-20,2016-11-07
Agriculture Development Bank Limited,45,630,605,610,5340,3293823,625,-15,2016-11-08
Agriculture Development Bank Limited,53,613,594,600,5406,3247293,610,-10,2016-11-09
Agriculture Development Bank Limited,50,607,596,600,4874,2927348,600,0,2016-11-10
Agriculture Development Bank Limited,37,610,598,600,7038,4235385,600,0,2016-11-13
Agriculture Development Bank Limited,51,609,595,600,6752,4045871,600,0,2016-11-14
Agriculture Development Bank Limited,41,612,590,596,7995,4812885,600,-4,2016-11-15
Agriculture Development Bank Limited,39,600,588,595,4803,2861582,596,-1,2016-11-16
Agriculture Development Bank Limited,41,595,580,580,5087,2979229,595,-15,2016-11-17
Agriculture Development Bank Limited,34,571,530,556,6046,3314277,580,-24,2016-11-20
Agriculture Development Bank Limited,54,565,541,555,6653,3669875,556,-1,2016-11-21
Agriculture Development Bank Limited,44,560,538,550,6174,3389711,555,-5,2016-11-22
Agriculture Development Bank Limited,64,540,520,525,9827,5206229,550,-25,2016-11-23
Agriculture Development Bank Limited,62,540,523,527,10536,5553951,525,2,2016-11-24
Agriculture Development Bank Limited,95,528,500,502,14556,7400232,527,-25,2016-11-27
Agriculture Development Bank Limited,96,535,480,525,20030,9903603,502,23,2016-11-28
Agriculture Development Bank Limited,71,560,505,555,6827,3685039,525,30,2016-11-29
Agriculture Development Bank Limited,108,589,550,576,17082,9590594,555,21,2016-11-30
Agriculture Development Bank Limited,91,590,556,575,12639,7301002,576,-1,2016-12-01
Agriculture Development Bank Limited,43,571,558,558,3739,2095270,575,-17,2016-12-04
Agriculture Development Bank Limited,31,558,530,545,3418,1858251,558,-13,2016-12-05
Agriculture Development Bank Limited,37,555,540,550,3030,1658237,545,5,2016-12-06
Agriculture Development Bank Limited,24,553,543,550,1850,1014612,550,0,2016-12-07
Agriculture Development Bank Limited,32,550,540,540,4444,2408365,550,-10,2016-12-08
Agriculture Development Bank Limited,27,541,529,530,3290,1755127,540,-10,2016-12-11
Agriculture Development Bank Limited,11,530,515,525,1484,775586,530,-5,2016-12-12
Agriculture Development Bank Limited,30,535,525,530,5246,2776288,525,5,2016-12-14
Agriculture Development Bank Limited,27,542,530,542,4365,2336919,530,12,2016-12-15
Agriculture Development Bank Limited,52,540,525,540,6847,3651601,542,-2,2016-12-18
Agriculture Development Bank Limited,53,535,520,520,6963,3662720,540,-20,2016-12-19
Agriculture Development Bank Limited,47,530,505,520,9974,5158258,520,0,2016-12-20
Agriculture Development Bank Limited,32,525,500,511,6654,3429880,520,-9,2016-12-21
Agriculture Development Bank Limited,46,513,506,513,8026,4103396,511,2,2016-12-22
Agriculture Development Bank Limited,57,510,497,497,7763,3894717,513,-16,2016-12-26
Agriculture Development Bank Limited,54,506,483,495,10568,5233623,497,-2,2016-12-27
Agriculture Development Bank Limited,30,505,495,498,5725,2863189,495,3,2016-12-28
Agriculture Development Bank Limited,115,526,502,526,19494,10089179,498,28,2016-12-29
Agriculture Development Bank Limited,125,555,535,545,18373,10076866,526,19,2017-01-01
Agriculture Development Bank Limited,138,560,545,545,19457,10709727,545,0,2017-01-02
Agriculture Development Bank Limited,78,550,530,530,8202,4415197,545,-15,2017-01-03
Agriculture Development Bank Limited,39,535,510,530,6130,3225775,530,0,2017-01-04
Agriculture Development Bank Limited,37,533,520,528,8287,4378949,530,-2,2017-01-05
Agriculture Development Bank Limited,26,529,520,524,5593,2926079,528,-4,2017-01-08
Agriculture Development Bank Limited,35,540,521,540,5545,2947042,524,16,2017-01-09
Agriculture Development Bank Limited,41,550,540,540,4148,2249676,540,0,2017-01-10
Agriculture Development Bank Limited,32,550,540,540,8359,4558612,540,0,2017-01-11
Agriculture Development Bank Limited,30,546,531,542,5428,2925146,540,2,2017-01-12
Agriculture Development Bank Limited,21,542,530,534,2339,1253888,542,-8,2017-01-15
Agriculture Development Bank Limited,25,536,527,527,2058,1091490,534,-7,2017-01-16
Agriculture Development Bank Limited,24,529,523,523,3270,1719022,527,-4,2017-01-17
Agriculture Development Bank Limited,21,530,520,520,3386,1783070,523,-3,2017-01-18
Agriculture Development Bank Limited,22,529,521,528,1913,1002025,520,8,2017-01-19
Agriculture Development Bank Limited,32,531,526,526,2773,1466139,528,-2,2017-01-22
Agriculture Development Bank Limited,28,524,520,520,2679,1395359,526,-6,2017-01-23
Agriculture Development Bank Limited,40,530,500,508,7839,4008784,520,-12,2017-01-24
Agriculture Development Bank Limited,148,505,480,490,25727,12653108,508,-18,2017-01-25
Agriculture Development Bank Limited,159,490,455,460,33136,15482268,490,-30,2017-01-26
Agriculture Development Bank Limited,69,465,442,442,12799,5774559,460,-18,2017-01-30
Agriculture Development Bank Limited,37,464,435,458,11409,5152834,442,16,2017-01-31
Agriculture Development Bank Limited,60,485,465,483,9886,4711204,458,25,2017-02-01
Agriculture Development Bank Limited,94,500,480,483,15620,7632898,483,0,2017-02-02
Agriculture Development Bank Limited,27,492,470,470,3121,1489850,483,-13,2017-02-05
Agriculture Development Bank Limited,47,468,455,455,5122,2362049,470,-15,2017-02-06
Agriculture Development Bank Limited,35,463,451,455,4245,1938381,455,0,2017-02-07
Agriculture Development Bank Limited,77,460,448,450,9700,4386164,455,-5,2017-02-08
Agriculture Development Bank Limited,78,453,440,445,12428,5537810,450,-5,2017-02-09
Agriculture Development Bank Limited,75,453,416,429,11551,4886512,445,-16,2017-02-12
Agriculture Development Bank Limited,58,443,413,440,11039,4662838,429,11,2017-02-13
Agriculture Development Bank Limited,82,447,424,437,13085,5708474,440,-3,2017-02-14
Agriculture Development Bank Limited,47,456,442,453,12899,5819825,437,16,2017-02-15
Agriculture Development Bank Limited,98,460,450,453,16259,7356534,453,0,2017-02-16
Agriculture Development Bank Limited,118,452,441,445,23260,10365716,453,-8,2017-02-19
Agriculture Development Bank Limited,98,455,440,440,17150,7643190,445,-5,2017-02-20
Agriculture Development Bank Limited,98,465,437,439,18863,8376472,440,-1,2017-02-21
Agriculture Development Bank Limited,102,442,430,434,22813,9908821,439,-5,2017-02-22
Agriculture Development Bank Limited,69,442,427,440,14367,6260776,434,6,2017-02-23
Agriculture Development Bank Limited,40,445,430,434,6391,2788327,440,-6,2017-02-26
Agriculture Development Bank Limited,91,426,417,421,16732,7032221,434,-13,2017-02-28
Agriculture Development Bank Limited,55,430,421,430,5008,2135041,421,9,2017-03-01
Agriculture Development Bank Limited,57,435,425,435,5828,2521303,430,5,2017-03-02
Agriculture Development Bank Limited,79,448,432,443,12347,5458931,435,8,2017-03-05
Agriculture Development Bank Limited,126,484,460,484,26819,12587312,461,23,2017-03-21
Agriculture Development Bank Limited,75,456,446,449,9615,4316175,443,6,2017-03-06
Agriculture Development Bank Limited,48,443,439,439,5596,2467237,449,-10,2017-03-07
Agriculture Development Bank Limited,37,452,444,445,3547,1583560,439,6,2017-03-09
Agriculture Development Bank Limited,34,450,440,440,5870,2600359,445,-5,2017-03-13
Agriculture Development Bank Limited,67,450,440,441,9273,4113210,440,1,2017-03-14
Agriculture Development Bank Limited,36,449,443,448,3091,1376749,441,7,2017-03-15
Agriculture Development Bank Limited,49,452,441,445,9046,4012644,448,-3,2017-03-16
Agriculture Development Bank Limited,67,454,445,451,10196,4592620,445,6,2017-03-19
Agriculture Development Bank Limited,88,465,455,461,16216,7455757,451,10,2017-03-20
Agriculture Development Bank Limited,207,515,485,492,46018,23059369,484,8,2017-03-22
Agriculture Development Bank Limited,238,514,493,511,42052,21317008,492,19,2017-03-23
Agriculture Development Bank Limited,330,562,512,562,86224,47708756,511,51,2017-03-26
Agriculture Development Bank Limited,275,606,573,595,63335,37423649,562,33,2017-03-28
Agriculture Development Bank Limited,535,615,550,565,122754,70858145,595,-30,2017-03-29
Agriculture Development Bank Limited,695,577,555,574,151987,86067068,565,9,2017-03-30
Agriculture Development Bank Limited,334,525,487,504,86048,43752580,478,26,2017-04-03
Agriculture Development Bank Limited,165,508,480,495,38622,19049502,504,-9,2017-04-04
Agriculture Development Bank Limited,163,495,474,482,42085,20121788,495,-13,2017-04-06
Agriculture Development Bank Limited,130,485,470,472,26361,12443931,482,-10,2017-04-09
Agriculture Development Bank Limited,109,485,467,471,24705,11622539,472,-1,2017-04-10
Agriculture Development Bank Limited,125,494,470,489,29427,14275730,471,18,2017-04-11
Agriculture Development Bank Limited,167,500,480,480,43976,21570036,489,-9,2017-04-12
Agriculture Development Bank Limited,130,482,468,472,25576,12157715,480,-8,2017-04-13
Agriculture Development Bank Limited,90,481,457,460,14433,6817342,472,-12,2017-04-16
Agriculture Development Bank Limited,121,460,443,450,26897,12146144,460,-10,2017-04-18
Agriculture Development Bank Limited,96,469,453,463,15551,7173984,450,13,2017-04-19
Agriculture Development Bank Limited,139,483,463,465,32994,15564848,463,2,2017-04-20
Agriculture Development Bank Limited,147,511,472,472,45549,21857591,465,7,2017-04-23
Agriculture Development Bank Limited,116,474,466,469,23133,10859181,472,-3,2017-04-24
Agriculture Development Bank Limited,100,472,464,469,17195,8041381,469,0,2017-04-25
Agriculture Development Bank Limited,53,472,465,467,9098,4257990,469,-2,2017-04-26
Agriculture Development Bank Limited,71,475,463,466,15743,7381184,467,-1,2017-04-27
Agriculture Development Bank Limited,97,470,454,459,18728,8571257,466,-7,2017-04-30
Agriculture Development Bank Limited,99,468,445,461,22562,10244556,459,2,2017-05-02
Agriculture Development Bank Limited,69,478,457,461,13689,6359865,461,0,2017-05-03
Agriculture Development Bank Limited,68,478,454,460,10579,4862372,461,-1,2017-05-04
Agriculture Development Bank Limited,57,464,453,454,5619,2567369,460,-6,2017-05-07
Agriculture Development Bank Limited,74,465,446,460,16791,7593535,454,6,2017-05-08
Agriculture Development Bank Limited,69,461,452,457,21081,9605186,460,-3,2017-05-09
Agriculture Development Bank Limited,76,466,461,464,12423,5755865,457,7,2017-05-11
Agriculture Development Bank Limited,48,471,460,465,10542,4873562,464,1,2017-05-15
Agriculture Development Bank Limited,55,465,455,456,7225,3308817,465,-9,2017-05-16
Agriculture Development Bank Limited,41,460,454,455,4811,2194661,456,-1,2017-05-17
Agriculture Development Bank Limited,49,458,450,451,6117,2771963,455,-4,2017-05-18
Agriculture Development Bank Limited,72,460,444,450,10460,4687103,451,-1,2017-05-21
Agriculture Development Bank Limited,32,450,441,448,3174,1418900,450,-2,2017-05-22
Agriculture Development Bank Limited,46,455,443,450,6912,3118403,448,2,2017-05-23
Agriculture Development Bank Limited,52,456,448,455,11662,5282774,450,5,2017-05-24
Agriculture Development Bank Limited,72,455,445,450,9086,4093677,455,-5,2017-05-28
Agriculture Development Bank Limited,43,450,441,444,7182,3193641,450,-6,2017-05-30
Agriculture Development Bank Limited,79,455,439,450,8727,3874255,444,6,2017-05-31
Agriculture Development Bank Limited,99,459,444,446,14518,6514331,450,-4,2017-06-01
Agriculture Development Bank Limited,71,450,440,445,10779,4796056,446,-1,2017-06-04
Agriculture Development Bank Limited,73,450,443,443,12176,5438368,445,-2,2017-06-05
Agriculture Development Bank Limited,88,458,448,454,10899,4918322,443,11,2017-06-06
Agriculture Development Bank Limited,72,463,450,453,14334,6502554,454,-1,2017-06-07
Agriculture Development Bank Limited,45,452,444,449,6842,3058885,453,-4,2017-06-08
Agriculture Development Bank Limited,52,448,440,444,7886,3493484,449,-5,2017-06-11
Agriculture Development Bank Limited,89,446,434,445,9184,4039315,444,1,2017-06-12
Agriculture Development Bank Limited,73,444,435,435,13963,6114368,445,-10,2017-06-13
Agriculture Development Bank Limited,63,440,434,435,8869,3869751,435,0,2017-06-14
Agriculture Development Bank Limited,97,442,432,440,15064,6569564,435,5,2017-06-15
Agriculture Development Bank Limited,137,440,428,431,19261,8290076,440,-9,2017-06-18
Agriculture Development Bank Limited,125,431,417,427,21359,9040694,431,-4,2017-06-19
Agriculture Development Bank Limited,98,429,415,423,12740,5380466,427,-4,2017-06-20
Agriculture Development Bank Limited,54,425,417,421,6334,2673676,423,-2,2017-06-21
Agriculture Development Bank Limited,105,429,420,421,16465,6949115,421,0,2017-06-22
Agriculture Development Bank Limited,75,426,419,423,10516,4451695,421,2,2017-06-25
Agriculture Development Bank Limited,82,425,420,422,11352,4795475,423,-1,2017-06-27
Agriculture Development Bank Limited,61,428,415,428,10162,4287790,422,6,2017-06-28
Agriculture Development Bank Limited,94,430,419,428,14946,6315356,428,0,2017-07-02
Agriculture Development Bank Limited,51,430,420,423,7794,3311499,428,-5,2017-07-03
Agriculture Development Bank Limited,80,426,419,420,13712,5768673,423,-3,2017-07-04
Agriculture Development Bank Limited,73,425,419,425,11348,4786382,420,5,2017-07-05
Agriculture Development Bank Limited,93,437,425,437,18660,7970364,425,12,2017-07-06
Agriculture Development Bank Limited,95,446,430,441,20091,8794058,437,4,2017-07-09
Agriculture Development Bank Limited,81,440,430,433,12785,5585373,441,-8,2017-07-10
Agriculture Development Bank Limited,68,440,430,435,9864,4318391,433,2,2017-07-11
Agriculture Development Bank Limited,63,440,432,432,8794,3825056,435,-3,2017-07-12
Agriculture Development Bank Limited,84,437,430,435,12875,5549593,432,3,2017-07-13
Agriculture Development Bank Limited,47,435,430,433,4465,1927023,435,-2,2017-07-16
Agriculture Development Bank Limited,74,448,433,448,16129,7096066,433,15,2017-07-17
Agriculture Development Bank Limited,181,472,449,472,27796,12739662,448,24,2017-07-18
Agriculture Development Bank Limited,94,459,450,453,14097,6379143,454,-1,2017-08-03
Agriculture Development Bank Limited,121,470,460,460,21239,9884869,472,-12,2017-07-19
Agriculture Development Bank Limited,88,465,454,461,10954,5040009,460,1,2017-07-20
Agriculture Development Bank Limited,88,465,455,459,16709,7668931,461,-2,2017-07-23
Agriculture Development Bank Limited,91,460,454,455,13393,6112032,459,-4,2017-07-24
Agriculture Development Bank Limited,78,461,454,458,16138,7380111,455,3,2017-07-25
Agriculture Development Bank Limited,96,460,448,450,22953,10401083,458,-8,2017-07-26
Agriculture Development Bank Limited,75,460,450,460,11335,5133609,450,10,2017-07-27
Agriculture Development Bank Limited,60,461,445,451,9537,4331121,460,-9,2017-07-30
Agriculture Development Bank Limited,76,459,450,453,12315,5598249,451,2,2017-07-31
Agriculture Development Bank Limited,87,469,450,454,9280,4235329,453,1,2017-08-01
Agriculture Development Bank Limited,56,456,453,454,12168,5532203,454,0,2017-08-02
Agriculture Development Bank Limited,104,456,450,454,18930,8598441,453,1,2017-08-06
Agriculture Development Bank Limited,87,463,452,453,11926,5419900,454,-1,2017-08-07
Agriculture Development Bank Limited,123,460,444,450,17516,7934355,453,-3,2017-08-09
Agriculture Development Bank Limited,97,454,443,450,21245,9497817,450,0,2017-08-10
Agriculture Development Bank Limited,86,449,440,445,14415,6423464,450,-5,2017-08-13
Agriculture Development Bank Limited,96,446,441,441,15104,6699557,445,-4,2017-08-15
Agriculture Development Bank Limited,84,448,442,444,11304,5021857,441,3,2017-08-16
Agriculture Development Bank Limited,75,449,438,443,23326,10279553,444,-1,2017-08-17
Agriculture Development Bank Limited,89,444,435,440,16054,7075869,443,-3,2017-08-20
Agriculture Development Bank Limited,46,442,432,438,5674,2474784,440,-2,2017-08-21
Agriculture Development Bank Limited,79,442,436,441,12396,5447828,438,3,2017-08-22
Agriculture Development Bank Limited,52,442,438,441,7718,3396666,441,0,2017-08-23
Agriculture Development Bank Limited,44,453,434,443,11438,5093781,441,2,2017-08-24
Agriculture Development Bank Limited,62,451,443,446,3889,1732805,443,3,2017-08-27
Agriculture Development Bank Limited,61,452,444,446,7897,3519687,446,0,2017-08-28
Agriculture Development Bank Limited,83,443,435,438,14820,6508340,446,-8,2017-08-30
Agriculture Development Bank Limited,83,438,432,437,15528,6769346,438,-1,2017-08-31
Agriculture Development Bank Limited,94,439,426,430,33009,14133477,437,-7,2017-09-04
Agriculture Development Bank Limited,111,440,425,438,11603,4994219,430,8,2017-09-06
Agriculture Development Bank Limited,89,438,426,428,34082,14711435,438,-10,2017-09-07
Agriculture Development Bank Limited,126,431,423,425,37704,16076730,428,-3,2017-09-10
Agriculture Development Bank Limited,65,430,420,424,17950,7592940,425,-1,2017-09-11
Agriculture Development Bank Limited,98,426,420,421,27903,11782776,424,-3,2017-09-12
Agriculture Development Bank Limited,111,423,418,420,32249,13538906,421,-1,2017-09-13
Agriculture Development Bank Limited,115,447,419,447,42524,18361183,420,27,2017-09-14
Agriculture Development Bank Limited,159,459,438,447,49764,22001355,447,0,2017-09-17
Agriculture Development Bank Limited,119,452,443,443,33400,14877419,447,-4,2017-09-18
Agriculture Development Bank Limited,65,443,435,439,10450,4599400,443,-4,2017-09-20
Agriculture Development Bank Limited,76,433,425,431,17649,7561101,432,-1,2017-10-09
Agriculture Development Bank Limited,42,443,439,441,3718,1638796,439,2,2017-09-24
Agriculture Development Bank Limited,29,448,440,448,2882,1272835,441,7,2017-09-25
Agriculture Development Bank Limited,35,449,443,448,5132,2286875,448,0,2017-09-26
Agriculture Development Bank Limited,20,453,446,453,3164,1415634,448,5,2017-10-03
Agriculture Development Bank Limited,40,450,437,440,6475,2854121,453,-13,2017-10-04
Agriculture Development Bank Limited,91,432,420,432,15759,6712529,440,-8,2017-10-08
Agriculture Development Bank Limited,89,438,423,427,19003,8118044,431,-4,2017-10-10
Agriculture Development Bank Limited,65,431,425,428,11993,5132940,427,1,2017-10-11
Agriculture Development Bank Limited,45,435,428,429,5474,2357856,428,1,2017-10-12
Agriculture Development Bank Limited,49,433,427,433,5553,2393186,429,4,2017-10-15
Agriculture Development Bank Limited,87,451,434,442,18696,8294486,433,9,2017-10-16
Agriculture Development Bank Limited,64,450,436,449,12124,5388922,442,7,2017-10-17
Agriculture Development Bank Limited,53,450,438,444,12688,5628714,449,-5,2017-10-18
Agriculture Development Bank Limited,44,458,436,450,11183,5051656,444,6,2017-10-22
Agriculture Development Bank Limited,79,455,445,449,12644,5695162,450,-1,2017-10-23
Agriculture Development Bank Limited,59,452,445,448,9549,4278475,449,-1,2017-10-24
Agriculture Development Bank Limited,93,451,444,449,17137,7675865,448,1,2017-10-25
Agriculture Development Bank Limited,51,447,440,442,7203,3185825,449,-7,2017-10-29
Agriculture Development Bank Limited,71,443,437,437,13723,6029799,442,-5,2017-10-30
Agriculture Development Bank Limited,38,440,433,437,8889,3866223,437,0,2017-10-31
Agriculture Development Bank Limited,51,437,429,434,6291,2725033,437,-3,2017-11-01
Agriculture Development Bank Limited,58,442,430,440,8331,3632384,434,6,2017-11-02
Agriculture Development Bank Limited,84,440,424,430,16936,7255084,440,-10,2017-11-05
Agriculture Development Bank Limited,139,430,420,429,29796,12642926,430,-1,2017-11-06
Agriculture Development Bank Limited,80,436,420,422,26141,11088659,429,-7,2017-11-07
Agriculture Development Bank Limited,126,422,414,416,17305,7217966,422,-6,2017-11-08
Agriculture Development Bank Limited,64,427,412,415,9434,3918031,416,-1,2017-11-09
Agriculture Development Bank Limited,59,425,415,423,9098,3815462,415,8,2017-11-12
Agriculture Development Bank Limited,69,428,420,428,14684,6245012,423,5,2017-11-13
Agriculture Development Bank Limited,65,434,424,432,14580,6256963,428,4,2017-11-14
Agriculture Development Bank Limited,56,432,426,428,3596,1544399,432,-4,2017-11-15
Agriculture Development Bank Limited,56,435,420,420,13740,5797379,428,-8,2017-11-16
Agriculture Development Bank Limited,72,422,412,420,13373,5575148,420,0,2017-11-19
Agriculture Development Bank Limited,33,422,418,421,4579,1923518,420,1,2017-11-20
Agriculture Development Bank Limited,30,425,421,423,4762,2015105,421,2,2017-11-21
Agriculture Development Bank Limited,39,429,421,425,5998,2539736,423,2,2017-11-22
Agriculture Development Bank Limited,52,430,425,425,7260,3103718,425,0,2017-11-23
Agriculture Development Bank Limited,71,441,425,432,10953,4710293,425,7,2017-11-26
Agriculture Development Bank Limited,42,435,430,430,6918,2983035,432,-2,2017-11-27
Agriculture Development Bank Limited,40,432,425,431,12551,5401048,430,1,2017-11-28
Agriculture Development Bank Limited,87,439,430,436,19013,8283527,431,5,2017-11-29
Agriculture Development Bank Limited,63,438,431,437,10518,4566994,436,1,2017-11-30
Agriculture Development Bank Limited,46,437,430,435,10306,4465824,437,-2,2017-12-04
Agriculture Development Bank Limited,29,426,419,422,3192,1350383,424,-2,2017-12-20
Agriculture Development Bank Limited,51,442,430,431,6588,2837524,435,-4,2017-12-05
Agriculture Development Bank Limited,47,437,426,435,9725,4204614,431,4,2017-12-06
Agriculture Development Bank Limited,46,451,428,430,11646,5072147,435,-5,2017-12-10
Agriculture Development Bank Limited,51,433,424,431,12873,5506814,430,1,2017-12-11
Agriculture Development Bank Limited,46,431,426,427,15642,6693617,431,-4,2017-12-12
Agriculture Development Bank Limited,22,431,421,428,4262,1812383,427,1,2017-12-13
Agriculture Development Bank Limited,59,433,424,425,5967,2540238,428,-3,2017-12-14
Agriculture Development Bank Limited,35,430,423,423,6121,2599496,425,-2,2017-12-17
Agriculture Development Bank Limited,39,426,422,426,4333,1839010,423,3,2017-12-18
Agriculture Development Bank Limited,38,426,421,424,8052,3410220,426,-2,2017-12-19
Agriculture Development Bank Limited,28,423,417,420,7557,3178267,422,-2,2017-12-21
Agriculture Development Bank Limited,48,428,420,421,7917,3341185,420,1,2017-12-24
Agriculture Development Bank Limited,30,426,411,420,7244,3040975,421,-1,2017-12-26
Agriculture Development Bank Limited,73,418,408,415,11368,4701950,420,-5,2017-12-27
Agriculture Development Bank Limited,74,417,400,410,9917,4064962,415,-5,2017-12-28
Agriculture Development Bank Limited,93,409,400,402,27546,11089087,410,-8,2017-12-31
Agriculture Development Bank Limited,48,414,405,414,6665,2726955,402,12,2018-01-01
Agriculture Development Bank Limited,240,430,416,425,55870,23639633,414,11,2018-01-02
Agriculture Development Bank Limited,115,428,419,422,15373,6515991,425,-3,2018-01-03
Agriculture Development Bank Limited,61,421,416,421,5788,2425843,422,-1,2018-01-04
Agriculture Development Bank Limited,91,429,416,423,18051,7598573,421,2,2018-01-07
Agriculture Development Bank Limited,57,430,420,425,8389,3558019,423,2,2018-01-08
Agriculture Development Bank Limited,44,427,422,425,7302,3105363,425,0,2018-01-09
Agriculture Development Bank Limited,70,427,421,425,7277,3089550,425,0,2018-01-10
Agriculture Development Bank Limited,66,427,417,420,10523,4415231,425,-5,2018-01-14
Agriculture Development Bank Limited,34,421,415,417,4270,1778362,420,-3,2018-01-16
Agriculture Development Bank Limited,48,417,409,413,6401,2647102,417,-4,2018-01-17
Agriculture Development Bank Limited,153,420,413,419,21733,9065805,413,6,2018-01-21
Agriculture Development Bank Limited,108,422,418,420,18056,7571323,419,1,2018-01-22
Agriculture Development Bank Limited,98,421,415,416,15725,6564115,420,-4,2018-01-23
Agriculture Development Bank Limited,86,420,412,419,14131,5896929,416,3,2018-01-24
Agriculture Development Bank Limited,141,420,417,420,13110,5476669,419,1,2018-01-25
Agriculture Development Bank Limited,341,423,415,415,49337,20640167,420,-5,2018-01-28
Agriculture Development Bank Limited,62,347,340,340,8266,2828715,346,-6,2018-01-29
Agriculture Development Bank Limited,42,344,340,344,4790,1636893,340,4,2018-01-31
Agriculture Development Bank Limited,53,345,343,344,6191,2133740,344,0,2018-02-01
Agriculture Development Bank Limited,57,350,342,350,8959,3116418,344,6,2018-02-04
Agriculture Development Bank Limited,57,350,342,342,8109,2793340,350,-8,2018-02-05
Agriculture Development Bank Limited,44,347,340,347,5214,1780333,342,5,2018-02-06
Agriculture Development Bank Limited,25,346,341,342,5012,1715421,347,-5,2018-02-07
Agriculture Development Bank Limited,39,345,336,342,3523,1208072,342,0,2018-02-08
Agriculture Development Bank Limited,33,342,335,338,3932,1323562,340,-2,2018-02-25
Agriculture Development Bank Limited,28,343,341,342,1760,601865,342,0,2018-02-11
Agriculture Development Bank Limited,35,342,340,340,3785,1289922,342,-2,2018-02-12
Agriculture Development Bank Limited,36,342,335,340,4167,1408438,340,0,2018-02-14
Agriculture Development Bank Limited,58,350,341,350,7548,2607158,340,10,2018-02-15
Agriculture Development Bank Limited,91,359,348,350,11904,4191852,350,0,2018-02-18
Agriculture Development Bank Limited,52,351,340,340,6728,2317045,350,-10,2018-02-20
Agriculture Development Bank Limited,23,341,339,340,2461,836966,340,0,2018-02-21
Agriculture Development Bank Limited,47,342,338,340,4099,1394160,340,0,2018-02-22
Agriculture Development Bank Limited,34,337,335,335,4951,1661667,338,-3,2018-02-26
Agriculture Development Bank Limited,42,342,332,338,4409,1484882,335,3,2018-02-27
Agriculture Development Bank Limited,39,339,334,334,13018,4369744,338,-4,2018-02-28
Agriculture Development Bank Limited,61,330,325,328,16726,5461805,334,-6,2018-03-04
Agriculture Development Bank Limited,64,330,323,324,16594,5384502,328,-4,2018-03-05
Agriculture Development Bank Limited,51,328,320,327,5748,1861617,324,3,2018-03-06
Agriculture Development Bank Limited,45,333,327,330,6817,2256339,327,3,2018-03-07
Agriculture Development Bank Limited,43,331,326,326,6491,2131371,330,-4,2018-03-11
Agriculture Development Bank Limited,28,331,326,328,10231,3365920,326,2,2018-03-12
Agriculture Development Bank Limited,46,333,327,333,8561,2828509,328,5,2018-03-13
Agriculture Development Bank Limited,36,335,328,335,8410,2787208,333,2,2018-03-14
Agriculture Development Bank Limited,58,337,330,335,10440,3496620,335,0,2018-03-15
Agriculture Development Bank Limited,39,339,333,334,5791,1934030,335,-1,2018-03-18
Agriculture Development Bank Limited,30,335,325,325,5937,1939750,334,-9,2018-03-19
Agriculture Development Bank Limited,25,327,321,323,2133,689613,325,-2,2018-03-20
Agriculture Development Bank Limited,73,321,314,316,11081,3509629,323,-7,2018-03-21
Agriculture Development Bank Limited,55,320,310,316,6600,2077888,316,0,2018-03-22
Agriculture Development Bank Limited,86,313,299,300,10390,3161312,316,-16,2018-03-26
Agriculture Development Bank Limited,86,326,283,316,16469,4927113,300,16,2018-03-27
Agriculture Development Bank Limited,99,317,307,311,12154,3801930,316,-5,2018-03-28
Agriculture Development Bank Limited,66,320,311,318,8252,2610653,311,7,2018-03-29
Agriculture Development Bank Limited,56,320,308,313,6979,2181409,318,-5,2018-04-01
Agriculture Development Bank Limited,33,318,310,314,6267,1957517,313,1,2018-04-02
Agriculture Development Bank Limited,33,318,310,315,3431,1080948,314,1,2018-04-03
Agriculture Development Bank Limited,81,326,315,325,12813,4139091,315,10,2018-04-04
Agriculture Development Bank Limited,103,335,321,331,22167,7296728,325,6,2018-04-05
Agriculture Development Bank Limited,115,348,331,340,17000,5765359,331,9,2018-04-08
Agriculture Development Bank Limited,80,346,334,335,13810,4682890,340,-5,2018-04-09
Agriculture Development Bank Limited,37,337,325,334,6099,2023472,335,-1,2018-04-10
Agriculture Development Bank Limited,45,335,328,335,5135,1702717,334,1,2018-04-11
Agriculture Development Bank Limited,39,340,332,337,9067,3064628,335,2,2018-04-12
Agriculture Development Bank Limited,27,340,326,340,7648,2538264,337,3,2018-04-15
Agriculture Development Bank Limited,44,341,335,338,5765,1952451,340,-2,2018-04-16
Agriculture Development Bank Limited,84,343,336,337,17345,5875128,338,-1,2018-04-17
Agriculture Development Bank Limited,76,354,337,345,17497,6018812,337,8,2018-04-18
Agriculture Development Bank Limited,93,353,347,351,24467,8591259,345,6,2018-04-19
Agriculture Development Bank Limited,139,370,352,369,36790,13381295,351,18,2018-04-22
Agriculture Development Bank Limited,142,382,360,360,39505,14550792,369,-9,2018-04-23
Agriculture Development Bank Limited,93,365,345,359,16417,5863413,360,-1,2018-04-24
Agriculture Development Bank Limited,73,360,351,352,10118,3576536,359,-7,2018-04-25
Agriculture Development Bank Limited,73,354,345,348,10047,3496945,352,-4,2018-04-26
Agriculture Development Bank Limited,70,348,337,344,10608,3637412,348,-4,2018-04-29
Agriculture Development Bank Limited,45,342,338,341,5447,1851294,344,-3,2018-05-02
Agriculture Development Bank Limited,79,352,343,346,9858,3429602,341,5,2018-05-03
Agriculture Development Bank Limited,78,346,343,343,9671,3330659,346,-3,2018-05-06
Agriculture Development Bank Limited,62,345,339,343,6251,2139147,343,0,2018-05-07
Agriculture Development Bank Limited,33,343,340,343,5181,1766629,343,0,2018-05-08
Agriculture Development Bank Limited,50,347,344,344,6849,2366426,343,1,2018-05-09
Agriculture Development Bank Limited,66,346,337,343,11575,3945761,344,-1,2018-05-10
Agriculture Development Bank Limited,42,344,338,341,4201,1434612,343,-2,2018-05-14
Agriculture Development Bank Limited,29,342,337,339,2916,987956,341,-2,2018-05-15
Agriculture Development Bank Limited,29,344,337,341,3039,1034751,339,2,2018-05-16
Agriculture Development Bank Limited,42,343,339,339,6983,2384710,341,-2,2018-05-17
Agriculture Development Bank Limited,45,344,338,340,9261,3153251,339,1,2018-05-20
Agriculture Development Bank Limited,60,340,335,340,10925,3694072,340,0,2018-05-21
Agriculture Development Bank Limited,59,340,335,337,6973,2356133,340,-3,2018-05-22
Alpine Development Bank Limited,14,555,543,554,2264,1239925,542,12,2016-05-23
Alpine Development Bank Limited,14,560,550,551,3034,1680287,554,-3,2016-05-24
Alpine Development Bank Limited,11,570,543,570,2991,1656566,551,19,2016-05-25
Alpine Development Bank Limited,2,560,559,559,310,173400,570,-11,2016-05-26
Alpine Development Bank Limited,6,579,551,551,576,323490,559,-8,2016-05-29
Alpine Development Bank Limited,16,565,529,533,4965,2705234,551,-18,2016-05-30
Alpine Development Bank Limited,20,550,536,540,4243,2297964,533,7,2016-05-31
Alpine Development Bank Limited,2,561,550,561,53,29480,540,21,2016-06-01
Alpine Development Bank Limited,15,583,550,552,5397,3004886,561,-9,2016-06-02
Alpine Development Bank Limited,6,550,525,538,392,209807,552,-14,2016-06-05
Alpine Development Bank Limited,12,545,530,545,2093,1120610,538,7,2016-06-06
Alpine Development Bank Limited,5,552,541,550,2187,1204643,545,5,2016-06-07
Alpine Development Bank Limited,19,651,610,620,2957,1846472,640,-20,2016-06-23
Alpine Development Bank Limited,12,561,540,540,5100,2776700,550,-10,2016-06-08
Alpine Development Bank Limited,7,550,540,541,855,468304,540,1,2016-06-09
Alpine Development Bank Limited,6,555,536,545,518,285568,541,4,2016-06-12
Alpine Development Bank Limited,13,560,541,541,2070,1152999,545,-4,2016-06-13
Alpine Development Bank Limited,12,555,545,555,4618,2533488,541,14,2016-06-14
Alpine Development Bank Limited,62,610,559,605,11665,6903357,555,50,2016-06-15
Alpine Development Bank Limited,30,645,615,615,8464,5359486,605,10,2016-06-16
Alpine Development Bank Limited,19,611,580,581,4975,2935584,615,-34,2016-06-19
Alpine Development Bank Limited,15,601,590,595,3034,1802882,581,14,2016-06-20
Alpine Development Bank Limited,9,600,587,587,731,432705,595,-8,2016-06-21
Alpine Development Bank Limited,22,645,598,640,4335,2733465,587,53,2016-06-22
Alpine Development Bank Limited,71,682,627,682,24417,16270498,620,62,2016-06-26
Alpine Development Bank Limited,20,690,667,667,4987,3403845,682,-15,2016-06-27
Alpine Development Bank Limited,61,705,680,700,12189,8474586,667,33,2016-06-28
Alpine Development Bank Limited,50,730,695,700,9714,6844222,700,0,2016-06-29
Alpine Development Bank Limited,56,705,686,705,11946,8288019,700,5,2016-06-30
Alpine Development Bank Limited,175,758,719,749,40924,30183631,705,44,2016-07-03
Alpine Development Bank Limited,226,766,730,740,43066,32189759,749,-9,2016-07-04
Alpine Development Bank Limited,28,463,426,463,5411,2489015,421,42,2016-07-05
Alpine Development Bank Limited,23,500,465,487,5929,2909177,463,24,2016-07-06
Alpine Development Bank Limited,23,495,478,485,5386,2611355,487,-2,2016-07-10
Alpine Development Bank Limited,10,494,453,460,1078,507209,485,-25,2016-07-11
Alpine Development Bank Limited,10,467,446,446,1455,668940,460,-14,2016-07-12
Alpine Development Bank Limited,8,460,438,460,1037,465682,446,14,2016-07-13
Alpine Development Bank Limited,5,460,457,460,1153,529411,460,0,2016-07-14
Alpine Development Bank Limited,21,481,451,473,1961,919834,460,13,2016-07-17
Alpine Development Bank Limited,10,480,465,469,1420,673050,473,-4,2016-07-18
Alpine Development Bank Limited,12,480,460,460,1253,585473,469,-9,2016-07-19
Alpine Development Bank Limited,11,478,451,451,1840,853390,460,-9,2016-07-20
Alpine Development Bank Limited,13,479,450,479,2190,1028676,451,28,2016-07-21
Alpine Development Bank Limited,22,488,479,485,4823,2324615,479,6,2016-07-25
Alpine Development Bank Limited,29,505,489,503,6858,3410682,485,18,2016-07-26
Alpine Development Bank Limited,12,514,503,506,3131,1597839,503,3,2016-07-27
Alpine Development Bank Limited,9,515,495,495,1279,644522,506,-11,2016-07-28
Alpine Development Bank Limited,11,504,490,499,1375,679799,495,4,2016-07-31
Alpine Development Bank Limited,12,490,472,485,939,455039,499,-14,2016-08-01
Alpine Development Bank Limited,5,485,476,485,182,86839,485,0,2016-08-02
Alpine Development Bank Limited,8,485,465,465,1538,739812,485,-20,2016-08-04
Alpine Development Bank Limited,15,499,474,483,1340,656440,465,18,2016-08-07
Alpine Development Bank Limited,4,475,456,456,576,270390,483,-27,2016-08-08
Alpine Development Bank Limited,11,475,455,471,1431,667265,456,15,2016-08-10
Alpine Development Bank Limited,14,469,457,460,1048,484677,471,-11,2016-08-11
Alpine Development Bank Limited,10,455,451,451,2159,979318,460,-9,2016-08-14
Alpine Development Bank Limited,7,444,436,441,558,245880,451,-10,2016-08-15
Alpine Development Bank Limited,14,450,433,440,3429,1504810,451,-11,2016-08-31
Alpine Development Bank Limited,4,460,445,460,201,91195,441,19,2016-08-16
Alpine Development Bank Limited,8,465,456,456,375,172798,460,-4,2016-08-17
Alpine Development Bank Limited,2,460,455,460,230,105450,456,4,2016-08-21
Alpine Development Bank Limited,1,451,451,451,250,112750,460,-9,2016-08-30
Alpine Development Bank Limited,9,464,439,464,1094,495010,440,24,2016-09-01
Alpine Development Bank Limited,17,490,456,490,3257,1535227,464,26,2016-09-04
Alpine Development Bank Limited,8,495,480,480,768,373865,490,-10,2016-09-05
Alpine Development Bank Limited,25,507,476,480,3653,1788638,480,0,2016-09-06
Alpine Development Bank Limited,7,489,471,472,514,246056,480,-8,2016-09-07
Alpine Development Bank Limited,12,480,471,480,2626,1253701,472,8,2016-09-08
Alpine Development Bank Limited,3,480,472,476,740,352280,480,-4,2016-09-11
Alpine Development Bank Limited,22,480,465,480,2056,969787,476,4,2016-09-12
Alpine Development Bank Limited,8,472,462,462,1500,698200,480,-18,2016-09-14
Alpine Development Bank Limited,18,475,453,475,3762,1737589,462,13,2016-09-18
Alpine Development Bank Limited,11,466,450,451,1170,533556,475,-24,2016-09-20
Alpine Development Bank Limited,10,460,443,460,1466,655576,451,9,2016-09-21
Alpine Development Bank Limited,11,460,442,450,429,193808,460,-10,2016-09-22
Alpine Development Bank Limited,3,459,441,441,229,102969,450,-9,2016-09-25
Alpine Development Bank Limited,7,447,440,447,680,302824,441,6,2016-09-26
Alpine Development Bank Limited,2,440,440,440,250,110000,447,-7,2016-09-27
Alpine Development Bank Limited,8,445,435,445,725,320789,440,5,2016-09-29
Alpine Development Bank Limited,3,438,437,437,850,371550,445,-8,2016-10-02
Alpine Development Bank Limited,9,430,422,430,1189,505030,437,-7,2016-10-03
Alpine Development Bank Limited,2,446,438,446,240,105280,430,16,2016-10-04
Alpine Development Bank Limited,5,454,445,445,220,98080,446,-1,2016-10-05
Alpine Development Bank Limited,4,450,445,445,630,281050,445,0,2016-10-06
Alpine Development Bank Limited,1,445,445,445,400,178000,445,0,2016-10-17
Alpine Development Bank Limited,1,445,445,445,250,111250,445,0,2016-10-18
Alpine Development Bank Limited,2,437,437,437,22,9614,445,-8,2016-10-19
Alpine Development Bank Limited,8,444,432,442,1319,582980,437,5,2016-10-23
Alpine Development Bank Limited,1,450,450,450,20,9000,442,8,2016-10-26
Alpine Development Bank Limited,2,458,458,458,150,68700,450,8,2016-10-27
Alpine Development Bank Limited,2,449,441,441,111,49039,458,-17,2016-11-08
Alpine Development Bank Limited,2,433,425,425,291,124315,441,-16,2016-11-10
Alpine Development Bank Limited,4,417,402,410,300,123705,425,-15,2016-11-13
Alpine Development Bank Limited,2,414,410,410,609,251726,410,0,2016-11-14
Alpine Development Bank Limited,4,418,410,411,556,228655,410,1,2016-11-15
Alpine Development Bank Limited,5,403,392,392,811,319550,411,-19,2016-11-16
Alpine Development Bank Limited,2,385,385,385,150,57750,392,-7,2016-11-17
Alpine Development Bank Limited,5,380,370,375,381,142980,385,-10,2016-11-20
Alpine Development Bank Limited,10,396,363,396,1343,508264,375,21,2016-11-21
Alpine Development Bank Limited,4,403,381,381,412,163845,396,-15,2016-11-24
Alpine Development Bank Limited,1,374,374,374,50,18700,381,-7,2016-11-27
Alpine Development Bank Limited,6,370,363,363,431,158953,374,-11,2016-11-29
Alpine Development Bank Limited,5,391,370,391,553,210096,363,28,2016-11-30
Alpine Development Bank Limited,2,396,389,389,123,48008,391,-2,2016-12-01
Alpine Development Bank Limited,2,390,383,383,200,77650,389,-6,2016-12-04
Alpine Development Bank Limited,5,390,370,370,581,216533,383,-13,2016-12-05
Alpine Development Bank Limited,1,363,363,363,50,18150,370,-7,2016-12-06
Alpine Development Bank Limited,2,363,360,360,161,58410,363,-3,2016-12-07
Alpine Development Bank Limited,2,359,353,359,293,105049,360,-1,2016-12-08
Alpine Development Bank Limited,2,352,345,345,200,69700,359,-14,2016-12-12
Alpine Development Bank Limited,1,339,339,339,200,67800,345,-6,2016-12-14
Alpine Development Bank Limited,1,335,335,335,23,7705,339,-4,2016-12-15
Alpine Development Bank Limited,5,367,341,367,110,39490,335,32,2016-12-18
Alpine Development Bank Limited,24,394,374,375,2729,1053171,367,8,2016-12-19
Alpine Development Bank Limited,21,399,375,384,1991,766870,375,9,2016-12-20
Alpine Development Bank Limited,12,386,377,379,1613,614661,384,-5,2016-12-21
Alpine Development Bank Limited,6,384,377,377,450,171000,379,-2,2016-12-22
Alpine Development Bank Limited,8,380,372,379,750,283330,377,2,2016-12-26
Alpine Development Bank Limited,11,380,368,368,1083,405545,379,-11,2016-12-27
Alpine Development Bank Limited,3,321,320,320,571,182770,321,-1,2017-01-01
Alpine Development Bank Limited,7,320,314,320,612,194290,320,0,2017-01-02
Alpine Development Bank Limited,12,314,302,302,1093,335114,320,-18,2017-01-03
Alpine Development Bank Limited,21,305,282,300,3745,1107635,302,-2,2017-01-04
Alpine Development Bank Limited,4,300,291,291,620,185070,300,-9,2017-01-05
Alpine Development Bank Limited,15,290,283,283,1668,478650,291,-8,2017-01-08
Alpine Development Bank Limited,3,293,283,293,255,72865,283,10,2017-01-09
Alpine Development Bank Limited,5,300,291,295,794,234340,293,2,2017-01-10
Alpine Development Bank Limited,6,311,300,305,342,104332,295,10,2017-01-11
Alpine Development Bank Limited,3,311,305,305,250,77150,305,0,2017-01-12
Alpine Development Bank Limited,1,300,300,300,500,150000,305,-5,2017-01-15
Alpine Development Bank Limited,1,294,294,294,17,4998,300,-6,2017-01-16
Alpine Development Bank Limited,7,292,287,287,600,174100,294,-7,2017-01-17
Alpine Development Bank Limited,5,295,284,290,782,223084,287,3,2017-01-18
Alpine Development Bank Limited,1,290,290,290,100,29000,290,0,2017-01-19
Alpine Development Bank Limited,6,300,295,296,751,223916,290,6,2017-01-22
Alpine Development Bank Limited,8,300,292,292,545,161880,296,-4,2017-01-23
Alpine Development Bank Limited,12,297,283,288,579,166121,292,-4,2017-01-24
Alpine Development Bank Limited,3,293,285,285,80,23210,288,-3,2017-01-25
Alpine Development Bank Limited,5,288,283,283,671,192464,285,-2,2017-01-26
Alpine Development Bank Limited,2,278,278,278,58,16124,283,-5,2017-01-31
Alpine Development Bank Limited,9,292,277,292,1217,341962,278,14,2017-02-01
Alpine Development Bank Limited,2,294,290,290,118,34292,292,-2,2017-02-02
Alpine Development Bank Limited,5,285,275,275,650,180750,290,-15,2017-02-06
Alpine Development Bank Limited,13,270,256,265,782,205092,275,-10,2017-02-07
Alpine Development Bank Limited,16,265,257,258,1428,373010,265,-7,2017-02-08
Alpine Development Bank Limited,4,263,258,258,463,119976,258,0,2017-02-09
Alpine Development Bank Limited,33,253,233,233,3765,903691,258,-25,2017-02-12
Alpine Development Bank Limited,14,240,216,238,933,213752,233,5,2017-02-13
Alpine Development Bank Limited,6,239,230,230,1060,251720,238,-8,2017-02-14
Alpine Development Bank Limited,12,246,234,246,1565,371230,230,16,2017-02-15
Alpine Development Bank Limited,12,260,250,254,1740,442300,246,8,2017-02-16
Alpine Development Bank Limited,17,270,252,270,1919,505505,254,16,2017-02-19
Alpine Development Bank Limited,20,278,260,260,3693,998785,270,-10,2017-02-20
Alpine Development Bank Limited,15,265,260,260,1560,407157,260,0,2017-02-21
Alpine Development Bank Limited,16,270,250,261,1289,335486,260,1,2017-02-22
Alpine Development Bank Limited,13,266,258,265,1766,461324,261,4,2017-02-23
Alpine Development Bank Limited,3,265,260,265,143,37658,265,0,2017-02-26
Alpine Development Bank Limited,2,260,260,260,150,39000,265,-5,2017-02-28
Alpine Development Bank Limited,3,255,250,255,162,41150,260,-5,2017-03-01
Alpine Development Bank Limited,5,261,255,261,148,38472,255,6,2017-03-02
Alpine Development Bank Limited,10,272,265,265,1198,319710,261,4,2017-03-05
Alpine Development Bank Limited,9,269,254,259,985,256965,265,-6,2017-03-06
Alpine Development Bank Limited,8,254,247,247,398,99442,259,-12,2017-03-07
Alpine Development Bank Limited,2,249,245,249,66,16346,247,2,2017-03-13
Alpine Development Bank Limited,1,249,249,249,44,10956,249,0,2017-03-14
Alpine Development Bank Limited,11,258,250,258,2645,672380,249,9,2017-03-16
Api Power Company Ltd.,111,672,656,656,8495,5660565,670,-14,2016-05-23
Api Power Company Ltd.,141,670,651,660,6774,4478102,656,4,2016-05-24
Api Power Company Ltd.,58,665,650,661,3517,2324946,660,1,2016-05-25
Api Power Company Ltd.,56,674,651,665,11000,7284644,661,4,2016-05-26
Api Power Company Ltd.,82,691,666,670,5305,3583117,665,5,2016-05-29
Api Power Company Ltd.,197,701,680,692,17849,12341370,670,22,2016-05-30
Api Power Company Ltd.,263,761,682,760,28803,20862088,692,68,2016-05-31
Api Power Company Ltd.,186,775,711,728,16725,12204965,760,-32,2016-06-01
Api Power Company Ltd.,125,734,688,710,10077,7160308,728,-18,2016-06-02
Api Power Company Ltd.,185,724,700,714,16759,11950278,710,4,2016-06-05
Api Power Company Ltd.,136,728,701,728,12197,8774171,714,14,2016-06-06
Api Power Company Ltd.,145,730,715,717,6421,4634296,728,-11,2016-06-07
Api Power Company Ltd.,273,872,836,872,11352,9641128,839,33,2016-06-23
Api Power Company Ltd.,128,737,714,737,11014,8015795,717,20,2016-06-08
Api Power Company Ltd.,199,774,735,772,28187,21216570,737,35,2016-06-09
Api Power Company Ltd.,228,785,743,780,22418,17303552,772,8,2016-06-12
Api Power Company Ltd.,144,784,753,779,13621,10540437,780,-1,2016-06-13
Api Power Company Ltd.,113,786,750,771,5916,4563929,779,-8,2016-06-14
Api Power Company Ltd.,90,776,760,770,7644,5889247,771,-1,2016-06-15
Api Power Company Ltd.,68,785,760,770,8485,6529585,770,0,2016-06-16
Api Power Company Ltd.,189,800,755,800,14769,11541179,770,30,2016-06-19
Api Power Company Ltd.,262,839,790,816,14485,11815582,800,16,2016-06-20
Api Power Company Ltd.,178,848,800,846,14330,11834101,816,30,2016-06-21
Api Power Company Ltd.,243,860,825,839,13248,11206028,846,-7,2016-06-22
Api Power Company Ltd.,176,888,845,860,12504,10769731,872,-12,2016-06-26
Api Power Company Ltd.,121,870,835,852,8144,6990311,860,-8,2016-06-27
Api Power Company Ltd.,168,864,830,848,11151,9455614,852,-4,2016-06-28
Api Power Company Ltd.,108,860,820,855,11753,9998966,848,7,2016-06-29
Api Power Company Ltd.,83,850,835,835,6826,5732405,855,-20,2016-06-30
Api Power Company Ltd.,92,869,825,859,12367,10471911,835,24,2016-07-03
Api Power Company Ltd.,124,877,841,854,13013,11183736,859,-5,2016-07-04
Api Power Company Ltd.,126,877,840,860,9562,8220400,854,6,2016-07-05
Api Power Company Ltd.,127,874,845,865,6903,5937236,860,5,2016-07-06
Api Power Company Ltd.,79,870,851,864,4495,3858920,865,-1,2016-07-10
Api Power Company Ltd.,68,860,833,840,8883,7531672,864,-24,2016-07-11
Api Power Company Ltd.,53,850,780,820,5346,4407401,840,-20,2016-07-12
Api Power Company Ltd.,106,840,800,830,9399,7680789,820,10,2016-07-13
Api Power Company Ltd.,76,860,811,843,4858,4016665,830,13,2016-07-14
Api Power Company Ltd.,120,876,800,825,16672,14108437,843,-18,2016-07-17
Api Power Company Ltd.,66,855,809,830,5299,4439086,825,5,2016-07-18
Api Power Company Ltd.,67,846,819,830,4592,3841076,830,0,2016-07-19
Api Power Company Ltd.,80,846,820,830,3120,2605577,830,0,2016-07-20
Api Power Company Ltd.,73,835,825,835,4889,4042398,830,5,2016-07-21
Api Power Company Ltd.,87,835,820,830,6596,5442884,835,-5,2016-07-25
Api Power Company Ltd.,93,855,826,828,7113,5970897,830,-2,2016-07-26
Api Power Company Ltd.,161,880,830,880,31763,26737285,828,52,2016-07-27
Api Power Company Ltd.,136,880,824,855,22750,19313320,880,-25,2016-07-28
Api Power Company Ltd.,117,870,823,837,7301,6099902,855,-18,2016-07-31
Api Power Company Ltd.,194,870,825,855,16558,14012994,837,18,2016-08-01
Api Power Company Ltd.,86,850,830,835,8463,7090543,855,-20,2016-08-02
Api Power Company Ltd.,60,840,820,834,6191,5121237,835,-1,2016-08-03
Api Power Company Ltd.,69,834,804,804,8432,6927183,834,-30,2016-08-04
Api Power Company Ltd.,91,851,800,812,7767,6342103,804,8,2016-08-07
Api Power Company Ltd.,59,844,740,742,3971,3114381,812,-70,2016-08-08
Api Power Company Ltd.,4,801,756,801,130,103230,742,59,2016-08-09
Api Power Company Ltd.,176,830,785,801,18833,15229117,801,0,2016-08-10
Api Power Company Ltd.,147,800,778,786,10871,8523570,801,-15,2016-08-11
Api Power Company Ltd.,351,780,721,733,27302,20168242,786,-53,2016-08-14
Api Power Company Ltd.,183,728,665,695,8049,5549436,733,-38,2016-08-15
Api Power Company Ltd.,177,686,630,630,17589,11089871,700,-70,2016-08-31
Api Power Company Ltd.,158,715,650,705,11494,7907337,695,10,2016-08-16
Api Power Company Ltd.,61,697,658,670,7694,5146990,671,-1,2016-08-17
Api Power Company Ltd.,45,660,641,655,4070,2642322,670,-15,2016-08-21
Api Power Company Ltd.,87,645,600,600,10240,6327919,655,-55,2016-08-22
Api Power Company Ltd.,148,623,559,623,24628,14423891,600,23,2016-08-23
Api Power Company Ltd.,39,635,600,635,4162,2583086,623,12,2016-08-24
Api Power Company Ltd.,41,685,632,650,4631,3021853,635,15,2016-08-28
Api Power Company Ltd.,93,697,645,697,14228,9474979,650,47,2016-08-29
Api Power Company Ltd.,76,738,690,700,5425,3835003,697,3,2016-08-30
Api Power Company Ltd.,145,635,597,605,13606,8243724,630,-25,2016-09-01
Api Power Company Ltd.,87,647,617,630,4512,2833823,605,25,2016-09-04
Api Power Company Ltd.,54,664,632,644,6822,4406130,630,14,2016-09-05
Api Power Company Ltd.,51,659,607,639,5337,3449792,644,-5,2016-09-06
Api Power Company Ltd.,41,649,615,640,2757,1764132,639,1,2016-09-07
Api Power Company Ltd.,44,645,628,632,2460,1563065,640,-8,2016-09-08
Api Power Company Ltd.,48,644,620,620,6323,3996339,632,-12,2016-09-11
Api Power Company Ltd.,42,653,621,623,2679,1675669,620,3,2016-09-12
Api Power Company Ltd.,63,640,615,620,6720,4219676,623,-3,2016-09-14
Api Power Company Ltd.,56,656,615,640,3592,2252994,620,20,2016-09-18
Api Power Company Ltd.,37,630,617,630,3596,2241234,640,-10,2016-09-20
Api Power Company Ltd.,21,630,618,620,1278,797426,630,-10,2016-09-21
Api Power Company Ltd.,59,625,608,620,2055,1268712,620,0,2016-09-22
Api Power Company Ltd.,64,622,591,600,3455,2075167,620,-20,2016-09-25
Api Power Company Ltd.,63,615,598,600,2317,1400426,600,0,2016-09-26
Api Power Company Ltd.,40,620,600,601,2745,1655780,600,1,2016-09-27
Api Power Company Ltd.,47,606,591,597,3256,1952616,601,-4,2016-09-28
Api Power Company Ltd.,43,608,590,602,7053,4226946,597,5,2016-09-29
Api Power Company Ltd.,29,612,585,600,2409,1421257,602,-2,2016-10-02
Api Power Company Ltd.,33,612,577,599,1486,885048,600,-1,2016-10-03
Api Power Company Ltd.,20,610,590,595,3446,2042970,599,-4,2016-10-04
Api Power Company Ltd.,24,605,587,587,4379,2611025,595,-8,2016-10-05
Api Power Company Ltd.,41,612,585,600,2928,1767924,587,13,2016-10-06
Api Power Company Ltd.,15,625,600,613,275,167838,600,13,2016-10-16
Api Power Company Ltd.,22,630,603,630,1028,631278,613,17,2016-10-17
Api Power Company Ltd.,28,630,598,615,2200,1327056,630,-15,2016-10-18
Api Power Company Ltd.,11,610,591,600,213,127847,615,-15,2016-10-19
Api Power Company Ltd.,25,617,595,612,875,532996,600,12,2016-10-20
Api Power Company Ltd.,18,612,590,599,2642,1582130,612,-13,2016-10-23
Api Power Company Ltd.,21,602,589,590,1702,1005886,599,-9,2016-10-24
Api Power Company Ltd.,25,600,582,586,1991,1167558,590,-4,2016-10-25
Api Power Company Ltd.,41,597,578,590,4023,2347971,586,4,2016-10-26
Api Power Company Ltd.,31,590,579,585,2132,1240759,590,-5,2016-10-27
Api Power Company Ltd.,36,617,581,617,1892,1137285,585,32,2016-11-03
Api Power Company Ltd.,29,629,595,597,1500,915269,617,-20,2016-11-07
Api Power Company Ltd.,19,625,585,600,1048,625608,597,3,2016-11-08
Api Power Company Ltd.,34,600,580,580,4109,2398298,600,-20,2016-11-09
Api Power Company Ltd.,50,594,574,577,6077,3514523,580,-3,2016-11-10
Api Power Company Ltd.,34,580,570,575,1503,864963,577,-2,2016-11-13
Api Power Company Ltd.,21,597,565,578,341,197570,575,3,2016-11-14
Api Power Company Ltd.,21,590,563,569,573,330221,578,-9,2016-11-15
Api Power Company Ltd.,46,569,545,569,2636,1468742,569,0,2016-11-16
Api Power Company Ltd.,34,580,549,549,2134,1199412,569,-20,2016-11-17
Api Power Company Ltd.,36,570,514,540,2830,1529732,549,-9,2016-11-20
Api Power Company Ltd.,7,561,540,541,296,160560,540,1,2016-11-21
Api Power Company Ltd.,55,550,511,525,2242,1174030,541,-16,2016-11-22
Api Power Company Ltd.,49,529,496,504,5650,2867574,525,-21,2016-11-23
Api Power Company Ltd.,61,525,477,495,2454,1203070,504,-9,2016-11-24
Api Power Company Ltd.,24,495,446,446,1824,853398,495,-49,2016-11-27
Api Power Company Ltd.,61,454,413,449,3591,1522814,446,3,2016-11-28
Api Power Company Ltd.,106,493,435,490,6740,3089662,449,41,2016-11-29
Api Power Company Ltd.,51,530,480,529,7470,3699678,490,39,2016-11-30
Api Power Company Ltd.,32,540,501,506,3024,1579548,529,-23,2016-12-01
Api Power Company Ltd.,33,520,496,520,3100,1551382,506,14,2016-12-04
Api Power Company Ltd.,39,511,478,509,1140,563046,520,-11,2016-12-05
Api Power Company Ltd.,26,510,492,509,1515,755473,509,0,2016-12-06
Api Power Company Ltd.,14,518,500,508,280,141334,509,-1,2016-12-07
Api Power Company Ltd.,175,517,469,479,14797,7029690,508,-29,2016-12-08
Api Power Company Ltd.,125,480,432,432,11281,4961069,479,-47,2016-12-11
Api Power Company Ltd.,58,425,394,417,5002,2081215,432,-15,2016-12-12
Api Power Company Ltd.,26,428,404,428,1646,679715,417,11,2016-12-14
Api Power Company Ltd.,27,424,405,413,3027,1254323,428,-15,2016-12-15
Api Power Company Ltd.,36,415,401,405,2264,922152,413,-8,2016-12-18
Api Power Company Ltd.,44,413,397,405,1967,792291,405,0,2016-12-19
Api Power Company Ltd.,24,402,386,396,1951,777219,405,-9,2016-12-20
Api Power Company Ltd.,29,408,389,395,849,339254,396,-1,2016-12-21
Api Power Company Ltd.,29,405,390,394,1292,510025,395,-1,2016-12-22
Api Power Company Ltd.,25,401,395,395,3479,1379825,394,1,2016-12-26
Api Power Company Ltd.,22,402,379,386,2409,939734,395,-9,2016-12-27
Api Power Company Ltd.,50,408,381,388,2516,978174,386,2,2016-12-28
Api Power Company Ltd.,15,408,382,404,798,317930,388,16,2016-12-29
Api Power Company Ltd.,22,412,390,390,1833,730175,404,-14,2017-01-01
Api Power Company Ltd.,38,410,394,405,4520,1822186,390,15,2017-01-02
Api Power Company Ltd.,30,407,396,407,1623,653991,405,2,2017-01-03
Api Power Company Ltd.,27,410,395,400,2324,930296,407,-7,2017-01-04
Api Power Company Ltd.,48,400,392,395,1738,686030,400,-5,2017-01-05
Api Power Company Ltd.,25,402,395,400,1045,416196,395,5,2017-01-08
Api Power Company Ltd.,11,409,401,405,1831,743868,400,5,2017-01-09
Api Power Company Ltd.,10,409,403,405,470,190456,405,0,2017-01-10
Api Power Company Ltd.,15,413,401,401,761,308797,405,-4,2017-01-11
Api Power Company Ltd.,15,409,400,405,972,390452,401,4,2017-01-12
Api Power Company Ltd.,9,403,395,395,923,369699,405,-10,2017-01-15
Api Power Company Ltd.,15,405,393,400,703,280624,395,5,2017-01-16
Api Power Company Ltd.,17,400,390,390,1486,581486,400,-10,2017-01-17
Api Power Company Ltd.,10,397,384,395,450,176796,390,5,2017-01-18
Api Power Company Ltd.,12,400,392,395,266,105334,395,0,2017-01-19
Api Power Company Ltd.,34,395,373,377,1525,593888,395,-18,2017-01-22
Api Power Company Ltd.,17,397,380,390,422,163720,377,13,2017-01-23
Api Power Company Ltd.,28,392,378,378,3038,1160519,390,-12,2017-01-24
Api Power Company Ltd.,19,380,369,370,1239,460827,378,-8,2017-01-25
Api Power Company Ltd.,33,377,356,375,1509,551449,370,5,2017-01-26
Api Power Company Ltd.,38,375,338,338,3742,1313925,375,-37,2017-01-30
Api Power Company Ltd.,45,357,325,331,1546,521240,338,-7,2017-01-31
Api Power Company Ltd.,27,358,333,358,1874,631329,331,27,2017-02-01
Api Power Company Ltd.,25,367,350,353,2971,1064073,358,-5,2017-02-02
Api Power Company Ltd.,16,360,346,360,1621,575320,353,7,2017-02-05
Api Power Company Ltd.,29,358,346,358,1179,414460,360,-2,2017-02-06
Api Power Company Ltd.,18,362,355,356,536,191674,358,-2,2017-02-07
Api Power Company Ltd.,34,350,338,340,756,259375,356,-16,2017-02-08
Api Power Company Ltd.,142,335,315,315,6685,2166795,340,-25,2017-02-09
Api Power Company Ltd.,69,310,298,301,5452,1655857,315,-14,2017-02-12
Api Power Company Ltd.,35,312,300,311,2979,905325,301,10,2017-02-13
Api Power Company Ltd.,41,322,304,316,1304,409623,311,5,2017-02-14
Api Power Company Ltd.,36,341,312,340,3322,1111303,316,24,2017-02-15
Api Power Company Ltd.,54,370,335,363,4950,1767223,340,23,2017-02-16
Api Power Company Ltd.,27,363,349,355,1854,659957,363,-8,2017-02-19
Api Power Company Ltd.,21,362,352,353,866,309285,355,-2,2017-02-20
Api Power Company Ltd.,10,367,360,360,680,245252,353,7,2017-02-21
Api Power Company Ltd.,10,355,345,351,290,101756,360,-9,2017-02-22
Api Power Company Ltd.,19,350,345,350,612,213178,351,-1,2017-02-23
Api Power Company Ltd.,24,357,345,350,1255,441167,350,0,2017-02-26
Api Power Company Ltd.,27,346,328,336,5625,1865005,350,-14,2017-02-28
Api Power Company Ltd.,29,351,334,350,4175,1410415,336,14,2017-03-01
Api Power Company Ltd.,16,350,338,338,943,324422,350,-12,2017-03-02
Api Power Company Ltd.,14,348,335,344,2081,703090,338,6,2017-03-05
Api Power Company Ltd.,54,438,417,428,4514,1928866,433,-5,2017-03-21
Api Power Company Ltd.,27,350,342,348,1228,427661,344,4,2017-03-06
Api Power Company Ltd.,67,375,345,373,7869,2857021,348,25,2017-03-07
Api Power Company Ltd.,57,405,380,405,8747,3457732,373,32,2017-03-09
Api Power Company Ltd.,43,439,410,435,4251,1841214,405,30,2017-03-13
Api Power Company Ltd.,45,455,412,412,4129,1786663,435,-23,2017-03-14
Api Power Company Ltd.,19,436,407,436,2203,913438,412,24,2017-03-15
Api Power Company Ltd.,18,428,417,417,694,293076,436,-19,2017-03-16
Api Power Company Ltd.,32,442,425,428,2954,1274438,417,11,2017-03-19
Api Power Company Ltd.,31,436,412,433,5259,2236375,428,5,2017-03-20
Api Power Company Ltd.,49,461,428,436,6225,2775199,428,8,2017-03-22
Api Power Company Ltd.,101,479,436,479,9365,4449602,436,43,2017-03-23
Api Power Company Ltd.,141,526,488,526,18707,9834966,479,47,2017-03-26
Api Power Company Ltd.,87,578,536,578,10318,5909798,526,52,2017-03-28
Api Power Company Ltd.,146,612,541,555,9988,5944894,578,-23,2017-03-29
Api Power Company Ltd.,112,571,540,553,8798,4831829,555,-2,2017-03-30
Api Power Company Ltd.,33,580,555,580,2982,1718933,553,27,2017-04-02
Api Power Company Ltd.,82,592,549,570,5071,2887398,580,-10,2017-04-03
Api Power Company Ltd.,84,560,550,555,3974,2199476,570,-15,2017-04-04
Api Power Company Ltd.,84,567,530,547,5454,2997886,555,-8,2017-04-06
Api Power Company Ltd.,83,560,530,560,3142,1736767,547,13,2017-04-09
Api Power Company Ltd.,74,581,550,560,4720,2657688,560,0,2017-04-10
Api Power Company Ltd.,238,616,571,616,24863,15077356,560,56,2017-04-11
Api Power Company Ltd.,189,654,613,635,14234,9193110,616,19,2017-04-12
Api Power Company Ltd.,110,645,606,615,7534,4692745,635,-20,2017-04-13
Api Power Company Ltd.,87,636,584,584,5971,3636842,615,-31,2017-04-16
Api Power Company Ltd.,89,584,557,567,7770,4427688,584,-17,2017-04-18
Api Power Company Ltd.,38,580,563,568,3520,2003587,567,1,2017-04-19
Api Power Company Ltd.,70,579,566,568,3409,1941677,568,0,2017-04-20
Api Power Company Ltd.,47,590,570,570,5069,2952437,568,2,2017-04-23
Api Power Company Ltd.,63,582,560,570,6394,3635103,570,0,2017-04-24
Api Power Company Ltd.,21,570,560,563,1107,625445,570,-7,2017-04-25
Api Power Company Ltd.,49,570,552,561,2127,1192477,563,-2,2017-04-26
Api Power Company Ltd.,58,570,547,560,2372,1326585,561,-1,2017-04-27
Api Power Company Ltd.,63,572,550,557,2302,1285982,560,-3,2017-04-30
Api Power Company Ltd.,45,569,557,560,2630,1483628,557,3,2017-05-02
Api Power Company Ltd.,33,572,555,572,704,395743,560,12,2017-05-03
Api Power Company Ltd.,69,583,557,557,1791,1012631,572,-15,2017-05-04
Api Power Company Ltd.,65,561,540,544,3891,2119733,557,-13,2017-05-07
Api Power Company Ltd.,40,554,532,545,1727,936274,544,1,2017-05-08
Api Power Company Ltd.,49,593,546,593,2282,1276457,545,48,2017-05-09
Api Power Company Ltd.,94,610,574,600,6481,3849028,593,7,2017-05-11
Api Power Company Ltd.,51,612,592,598,5806,3475374,600,-2,2017-05-15
Api Power Company Ltd.,36,595,580,588,1445,852005,598,-10,2017-05-16
Api Power Company Ltd.,21,598,580,587,1315,769157,588,-1,2017-05-17
Api Power Company Ltd.,56,585,575,584,4203,2436615,587,-3,2017-05-18
Api Power Company Ltd.,39,585,575,585,2924,1698225,584,1,2017-05-21
Api Power Company Ltd.,63,585,564,580,3642,2107500,585,-5,2017-05-22
Api Power Company Ltd.,76,586,563,575,2474,1420671,580,-5,2017-05-23
Api Power Company Ltd.,24,586,551,586,1484,846189,575,11,2017-05-24
Api Power Company Ltd.,62,580,554,579,3416,1973300,586,-7,2017-05-28
Api Power Company Ltd.,81,580,554,557,3971,2236004,579,-22,2017-05-30
Api Power Company Ltd.,24,582,554,570,839,470124,557,13,2017-05-31
Api Power Company Ltd.,43,572,560,572,1347,761221,570,2,2017-06-01
Api Power Company Ltd.,68,575,551,565,2835,1593941,572,-7,2017-06-04
Api Power Company Ltd.,41,574,554,568,1108,623690,565,3,2017-06-05
Api Power Company Ltd.,45,578,565,573,1618,923600,568,5,2017-06-06
Api Power Company Ltd.,47,573,562,567,1473,837052,573,-6,2017-06-07
Api Power Company Ltd.,32,571,560,565,1021,577103,567,-2,2017-06-08
Api Power Company Ltd.,83,575,560,570,4076,2304253,565,5,2017-06-11
Api Power Company Ltd.,61,562,550,556,3046,1701452,570,-14,2017-06-12
Api Power Company Ltd.,64,560,550,560,2058,1146411,556,4,2017-06-13
Api Power Company Ltd.,16,570,550,564,265,147752,560,4,2017-06-14
Api Power Company Ltd.,99,575,553,565,3120,1752553,564,1,2017-06-15
Api Power Company Ltd.,38,557,552,554,2195,1217963,565,-11,2017-06-18
Api Power Company Ltd.,25,556,539,556,780,427879,554,2,2017-06-19
Api Power Company Ltd.,31,571,546,558,1680,926563,556,2,2017-06-20
Api Power Company Ltd.,42,559,549,553,1833,1015074,558,-5,2017-06-21
Api Power Company Ltd.,60,561,550,555,3492,1938589,553,2,2017-06-22
Api Power Company Ltd.,40,556,540,554,973,534044,555,-1,2017-06-25
Api Power Company Ltd.,51,558,545,552,1429,787790,554,-2,2017-06-27
Api Power Company Ltd.,62,560,538,547,2745,1496835,552,-5,2017-06-28
Api Power Company Ltd.,39,550,535,549,1793,974006,547,2,2017-07-02
Api Power Company Ltd.,27,562,548,550,1514,836873,549,1,2017-07-03
Api Power Company Ltd.,38,559,539,547,849,465785,550,-3,2017-07-04
Api Power Company Ltd.,28,555,540,550,601,326701,547,3,2017-07-05
Api Power Company Ltd.,26,560,547,555,965,532369,550,5,2017-07-06
Api Power Company Ltd.,68,566,544,555,1800,997419,555,0,2017-07-09
Api Power Company Ltd.,37,560,550,560,1483,824366,555,5,2017-07-10
Api Power Company Ltd.,43,575,554,568,3046,1715952,560,8,2017-07-11
Api Power Company Ltd.,38,570,555,557,1363,765062,568,-11,2017-07-12
Api Power Company Ltd.,26,556,545,545,2220,1221158,557,-12,2017-07-13
Api Power Company Ltd.,60,560,545,552,2621,1447363,545,7,2017-07-16
Api Power Company Ltd.,38,554,541,554,938,514452,552,2,2017-07-17
Api Power Company Ltd.,39,562,551,562,1224,683844,554,8,2017-07-18
Api Power Company Ltd.,151,670,655,655,11636,7669584,669,-14,2017-08-03
Api Power Company Ltd.,193,618,562,618,27032,16555921,562,56,2017-07-19
Api Power Company Ltd.,196,636,589,613,17497,10743954,618,-5,2017-07-20
Api Power Company Ltd.,105,620,605,607,6349,3879469,613,-6,2017-07-23
Api Power Company Ltd.,92,605,593,597,5578,3337175,607,-10,2017-07-24
Api Power Company Ltd.,95,612,600,612,10425,6285311,597,15,2017-07-25
Api Power Company Ltd.,143,629,608,628,13378,8313409,612,16,2017-07-26
Api Power Company Ltd.,93,630,620,620,5539,3468449,628,-8,2017-07-27
Api Power Company Ltd.,83,620,596,606,8378,5081730,620,-14,2017-07-30
Api Power Company Ltd.,93,630,600,629,8278,5104327,606,23,2017-07-31
Api Power Company Ltd.,227,670,617,658,29521,19136249,629,29,2017-08-01
Api Power Company Ltd.,227,683,650,669,25467,17054497,658,11,2017-08-02
Api Power Company Ltd.,120,668,650,652,5719,3738267,655,-3,2017-08-06
Api Power Company Ltd.,107,652,635,640,3707,2378614,652,-12,2017-08-07
Api Power Company Ltd.,120,652,640,643,5551,3594283,640,3,2017-08-09
Api Power Company Ltd.,81,645,629,644,4716,3013649,643,1,2017-08-10
Api Power Company Ltd.,126,653,638,648,9311,6036750,644,4,2017-08-13
Api Power Company Ltd.,103,664,626,664,8583,5595047,648,16,2017-08-15
Api Power Company Ltd.,100,669,641,660,6790,4402460,664,-4,2017-08-16
Api Power Company Ltd.,77,673,635,644,3683,2358800,660,-16,2017-08-17
Api Power Company Ltd.,96,644,634,635,4893,3114085,644,-9,2017-08-20
Api Power Company Ltd.,82,634,617,634,2156,1343038,635,-1,2017-08-21
Api Power Company Ltd.,82,645,617,630,3442,2150442,634,-4,2017-08-22
Api Power Company Ltd.,110,633,613,624,4533,2800871,630,-6,2017-08-23
Api Power Company Ltd.,48,636,613,631,2287,1414739,624,7,2017-08-24
Api Power Company Ltd.,73,634,620,633,2603,1627858,631,2,2017-08-27
Api Power Company Ltd.,83,642,617,627,5730,3611542,633,-6,2017-08-28
Api Power Company Ltd.,61,627,615,620,4150,2564780,627,-7,2017-08-30
Api Power Company Ltd.,87,620,605,610,6652,4056660,620,-10,2017-08-31
Api Power Company Ltd.,93,618,594,601,4327,2620813,610,-9,2017-09-04
Api Power Company Ltd.,63,615,588,615,2540,1522430,601,14,2017-09-06
Api Power Company Ltd.,69,614,584,584,4880,2896302,615,-31,2017-09-07
Api Power Company Ltd.,64,600,564,565,3378,1930740,584,-19,2017-09-10
Api Power Company Ltd.,42,597,550,570,1553,870787,565,5,2017-09-11
Api Power Company Ltd.,79,581,560,560,6364,3608975,570,-10,2017-09-12
Api Power Company Ltd.,80,579,557,567,8663,4947087,560,7,2017-09-13
Api Power Company Ltd.,151,593,557,589,8750,5107571,567,22,2017-09-14
Api Power Company Ltd.,50,595,582,584,1939,1135742,589,-5,2017-09-17
Api Power Company Ltd.,51,598,566,585,1480,857518,584,1,2017-09-18
Api Power Company Ltd.,56,596,564,570,3725,2129589,585,-15,2017-09-20
Api Power Company Ltd.,19,563,541,560,1214,672848,560,0,2017-10-09
Api Power Company Ltd.,39,583,561,580,4589,2628425,570,10,2017-09-24
Api Power Company Ltd.,28,581,570,574,2257,1293714,580,-6,2017-09-25
Api Power Company Ltd.,19,579,567,570,1039,594216,574,-4,2017-09-26
Api Power Company Ltd.,17,581,565,581,384,218953,570,11,2017-10-03
Api Power Company Ltd.,7,576,570,570,284,163335,581,-11,2017-10-04
Api Power Company Ltd.,27,565,541,560,1417,781748,570,-10,2017-10-08
Api Power Company Ltd.,17,565,550,551,904,503470,560,-9,2017-10-10
Api Power Company Ltd.,36,560,539,539,2844,1563150,551,-12,2017-10-11
Api Power Company Ltd.,25,557,545,548,2456,1346363,539,9,2017-10-12
Api Power Company Ltd.,22,550,542,546,466,254634,548,-2,2017-10-15
Api Power Company Ltd.,25,562,545,562,915,506518,546,16,2017-10-16
Api Power Company Ltd.,38,573,547,550,6798,3746213,562,-12,2017-10-17
Api Power Company Ltd.,18,561,540,555,1937,1067765,550,5,2017-10-18
Api Power Company Ltd.,19,571,560,561,453,254911,555,6,2017-10-22
Api Power Company Ltd.,35,570,547,557,3740,2065600,561,-4,2017-10-23
Api Power Company Ltd.,19,554,548,550,1482,815237,557,-7,2017-10-24
Api Power Company Ltd.,30,554,541,541,2318,1263112,550,-9,2017-10-25
Api Power Company Ltd.,64,555,537,540,1792,970269,541,-1,2017-10-29
Api Power Company Ltd.,22,550,535,540,1153,626502,540,0,2017-10-30
Api Power Company Ltd.,40,540,527,530,3613,1920805,540,-10,2017-10-31
Api Power Company Ltd.,54,528,515,519,3483,1817811,530,-11,2017-11-01
Api Power Company Ltd.,34,528,510,518,2360,1228575,519,-1,2017-11-02
Api Power Company Ltd.,56,515,493,515,4955,2495125,518,-3,2017-11-05
Api Power Company Ltd.,51,530,495,515,3519,1779816,515,0,2017-11-06
Api Power Company Ltd.,55,512,495,495,3987,1995748,515,-20,2017-11-07
Api Power Company Ltd.,21,499,484,490,1930,948876,495,-5,2017-11-08
Api Power Company Ltd.,34,499,473,482,2213,1071449,490,-8,2017-11-09
Api Power Company Ltd.,48,500,482,500,586,288213,482,18,2017-11-12
Api Power Company Ltd.,36,495,482,495,3205,1570510,500,-5,2017-11-13
Api Power Company Ltd.,57,513,491,513,8815,4395297,495,18,2017-11-14
Api Power Company Ltd.,50,517,495,495,5174,2603438,513,-18,2017-11-15
Api Power Company Ltd.,32,500,490,499,1769,877413,495,4,2017-11-16
Api Power Company Ltd.,22,491,482,487,403,196095,499,-12,2017-11-19
Api Power Company Ltd.,31,490,481,481,2341,1131799,487,-6,2017-11-20
Api Power Company Ltd.,25,490,485,485,1050,513442,481,4,2017-11-21
Api Power Company Ltd.,43,512,480,500,3431,1730064,485,15,2017-11-22
Api Power Company Ltd.,85,513,503,512,4097,2080948,500,12,2017-11-23
Api Power Company Ltd.,43,513,495,507,3453,1742779,512,-5,2017-11-26
Api Power Company Ltd.,72,517,497,500,5366,2706019,507,-7,2017-11-27
Api Power Company Ltd.,28,515,500,514,2041,1039965,500,14,2017-11-28
Api Power Company Ltd.,54,520,507,510,3727,1914097,514,-4,2017-11-29
Api Power Company Ltd.,165,510,472,490,15420,7504203,510,-20,2017-11-30
Api Power Company Ltd.,81,490,481,485,5927,2882494,490,-5,2017-12-04
Api Power Company Ltd.,40,472,446,464,2275,1034063,465,-1,2017-12-20
Api Power Company Ltd.,34,493,478,486,1725,838619,485,1,2017-12-05
Api Power Company Ltd.,46,494,480,493,6570,3210209,486,7,2017-12-06
Api Power Company Ltd.,18,493,482,485,1676,811753,493,-8,2017-12-10
Api Power Company Ltd.,20,485,476,485,1507,724509,485,0,2017-12-11
Api Power Company Ltd.,33,485,476,476,2091,1001752,485,-9,2017-12-12
Api Power Company Ltd.,45,489,467,489,2027,960313,476,13,2017-12-13
Api Power Company Ltd.,7,490,466,480,174,84040,489,-9,2017-12-14
Api Power Company Ltd.,34,478,465,478,2615,1227543,480,-2,2017-12-17
Api Power Company Ltd.,48,478,466,470,5565,2607603,478,-8,2017-12-18
Api Power Company Ltd.,41,469,458,465,2784,1283809,470,-5,2017-12-19
Api Power Company Ltd.,29,463,453,456,1947,888501,464,-8,2017-12-21
Api Power Company Ltd.,81,478,455,455,4887,2276547,456,-1,2017-12-24
Api Power Company Ltd.,78,464,450,455,3590,1636565,455,0,2017-12-26
Api Power Company Ltd.,61,457,440,457,2382,1068453,455,2,2017-12-27
Api Power Company Ltd.,33,463,450,455,2188,997525,457,-2,2017-12-28
Api Power Company Ltd.,63,456,437,450,5055,2238929,455,-5,2017-12-31
Api Power Company Ltd.,27,459,443,459,1856,837425,450,9,2018-01-01
Api Power Company Ltd.,36,460,443,452,2834,1279180,459,-7,2018-01-02
Api Power Company Ltd.,48,455,446,446,3258,1463811,452,-6,2018-01-03
Api Power Company Ltd.,113,470,445,470,7975,3617890,446,24,2018-01-04
Api Power Company Ltd.,54,430,426,430,2689,1150040,435,-5,2018-01-07
Api Power Company Ltd.,16,429,418,428,1656,703344,430,-2,2018-01-08
Api Power Company Ltd.,22,432,413,425,1408,597126,428,-3,2018-01-09
Api Power Company Ltd.,7,423,419,423,525,220362,425,-2,2018-01-10
Api Power Company Ltd.,22,428,420,425,1286,546864,423,2,2018-01-14
Api Power Company Ltd.,4,420,418,420,318,133320,425,-5,2018-01-16
Api Power Company Ltd.,15,420,405,405,893,365016,420,-15,2018-01-17
Api Power Company Ltd.,24,410,394,395,875,349589,405,-10,2018-01-21
Api Power Company Ltd.,18,405,384,397,919,358828,395,2,2018-01-22
Api Power Company Ltd.,15,390,381,384,576,221225,397,-13,2018-01-23
Api Power Company Ltd.,15,391,385,391,987,383113,384,7,2018-01-24
Api Power Company Ltd.,27,392,381,387,997,387360,391,-4,2018-01-25
Api Power Company Ltd.,31,386,380,382,662,253166,387,-5,2018-01-28
Api Power Company Ltd.,33,392,377,392,1155,442734,382,10,2018-01-29
Api Power Company Ltd.,25,391,383,391,720,278154,392,-1,2018-01-31
Api Power Company Ltd.,20,393,387,392,837,326912,391,1,2018-02-01
Api Power Company Ltd.,12,390,383,383,364,140260,392,-9,2018-02-04
Api Power Company Ltd.,23,392,380,382,609,232315,383,-1,2018-02-05
Api Power Company Ltd.,21,382,374,381,1347,512891,382,-1,2018-02-06
Api Power Company Ltd.,10,381,374,381,267,100658,381,0,2018-02-07
Api Power Company Ltd.,16,386,374,380,407,153937,381,-1,2018-02-08
Api Power Company Ltd.,18,374,367,373,566,210153,380,-7,2018-02-25
Api Power Company Ltd.,9,384,373,375,844,316729,380,-5,2018-02-11
Api Power Company Ltd.,7,375,365,375,110,40447,375,0,2018-02-12
Api Power Company Ltd.,28,378,367,378,1581,592168,375,3,2018-02-14
Api Power Company Ltd.,26,400,378,400,3540,1375466,378,22,2018-02-15
Api Power Company Ltd.,19,408,386,387,556,220139,400,-13,2018-02-18
Api Power Company Ltd.,10,389,377,389,431,163221,387,2,2018-02-20
Api Power Company Ltd.,13,389,375,375,454,171157,389,-14,2018-02-21
Api Power Company Ltd.,13,380,364,380,664,245904,375,5,2018-02-22
Api Power Company Ltd.,26,380,366,380,1860,686730,373,7,2018-02-26
Api Power Company Ltd.,7,380,369,380,1002,374728,380,0,2018-02-27
Api Power Company Ltd.,25,373,362,369,2460,895192,380,-11,2018-02-28
Api Power Company Ltd.,21,370,337,367,1427,517682,369,-2,2018-03-04
Api Power Company Ltd.,26,367,333,339,2512,865936,367,-28,2018-03-05
Api Power Company Ltd.,34,345,321,345,1298,427828,339,6,2018-03-06
Api Power Company Ltd.,13,354,343,354,999,345872,345,9,2018-03-07
Api Power Company Ltd.,22,355,336,337,644,221769,354,-17,2018-03-11
Api Power Company Ltd.,31,337,325,335,782,257407,337,-2,2018-03-12
Api Power Company Ltd.,29,338,325,333,967,323273,335,-2,2018-03-13
Api Power Company Ltd.,15,351,333,346,1704,585686,333,13,2018-03-14
Api Power Company Ltd.,6,340,340,340,1030,350200,346,-6,2018-03-15
Api Power Company Ltd.,130,334,306,306,17383,5383289,340,-34,2018-03-18
Api Power Company Ltd.,94,300,276,276,16667,4623857,306,-30,2018-03-19
Api Power Company Ltd.,108,285,249,280,15593,3942375,276,4,2018-03-20
Api Power Company Ltd.,58,285,252,280,8186,2149421,280,0,2018-03-21
Api Power Company Ltd.,45,284,259,271,3183,859059,280,-9,2018-03-22
Api Power Company Ltd.,39,266,248,254,8917,2290297,271,-17,2018-03-26
Api Power Company Ltd.,34,265,246,262,5128,1296579,254,8,2018-03-27
Api Power Company Ltd.,33,265,257,260,5892,1533538,262,-2,2018-03-28
Api Power Company Ltd.,64,279,262,279,8252,2214093,260,19,2018-03-29
Api Power Company Ltd.,26,279,259,268,2679,718639,279,-11,2018-04-01
Api Power Company Ltd.,25,274,263,267,2065,556761,268,-1,2018-04-02
Api Power Company Ltd.,11,278,270,276,747,203240,267,9,2018-04-03
Api Power Company Ltd.,27,278,270,274,4705,1292065,276,-2,2018-04-04
Api Power Company Ltd.,34,285,273,276,4628,1281926,274,2,2018-04-05
Api Power Company Ltd.,55,300,275,285,6637,1880119,276,9,2018-04-08
Api Power Company Ltd.,71,295,270,277,9461,2692946,285,-8,2018-04-09
Api Power Company Ltd.,37,280,270,280,3493,952032,277,3,2018-04-10
Api Power Company Ltd.,25,285,279,285,3570,1007866,280,5,2018-04-11
Api Power Company Ltd.,37,290,285,286,3471,999824,285,1,2018-04-12
Api Power Company Ltd.,14,291,281,290,2444,704432,286,4,2018-04-15
Api Power Company Ltd.,62,299,290,299,9586,2831520,290,9,2018-04-16
Api Power Company Ltd.,38,310,295,306,4431,1348638,299,7,2018-04-17
Api Power Company Ltd.,91,336,300,320,22627,7190743,306,14,2018-04-18
Api Power Company Ltd.,82,345,314,339,25085,8301206,320,19,2018-04-19
Api Power Company Ltd.,79,372,345,372,16370,5940572,339,33,2018-04-22
Api Power Company Ltd.,157,400,358,361,32366,12311387,372,-11,2018-04-23
Api Power Company Ltd.,76,372,342,360,9612,3476265,361,-1,2018-04-24
Api Power Company Ltd.,50,370,352,363,4185,1508839,360,3,2018-04-25
Api Power Company Ltd.,46,370,346,350,6381,2263624,363,-13,2018-04-26
Api Power Company Ltd.,42,350,340,342,6097,2103950,350,-8,2018-04-29
Api Power Company Ltd.,30,358,330,358,4047,1387675,342,16,2018-05-02
Api Power Company Ltd.,52,360,348,355,5538,1967406,358,-3,2018-05-03
Api Power Company Ltd.,36,355,347,348,2702,942793,355,-7,2018-05-06
Api Power Company Ltd.,35,355,344,349,5616,1951701,348,1,2018-05-07
Api Power Company Ltd.,32,350,337,350,2278,788341,349,1,2018-05-08
Api Power Company Ltd.,34,369,344,348,1864,654064,350,-2,2018-05-09
Api Power Company Ltd.,70,354,336,338,6058,2062980,348,-10,2018-05-10
Api Power Company Ltd.,51,342,335,338,2714,917175,338,0,2018-05-14
Api Power Company Ltd.,15,340,335,335,444,149855,338,-3,2018-05-15
Api Power Company Ltd.,23,341,329,340,2120,714656,335,5,2018-05-16
Api Power Company Ltd.,27,346,335,337,3035,1022453,340,-3,2018-05-17
Api Power Company Ltd.,16,340,332,336,870,294070,337,-1,2018-05-20
Api Power Company Ltd.,28,345,333,335,3869,1305082,336,-1,2018-05-21
Api Power Company Ltd.,21,335,330,332,1793,595134,335,-3,2018-05-22
Arambha Microfinance Bittiya Sanstha Ltd.,2,250,246,250,20,4960,0,250,2018-04-05
Arambha Microfinance Bittiya Sanstha Ltd.,2,260,255,260,20,5150,250,10,2018-04-08
Arambha Microfinance Bittiya Sanstha Ltd.,2,270,265,270,20,5350,260,10,2018-04-09
Arambha Microfinance Bittiya Sanstha Ltd.,2,280,275,280,20,5550,270,10,2018-04-10
Arambha Microfinance Bittiya Sanstha Ltd.,2,290,285,290,20,5750,280,10,2018-04-11
Arambha Microfinance Bittiya Sanstha Ltd.,2,300,295,300,20,5950,290,10,2018-04-12
Arambha Microfinance Bittiya Sanstha Ltd.,1,315,315,315,10,3150,300,15,2018-04-16
Arambha Microfinance Bittiya Sanstha Ltd.,1,321,321,321,10,3210,315,6,2018-04-19
Arambha Microfinance Bittiya Sanstha Ltd.,2,333,327,333,20,6600,321,12,2018-04-26
Arambha Microfinance Bittiya Sanstha Ltd.,1,339,339,339,10,3390,333,6,2018-05-02
Arambha Microfinance Bittiya Sanstha Ltd.,3,345,345,345,20,6900,339,6,2018-05-09
Arambha Microfinance Bittiya Sanstha Ltd.,2,0,0,0,10,3510,345,-345,2018-05-14
Arambha Microfinance Bittiya Sanstha Ltd.,1,362,362,362,10,3620,345,17,2018-05-16
Arambha Microfinance Bittiya Sanstha Ltd.,1,369,369,369,10,3690,362,7,2018-05-20
Arambha Microfinance Bittiya Sanstha Ltd.,1,376,376,376,10,3760,369,7,2018-05-22
Araniko Development Bank Limited,6,295,285,285,830,239973,293,-8,2016-05-23
Araniko Development Bank Limited,28,290,284,290,4221,1218052,285,5,2016-05-24
Araniko Development Bank Limited,13,289,282,284,3197,909162,290,-6,2016-05-25
Araniko Development Bank Limited,16,284,275,284,7573,2121947,284,0,2016-05-26
Araniko Development Bank Limited,4,285,281,285,1919,540789,284,1,2016-05-29
Araniko Development Bank Limited,7,285,280,282,2353,662645,285,-3,2016-05-30
Araniko Development Bank Limited,32,285,277,284,7335,2051032,282,2,2016-05-31
Araniko Development Bank Limited,9,284,280,281,1350,380635,284,-3,2016-06-01
Araniko Development Bank Limited,10,286,280,282,597,169840,281,1,2016-06-02
Araniko Development Bank Limited,19,277,270,270,1390,381454,282,-12,2016-06-05
Araniko Development Bank Limited,10,280,275,280,1183,329142,270,10,2016-06-06
Araniko Development Bank Limited,31,285,277,281,7581,2129019,280,1,2016-06-07
Araniko Development Bank Limited,14,348,331,333,2797,945311,337,-4,2016-06-23
Araniko Development Bank Limited,28,301,280,294,8183,2421585,281,13,2016-06-08
Araniko Development Bank Limited,20,303,292,292,4827,1445566,294,-2,2016-06-09
Araniko Development Bank Limited,20,300,292,296,3374,1003549,292,4,2016-06-12
Araniko Development Bank Limited,41,318,298,315,8645,2666920,296,19,2016-06-13
Araniko Development Bank Limited,21,315,309,309,5103,1588099,315,-6,2016-06-14
Araniko Development Bank Limited,16,315,307,307,1714,531834,309,-2,2016-06-15
Araniko Development Bank Limited,17,320,304,320,2836,882674,307,13,2016-06-16
Araniko Development Bank Limited,20,340,319,327,5021,1669151,320,7,2016-06-19
Araniko Development Bank Limited,22,339,327,334,4438,1478668,327,7,2016-06-20
Araniko Development Bank Limited,39,365,333,355,15408,5278204,334,21,2016-06-21
Araniko Development Bank Limited,7,350,337,337,1688,586584,355,-18,2016-06-22
Araniko Development Bank Limited,1,327,327,327,10,3270,333,-6,2016-06-26
Araniko Development Bank Limited,9,333,320,333,1672,545020,327,6,2016-06-27
Araniko Development Bank Limited,22,340,328,340,4694,1571651,333,7,2016-06-28
Araniko Development Bank Limited,34,340,324,338,9339,3134015,340,-2,2016-06-29
Araniko Development Bank Limited,19,340,334,340,12547,4214826,338,2,2016-06-30
Araniko Development Bank Limited,57,374,334,374,18616,6736817,340,34,2016-07-03
Araniko Development Bank Limited,69,400,371,382,29642,11295449,374,8,2016-07-04
Araniko Development Bank Limited,21,381,365,375,8821,3280469,382,-7,2016-07-05
Araniko Development Bank Limited,31,385,372,375,13364,5045578,375,0,2016-07-06
Araniko Development Bank Limited,8,375,368,368,1450,535393,375,-7,2016-07-10
Araniko Development Bank Limited,15,375,361,375,2043,745265,368,7,2016-07-11
Araniko Development Bank Limited,2,370,363,363,1359,493772,375,-12,2016-07-12
Araniko Development Bank Limited,21,362,337,359,4546,1598471,363,-4,2016-07-13
Araniko Development Bank Limited,6,380,352,380,343,126476,359,21,2016-07-14
Araniko Development Bank Limited,20,373,366,373,5645,2091655,380,-7,2016-07-17
Araniko Development Bank Limited,28,380,370,375,4772,1791910,373,2,2016-07-18
Araniko Development Bank Limited,53,398,375,393,18894,7322683,375,18,2016-07-19
Araniko Development Bank Limited,97,432,400,431,27580,11657803,393,38,2016-07-20
Araniko Development Bank Limited,89,455,436,444,32577,14470101,431,13,2016-07-21
Araniko Development Bank Limited,77,464,446,458,18549,8508371,444,14,2016-07-25
Araniko Development Bank Limited,73,500,467,499,12227,5961355,458,41,2016-07-26
Araniko Development Bank Limited,67,528,482,482,10190,5108663,499,-17,2016-07-27
Araniko Development Bank Limited,59,490,463,488,11669,5554240,482,6,2016-07-28
Araniko Development Bank Limited,46,497,465,465,11578,5487926,488,-23,2016-07-31
Araniko Development Bank Limited,51,470,450,464,12914,5900771,465,-1,2016-08-01
Araniko Development Bank Limited,35,473,446,461,5043,2298488,464,-3,2016-08-02
Araniko Development Bank Limited,31,474,445,460,5813,2642676,461,-1,2016-08-03
Araniko Development Bank Limited,29,478,432,433,5166,2293679,460,-27,2016-08-04
Araniko Development Bank Limited,33,462,429,436,6319,2801069,433,3,2016-08-07
Araniko Development Bank Limited,38,444,394,400,6447,2638401,436,-36,2016-08-08
Araniko Development Bank Limited,7,430,408,428,517,219721,400,28,2016-08-09
Araniko Development Bank Limited,41,444,430,440,7161,3128333,428,12,2016-08-10
Araniko Development Bank Limited,40,478,438,451,6843,3068035,440,11,2016-08-11
Araniko Development Bank Limited,33,443,422,430,5799,2505357,451,-21,2016-08-14
Araniko Development Bank Limited,8,433,417,423,1344,564916,430,-7,2016-08-15
Araniko Development Bank Limited,17,435,430,435,2837,1227057,435,0,2016-08-31
Araniko Development Bank Limited,40,440,415,439,7127,3063887,423,16,2016-08-16
Araniko Development Bank Limited,23,445,422,430,1956,859819,439,-9,2016-08-17
Araniko Development Bank Limited,18,438,417,418,3198,1358264,430,-12,2016-08-21
Araniko Development Bank Limited,19,420,402,414,2911,1204023,418,-4,2016-08-22
Araniko Development Bank Limited,15,426,402,418,2349,968181,414,4,2016-08-23
Araniko Development Bank Limited,4,432,418,432,152,64776,418,14,2016-08-24
Araniko Development Bank Limited,8,430,414,428,354,149942,432,-4,2016-08-28
Araniko Development Bank Limited,17,435,419,435,2346,996258,428,7,2016-08-29
Araniko Development Bank Limited,33,443,430,435,6776,2955822,435,0,2016-08-30
Araniko Development Bank Limited,112,477,436,472,34743,15889410,435,37,2016-09-01
Araniko Development Bank Limited,46,480,448,456,9371,4294306,472,-16,2016-09-04
Araniko Development Bank Limited,32,460,446,460,7777,3533909,456,4,2016-09-05
Araniko Development Bank Limited,39,469,446,460,19317,8906199,460,0,2016-09-06
Araniko Development Bank Limited,15,469,455,462,3955,1822412,460,2,2016-09-07
Araniko Development Bank Limited,31,469,459,465,4623,2135796,462,3,2016-09-08
Araniko Development Bank Limited,20,474,451,457,1076,490492,465,-8,2016-09-11
Araniko Development Bank Limited,28,465,452,458,2170,988486,457,1,2016-09-12
Araniko Development Bank Limited,20,476,460,460,2923,1356634,458,2,2016-09-14
Araniko Development Bank Limited,8,460,443,453,247,110899,460,-7,2016-09-18
Araniko Development Bank Limited,23,469,442,450,3017,1352003,453,-3,2016-09-20
Araniko Development Bank Limited,23,450,430,439,2409,1058825,450,-11,2016-09-21
Araniko Development Bank Limited,32,446,438,446,2140,944045,439,7,2016-09-22
Araniko Development Bank Limited,21,445,413,413,4557,1934683,446,-33,2016-09-25
Araniko Development Bank Limited,23,435,413,435,7077,3027380,413,22,2016-09-26
Araniko Development Bank Limited,20,442,427,442,4070,1767867,435,7,2016-09-27
Araniko Development Bank Limited,29,445,430,430,4270,1871192,442,-12,2016-09-28
Araniko Development Bank Limited,58,460,430,456,18962,8433901,430,26,2016-09-29
Araniko Development Bank Limited,19,459,439,451,4296,1939142,456,-5,2016-10-02
Araniko Development Bank Limited,31,459,442,450,5472,2458911,451,-1,2016-10-03
Araniko Development Bank Limited,32,462,451,462,7874,3600461,450,12,2016-10-04
Araniko Development Bank Limited,35,462,455,462,7200,3311541,462,0,2016-10-05
Araniko Development Bank Limited,84,475,460,475,20171,9435171,462,13,2016-10-06
Araniko Development Bank Limited,2,370,370,370,248,91760,376,-6,2016-10-16
Araniko Development Bank Limited Promoter Share,1,115,115,115,11854,1363210,115,0,2016-09-29
Arun Kabeli Power Ltd.,48,326,297,326,9361,3049746,0,326,2017-04-16
Arun Kabeli Power Ltd.,269,358,332,358,31151,11151161,326,32,2017-04-18
Arun Kabeli Power Ltd.,165,393,365,393,10034,3925883,358,35,2017-04-19
Arun Kabeli Power Ltd.,1499,432,383,411,110978,46161908,393,18,2017-04-23
Arun Kabeli Power Ltd.,1316,408,385,402,53027,21169186,411,-9,2017-04-24
Arun Kabeli Power Ltd.,1038,418,393,408,39076,15661810,402,6,2017-04-25
Arun Kabeli Power Ltd.,914,448,403,441,35032,14772788,408,33,2017-04-26
Arun Kabeli Power Ltd.,854,469,425,461,45822,20535199,441,20,2017-04-27
Arun Kabeli Power Ltd.,655,460,438,445,52492,23543803,461,-16,2017-04-30
Arun Kabeli Power Ltd.,388,455,434,444,30617,13560470,445,-1,2017-05-02
Arun Kabeli Power Ltd.,423,457,436,438,24825,10963261,444,-6,2017-05-03
Arun Kabeli Power Ltd.,703,450,435,447,51497,22794261,438,9,2017-05-04
Arun Kabeli Power Ltd.,640,450,437,439,29759,13140253,447,-8,2017-05-07
Arun Kabeli Power Ltd.,392,448,432,444,24419,10783817,439,5,2017-05-08
Arun Kabeli Power Ltd.,633,474,441,467,48134,22066936,444,23,2017-05-09
Arun Kabeli Power Ltd.,671,503,466,485,53131,25937106,467,18,2017-05-11
Arun Kabeli Power Ltd.,245,493,475,477,20965,10072120,485,-8,2017-05-15
Arun Kabeli Power Ltd.,246,485,472,480,12819,6103612,477,3,2017-05-16
Arun Kabeli Power Ltd.,250,484,472,481,14404,6902547,480,1,2017-05-17
Arun Kabeli Power Ltd.,218,493,473,490,25777,12366722,481,9,2017-05-18
Arun Kabeli Power Ltd.,202,485,465,484,11480,5470031,490,-6,2017-05-21
Arun Kabeli Power Ltd.,153,479,460,472,8730,4112955,484,-12,2017-05-22
Arun Kabeli Power Ltd.,196,483,465,468,11209,5299349,472,-4,2017-05-23
Arun Kabeli Power Ltd.,198,482,460,470,9904,4623727,468,2,2017-05-24
Arun Kabeli Power Ltd.,242,475,461,467,7736,3594103,470,-3,2017-05-28
Arun Kabeli Power Ltd.,278,469,450,460,11667,5331994,467,-7,2017-05-30
Arun Kabeli Power Ltd.,228,469,451,460,8876,4058962,460,0,2017-05-31
Arun Kabeli Power Ltd.,153,462,454,460,7009,3210837,460,0,2017-06-01
Arun Kabeli Power Ltd.,279,459,444,450,8662,3914707,460,-10,2017-06-04
Arun Kabeli Power Ltd.,164,455,443,450,5406,2419731,450,0,2017-06-05
Arun Kabeli Power Ltd.,189,463,441,457,5992,2719007,450,7,2017-06-06
Arun Kabeli Power Ltd.,279,455,446,447,11678,5241935,457,-10,2017-06-07
Arun Kabeli Power Ltd.,222,449,437,448,9330,4126730,447,1,2017-06-08
Arun Kabeli Power Ltd.,315,445,429,430,13870,6019824,448,-18,2017-06-11
Arun Kabeli Power Ltd.,194,435,416,422,10653,4516731,430,-8,2017-06-12
Arun Kabeli Power Ltd.,145,430,416,422,7280,3067322,422,0,2017-06-13
Arun Kabeli Power Ltd.,186,430,415,430,4893,2054570,422,8,2017-06-14
Arun Kabeli Power Ltd.,134,434,417,434,6410,2722549,430,4,2017-06-15
Arun Kabeli Power Ltd.,100,435,415,418,2107,885873,434,-16,2017-06-18
Arun Kabeli Power Ltd.,146,418,405,405,4938,2024152,418,-13,2017-06-19
Arun Kabeli Power Ltd.,155,421,400,412,4359,1781592,405,7,2017-06-20
Arun Kabeli Power Ltd.,131,416,406,416,8927,3674921,412,4,2017-06-21
Arun Kabeli Power Ltd.,67,420,415,418,2909,1215742,416,2,2017-06-22
Arun Kabeli Power Ltd.,134,439,418,438,5526,2368404,418,20,2017-06-25
Arun Kabeli Power Ltd.,67,439,427,429,2938,1261901,438,-9,2017-06-27
Arun Kabeli Power Ltd.,59,425,417,421,1161,488843,429,-8,2017-06-28
Arun Kabeli Power Ltd.,144,420,405,410,3952,1623186,421,-11,2017-07-02
Arun Kabeli Power Ltd.,156,418,405,406,5055,2064916,410,-4,2017-07-03
Arun Kabeli Power Ltd.,79,412,400,409,1815,739723,406,3,2017-07-04
Arun Kabeli Power Ltd.,114,417,405,417,3711,1510056,409,8,2017-07-05
Arun Kabeli Power Ltd.,70,425,409,425,1898,789357,417,8,2017-07-06
Arun Kabeli Power Ltd.,168,430,408,425,5553,2328785,425,0,2017-07-09
Arun Kabeli Power Ltd.,148,425,401,415,32236,13363029,425,-10,2017-07-10
Arun Kabeli Power Ltd.,123,417,408,417,4924,2026748,415,2,2017-07-11
Arun Kabeli Power Ltd.,108,414,410,410,3492,1436443,417,-7,2017-07-12
Arun Kabeli Power Ltd.,89,413,405,409,2146,877888,410,-1,2017-07-13
Arun Kabeli Power Ltd.,165,415,401,415,5459,2208990,409,6,2017-07-16
Arun Kabeli Power Ltd.,151,416,407,412,7175,2944449,415,-3,2017-07-17
Arun Kabeli Power Ltd.,188,441,405,434,9889,4189454,412,22,2017-07-18
Arun Kabeli Power Ltd.,170,418,404,410,3902,1598879,411,-1,2017-08-03
Arun Kabeli Power Ltd.,150,435,417,417,10705,4508979,434,-17,2017-07-19
Arun Kabeli Power Ltd.,93,422,415,417,5106,2133496,417,0,2017-07-20
Arun Kabeli Power Ltd.,142,425,411,416,5856,2430825,417,-1,2017-07-23
Arun Kabeli Power Ltd.,117,423,411,412,9148,3787907,416,-4,2017-07-24
Arun Kabeli Power Ltd.,146,423,404,411,3866,1598305,412,-1,2017-07-25
Arun Kabeli Power Ltd.,133,416,410,415,6045,2497707,411,4,2017-07-26
Arun Kabeli Power Ltd.,60,414,409,412,3964,1628987,415,-3,2017-07-27
Arun Kabeli Power Ltd.,97,418,407,407,11606,4751125,412,-5,2017-07-30
Arun Kabeli Power Ltd.,156,423,400,418,8062,3311181,407,11,2017-07-31
Arun Kabeli Power Ltd.,117,420,404,420,6928,2825951,418,2,2017-08-01
Arun Kabeli Power Ltd.,112,416,408,411,4182,1717301,420,-9,2017-08-02
Arun Kabeli Power Ltd.,150,411,402,407,3548,1447024,410,-3,2017-08-06
Arun Kabeli Power Ltd.,131,410,405,406,3067,1247544,407,-1,2017-08-07
Arun Kabeli Power Ltd.,266,405,397,400,11476,4595925,406,-6,2017-08-09
Arun Kabeli Power Ltd.,199,400,392,393,8529,3360936,400,-7,2017-08-10
Arun Kabeli Power Ltd.,124,400,376,381,5335,2032823,393,-12,2017-08-13
Arun Kabeli Power Ltd.,116,387,367,367,5051,1879853,381,-14,2017-08-15
Arun Kabeli Power Ltd.,85,387,370,375,5715,2157848,367,8,2017-08-16
Arun Kabeli Power Ltd.,168,375,364,368,13588,5010685,375,-7,2017-08-17
Arun Kabeli Power Ltd.,67,370,356,362,5245,1903753,368,-6,2017-08-20
Arun Kabeli Power Ltd.,97,366,350,366,6837,2427379,362,4,2017-08-21
Arun Kabeli Power Ltd.,104,380,352,360,2835,1030577,366,-6,2017-08-22
Arun Kabeli Power Ltd.,126,362,353,357,10457,3735959,360,-3,2017-08-23
Arun Kabeli Power Ltd.,89,372,351,372,4775,1718654,357,15,2017-08-24
Arun Kabeli Power Ltd.,133,378,350,378,9008,3305972,372,6,2017-08-27
Arun Kabeli Power Ltd.,77,391,358,368,6756,2544939,378,-10,2017-08-28
Arun Kabeli Power Ltd.,69,368,360,360,2199,797716,368,-8,2017-08-30
Arun Kabeli Power Ltd.,106,358,350,354,6893,2436766,360,-6,2017-08-31
Arun Kabeli Power Ltd.,99,362,345,362,5940,2084406,354,8,2017-09-04
Arun Kabeli Power Ltd.,109,365,346,350,5791,2033771,362,-12,2017-09-06
Arun Kabeli Power Ltd.,139,352,346,348,6831,2380066,350,-2,2017-09-07
Arun Kabeli Power Ltd.,104,342,330,332,9243,3103428,348,-16,2017-09-10
Arun Kabeli Power Ltd.,100,340,326,335,2600,860999,332,3,2017-09-11
Arun Kabeli Power Ltd.,82,339,326,330,3991,1323102,335,-5,2017-09-12
Arun Kabeli Power Ltd.,84,335,326,330,2061,680865,330,0,2017-09-13
Arun Kabeli Power Ltd.,70,342,324,342,2678,893369,330,12,2017-09-14
Arun Kabeli Power Ltd.,163,350,340,340,4138,1423399,342,-2,2017-09-17
Arun Kabeli Power Ltd.,88,346,334,336,1968,663556,340,-4,2017-09-18
Arun Kabeli Power Ltd.,53,336,326,333,1664,547030,336,-3,2017-09-20
Arun Kabeli Power Ltd.,27,319,315,318,2361,746894,317,1,2017-10-09
Arun Kabeli Power Ltd.,30,337,328,335,779,259413,333,2,2017-09-24
Arun Kabeli Power Ltd.,19,343,339,340,1680,573374,335,5,2017-09-25
Arun Kabeli Power Ltd.,36,341,330,340,3344,1125472,340,0,2017-09-26
Arun Kabeli Power Ltd.,12,346,330,332,2804,939867,340,-8,2017-10-04
Arun Kabeli Power Ltd.,69,326,315,317,1817,575696,332,-15,2017-10-08
Arun Kabeli Power Ltd.,19,323,312,323,1247,393387,318,5,2017-10-10
Arun Kabeli Power Ltd.,12,326,317,325,277,89080,323,2,2017-10-11
Arun Kabeli Power Ltd.,29,324,317,320,4026,1292428,325,-5,2017-10-12
Arun Kabeli Power Ltd.,13,325,315,325,1226,397115,320,5,2017-10-15
Arun Kabeli Power Ltd.,30,336,320,326,389,127032,325,1,2017-10-16
Arun Kabeli Power Ltd.,39,338,321,328,1323,437837,326,2,2017-10-17
Arun Kabeli Power Ltd.,15,329,317,329,215,69494,328,1,2017-10-18
Arun Kabeli Power Ltd.,53,351,335,351,6572,2243730,329,22,2017-10-22
Arun Kabeli Power Ltd.,39,355,340,342,2467,852013,351,-9,2017-10-23
Arun Kabeli Power Ltd.,26,346,340,344,779,267000,342,2,2017-10-24
Arun Kabeli Power Ltd.,44,344,335,338,2006,684814,344,-6,2017-10-25
Arun Kabeli Power Ltd.,32,346,333,335,1668,564788,338,-3,2017-10-29
Arun Kabeli Power Ltd.,35,335,330,332,5677,1883474,335,-3,2017-10-30
Arun Kabeli Power Ltd.,28,335,327,334,1710,569647,332,2,2017-10-31
Arun Kabeli Power Ltd.,47,338,328,329,2946,970535,334,-5,2017-11-01
Arun Kabeli Power Ltd.,41,331,323,327,1048,341967,329,-2,2017-11-02
Arun Kabeli Power Ltd.,62,325,321,325,1982,639535,327,-2,2017-11-05
Arun Kabeli Power Ltd.,37,331,322,326,2142,704307,325,1,2017-11-06
Arun Kabeli Power Ltd.,51,330,320,330,982,320296,326,4,2017-11-07
Arun Kabeli Power Ltd.,60,330,319,322,1927,621058,330,-8,2017-11-08
Arun Kabeli Power Ltd.,50,338,320,326,3682,1210945,322,4,2017-11-09
Arun Kabeli Power Ltd.,44,330,324,327,1146,375325,326,1,2017-11-12
Arun Kabeli Power Ltd.,54,342,321,342,2082,686167,327,15,2017-11-13
Arun Kabeli Power Ltd.,54,348,334,346,8731,2989240,342,4,2017-11-14
Arun Kabeli Power Ltd.,37,342,332,337,2178,734906,346,-9,2017-11-15
Arun Kabeli Power Ltd.,50,343,327,332,2407,809263,337,-5,2017-11-16
Arun Kabeli Power Ltd.,92,340,326,335,45210,15145567,332,3,2017-11-19
Arun Kabeli Power Ltd.,40,338,330,336,2051,687878,335,1,2017-11-20
Arun Kabeli Power Ltd.,113,351,330,351,7667,2608133,336,15,2017-11-21
Arun Kabeli Power Ltd.,79,353,334,343,2724,938168,351,-8,2017-11-22
Arun Kabeli Power Ltd.,139,353,343,353,5691,1978905,343,10,2017-11-23
Arun Kabeli Power Ltd.,43,364,347,354,3578,1281211,353,1,2017-11-26
Arun Kabeli Power Ltd.,96,361,336,351,4960,1740762,354,-3,2017-11-27
Arun Kabeli Power Ltd.,25,358,344,348,695,244862,351,-3,2017-11-28
Arun Kabeli Power Ltd.,82,369,353,354,9802,3533726,348,6,2017-11-29
Arun Kabeli Power Ltd.,74,365,344,365,5588,2003227,354,11,2017-11-30
Arun Kabeli Power Ltd.,54,372,344,358,6724,2410180,365,-7,2017-12-04
Arun Kabeli Power Ltd.,14,358,351,356,1458,516266,358,-2,2017-12-20
Arun Kabeli Power Ltd.,37,360,351,356,1846,655129,358,-2,2017-12-05
Arun Kabeli Power Ltd.,82,372,355,372,13162,4832065,356,16,2017-12-06
Arun Kabeli Power Ltd.,24,379,365,367,1943,719037,372,-5,2017-12-10
Arun Kabeli Power Ltd.,37,374,355,370,1935,709695,367,3,2017-12-11
Arun Kabeli Power Ltd.,48,373,359,362,2947,1070805,370,-8,2017-12-12
Arun Kabeli Power Ltd.,93,367,356,364,2390,866173,362,2,2017-12-13
Arun Kabeli Power Ltd.,11,370,357,360,487,175361,364,-4,2017-12-14
Arun Kabeli Power Ltd.,48,360,354,360,1060,379264,360,0,2017-12-17
Arun Kabeli Power Ltd.,57,368,359,360,4378,1590479,360,0,2017-12-18
Arun Kabeli Power Ltd.,63,360,351,358,3355,1199765,360,-2,2017-12-19
Arun Kabeli Power Ltd.,53,362,346,350,3925,1382753,356,-6,2017-12-21
Arun Kabeli Power Ltd.,22,351,346,348,466,162913,350,-2,2017-12-24
Arun Kabeli Power Ltd.,32,352,338,341,3621,1228095,348,-7,2017-12-26
Arun Kabeli Power Ltd.,46,346,326,346,1892,641706,341,5,2017-12-27
Arun Kabeli Power Ltd.,15,341,334,341,961,326761,346,-5,2017-12-28
Arun Kabeli Power Ltd.,36,339,332,335,2374,796545,341,-6,2017-12-31
Arun Kabeli Power Ltd.,27,347,334,341,1358,465716,335,6,2018-01-01
Arun Kabeli Power Ltd.,44,346,337,343,1127,384163,341,2,2018-01-02
Arun Kabeli Power Ltd.,34,343,333,337,3199,1080294,343,-6,2018-01-03
Arun Kabeli Power Ltd.,74,342,338,342,1449,493044,337,5,2018-01-04
Arun Kabeli Power Ltd.,25,344,338,339,1013,344579,342,-3,2018-01-07
Arun Kabeli Power Ltd.,17,342,335,341,235,79513,339,2,2018-01-08
Arun Kabeli Power Ltd.,11,345,335,340,1199,412082,341,-1,2018-01-09
Arun Kabeli Power Ltd.,23,346,337,342,828,284337,340,2,2018-01-10
Arun Kabeli Power Ltd.,14,341,333,341,1078,364844,342,-1,2018-01-14
Arun Kabeli Power Ltd.,17,340,332,337,991,335644,341,-4,2018-01-16
Arun Kabeli Power Ltd.,24,337,333,335,2095,700391,337,-2,2018-01-17
Arun Kabeli Power Ltd.,45,338,331,332,2711,904055,335,-3,2018-01-21
Arun Kabeli Power Ltd.,21,334,327,334,1374,457206,332,2,2018-01-22
Arun Kabeli Power Ltd.,22,337,325,330,1780,586231,334,-4,2018-01-23
Arun Kabeli Power Ltd.,37,335,329,335,732,242092,330,5,2018-01-24
Arun Kabeli Power Ltd.,40,340,330,340,1334,443767,335,5,2018-01-25
Arun Kabeli Power Ltd.,49,344,328,334,917,305050,340,-6,2018-01-28
Arun Kabeli Power Ltd.,29,332,328,332,423,139939,334,-2,2018-01-29
Arun Kabeli Power Ltd.,35,335,332,335,1510,505095,332,3,2018-01-31
Arun Kabeli Power Ltd.,19,343,331,335,461,153932,335,0,2018-02-01
Arun Kabeli Power Ltd.,33,337,329,334,2004,661689,335,-1,2018-02-04
Arun Kabeli Power Ltd.,34,330,326,327,9369,3076357,334,-7,2018-02-05
Arun Kabeli Power Ltd.,30,325,319,319,4833,1556871,327,-8,2018-02-06
Arun Kabeli Power Ltd.,11,329,315,329,203,64616,319,10,2018-02-07
Arun Kabeli Power Ltd.,31,332,317,321,1439,472399,329,-8,2018-02-08
Arun Kabeli Power Ltd.,10,318,312,315,367,115950,318,-3,2018-02-25
Arun Kabeli Power Ltd.,37,325,315,325,2621,836669,321,4,2018-02-11
Arun Kabeli Power Ltd.,28,322,316,322,2380,757525,325,-3,2018-02-12
Arun Kabeli Power Ltd.,53,329,313,329,5369,1695006,322,7,2018-02-14
Arun Kabeli Power Ltd.,37,333,317,329,3802,1241004,329,0,2018-02-15
Arun Kabeli Power Ltd.,1,335,335,335,10,3350,329,6,2018-02-18
Arun Kabeli Power Ltd.,31,329,314,318,2435,772218,335,-17,2018-02-20
Arun Kabeli Power Ltd.,8,319,313,319,156,49166,318,1,2018-02-21
Arun Kabeli Power Ltd.,33,320,313,318,1253,398407,319,-1,2018-02-22
Arun Kabeli Power Ltd.,33,310,305,306,3368,1034243,315,-9,2018-02-26
Arun Kabeli Power Ltd.,40,310,301,304,2068,626708,306,-2,2018-02-27
Arun Kabeli Power Ltd.,47,301,285,290,8975,2586670,304,-14,2018-02-28
Arun Kabeli Power Ltd.,84,285,261,273,3241,872746,290,-17,2018-03-04
Arun Kabeli Power Ltd.,33,269,255,255,9399,2478187,273,-18,2018-03-05
Arun Kabeli Power Ltd.,44,261,251,261,5031,1277658,255,6,2018-03-06
Arun Kabeli Power Ltd.,18,271,256,269,717,189830,261,8,2018-03-07
Arun Kabeli Power Ltd.,74,265,250,252,5178,1299676,269,-17,2018-03-11
Arun Kabeli Power Ltd.,30,251,243,250,1707,420390,252,-2,2018-03-12
Arun Kabeli Power Ltd.,12,252,248,252,435,108840,250,2,2018-03-13
Arun Kabeli Power Ltd.,8,257,249,254,748,189737,252,2,2018-03-14
Arun Kabeli Power Ltd.,4,259,258,258,513,132854,254,4,2018-03-15
Arun Kabeli Power Ltd.,18,258,250,258,1337,337251,258,0,2018-03-18
Arun Kabeli Power Ltd.,17,253,244,245,1016,249843,258,-13,2018-03-19
Arun Kabeli Power Ltd.,61,246,240,240,2751,665226,245,-5,2018-03-20
Arun Kabeli Power Ltd.,14,239,233,238,1483,350655,240,-2,2018-03-21
Arun Kabeli Power Ltd.,23,237,230,235,2077,481819,238,-3,2018-03-22
Arun Kabeli Power Ltd.,50,231,226,227,1404,318289,235,-8,2018-03-26
Arun Kabeli Power Ltd.,27,231,212,231,1880,404539,227,4,2018-03-27
Arun Kabeli Power Ltd.,12,228,220,223,951,212479,231,-8,2018-03-28
Arun Kabeli Power Ltd.,18,235,223,235,1353,310299,223,12,2018-03-29
Arun Kabeli Power Ltd.,51,235,219,232,2310,528348,235,-3,2018-04-01
Arun Kabeli Power Ltd.,17,236,225,227,1187,270079,232,-5,2018-04-02
Arun Kabeli Power Ltd.,9,230,225,225,446,100791,227,-2,2018-04-03
Arun Kabeli Power Ltd.,10,236,229,236,1033,238823,225,11,2018-04-04
Arun Kabeli Power Ltd.,22,248,236,238,1888,454722,236,2,2018-04-05
Arun Kabeli Power Ltd.,25,261,241,261,3470,867232,238,23,2018-04-08
Arun Kabeli Power Ltd.,31,271,248,250,6422,1651142,261,-11,2018-04-09
Arun Kabeli Power Ltd.,30,250,242,245,3483,853848,250,-5,2018-04-10
Arun Kabeli Power Ltd.,14,248,237,245,645,156142,245,0,2018-04-11
Arun Kabeli Power Ltd.,17,256,245,249,1178,297379,245,4,2018-04-12
Arun Kabeli Power Ltd.,12,250,245,250,793,197130,249,1,2018-04-15
Arun Kabeli Power Ltd.,21,270,245,265,3553,935288,250,15,2018-04-16
Arun Kabeli Power Ltd.,39,284,264,274,5001,1351669,265,9,2018-04-17
Arun Kabeli Power Ltd.,61,301,269,291,7701,2224089,274,17,2018-04-18
Arun Kabeli Power Ltd.,71,305,286,300,17076,5080826,291,9,2018-04-19
Arun Kabeli Power Ltd.,136,330,306,330,16988,5460887,300,30,2018-04-22
Arun Kabeli Power Ltd.,126,349,313,343,19600,6605864,330,13,2018-04-23
Arun Kabeli Power Ltd.,43,349,326,333,7518,2529848,343,-10,2018-04-24
Arun Kabeli Power Ltd.,46,340,321,334,5874,1954559,333,1,2018-04-25
Arun Kabeli Power Ltd.,40,330,314,316,5745,1838484,334,-18,2018-04-26
Arun Kabeli Power Ltd.,51,325,310,325,7009,2221124,316,9,2018-04-29
Arun Kabeli Power Ltd.,33,325,314,321,963,309820,325,-4,2018-05-02
Arun Kabeli Power Ltd.,80,335,321,324,5461,1787625,321,3,2018-05-03
Arun Kabeli Power Ltd.,35,321,306,314,2314,733451,324,-10,2018-05-06
Arun Kabeli Power Ltd.,43,322,310,312,9012,2815209,314,-2,2018-05-07
Arun Kabeli Power Ltd.,57,322,311,322,3454,1091564,312,10,2018-05-08
Arun Kabeli Power Ltd.,78,326,315,320,2692,866039,322,-2,2018-05-09
Arun Kabeli Power Ltd.,80,326,314,323,3467,1108390,320,3,2018-05-10
Arun Kabeli Power Ltd.,75,317,305,314,1876,590265,323,-9,2018-05-14
Arun Kabeli Power Ltd.,21,320,311,311,1279,399260,314,-3,2018-05-15
Arun Kabeli Power Ltd.,17,315,306,314,2397,748236,311,3,2018-05-16
Arun Kabeli Power Ltd.,21,326,310,311,2033,634538,314,-3,2018-05-17
Arun Kabeli Power Ltd.,24,321,308,311,2774,862104,311,0,2018-05-20
Arun Kabeli Power Ltd.,32,312,307,311,840,259890,311,0,2018-05-21
Arun Kabeli Power Ltd.,21,312,308,309,2102,651699,311,-2,2018-05-22
Arun Valley Hydropower Development Co. Ltd.,45,334,328,334,14083,4668974,331,3,2016-05-23
Arun Valley Hydropower Development Co. Ltd.,41,335,331,332,13309,4435578,334,-2,2016-05-24
Arun Valley Hydropower Development Co. Ltd.,62,338,330,338,21449,7186279,332,6,2016-05-25
Arun Valley Hydropower Development Co. Ltd.,35,338,330,337,11988,3991454,338,-1,2016-05-26
Arun Valley Hydropower Development Co. Ltd.,38,349,334,334,9597,3258226,337,-3,2016-05-29
Arun Valley Hydropower Development Co. Ltd.,40,342,336,340,12088,4102553,334,6,2016-05-30
Arun Valley Hydropower Development Co. Ltd.,197,374,340,374,61779,22662140,340,34,2016-05-31
Arun Valley Hydropower Development Co. Ltd.,240,402,354,366,78039,29209511,374,-8,2016-06-01
Arun Valley Hydropower Development Co. Ltd.,75,365,353,356,25787,9228426,366,-10,2016-06-02
Arun Valley Hydropower Development Co. Ltd.,57,353,340,340,16319,5665713,356,-16,2016-06-05
Arun Valley Hydropower Development Co. Ltd.,38,352,343,350,11655,4061963,340,10,2016-06-06
Arun Valley Hydropower Development Co. Ltd.,41,350,343,348,9737,3369171,350,-2,2016-06-07
Arun Valley Hydropower Development Co. Ltd.,381,435,401,435,156869,66459227,396,39,2016-06-23
Arun Valley Hydropower Development Co. Ltd.,37,354,342,349,13836,4789227,348,1,2016-06-08
Arun Valley Hydropower Development Co. Ltd.,55,352,336,349,26484,9145667,349,0,2016-06-09
Arun Valley Hydropower Development Co. Ltd.,91,357,344,356,50039,17588019,349,7,2016-06-12
Arun Valley Hydropower Development Co. Ltd.,79,363,350,355,43140,15340840,356,-1,2016-06-13
Arun Valley Hydropower Development Co. Ltd.,133,375,357,365,67920,24892977,355,10,2016-06-14
Arun Valley Hydropower Development Co. Ltd.,65,370,357,359,27350,9945108,365,-6,2016-06-15
Arun Valley Hydropower Development Co. Ltd.,122,394,366,378,47493,17656672,359,19,2016-06-16
Arun Valley Hydropower Development Co. Ltd.,198,409,375,390,90850,35419118,378,12,2016-06-19
Arun Valley Hydropower Development Co. Ltd.,119,402,383,386,60257,23900165,390,-4,2016-06-20
Arun Valley Hydropower Development Co. Ltd.,87,400,386,390,38502,15135889,386,4,2016-06-21
Arun Valley Hydropower Development Co. Ltd.,81,404,388,396,29094,11429506,390,6,2016-06-22
Arun Valley Hydropower Development Co. Ltd.,199,443,415,415,62449,26517911,435,-20,2016-06-26
Arun Valley Hydropower Development Co. Ltd.,135,434,420,424,56552,24075475,415,9,2016-06-27
Arun Valley Hydropower Development Co. Ltd.,80,435,416,429,27672,11696232,424,5,2016-06-28
Arun Valley Hydropower Development Co. Ltd.,152,437,418,433,67476,28794716,429,4,2016-06-29
Arun Valley Hydropower Development Co. Ltd.,123,437,425,435,60741,26110600,433,2,2016-06-30
Arun Valley Hydropower Development Co. Ltd.,61,450,430,434,19157,8329221,435,-1,2016-07-03
Arun Valley Hydropower Development Co. Ltd.,67,434,427,428,22942,9876812,434,-6,2016-07-04
Arun Valley Hydropower Development Co. Ltd.,53,430,423,425,10719,4581262,428,-3,2016-07-05
Arun Valley Hydropower Development Co. Ltd.,67,428,420,422,20544,8669867,425,-3,2016-07-06
Arun Valley Hydropower Development Co. Ltd.,74,425,417,420,33129,13908925,422,-2,2016-07-10
Arun Valley Hydropower Development Co. Ltd.,56,420,405,412,14144,5841361,420,-8,2016-07-11
Arun Valley Hydropower Development Co. Ltd.,77,412,393,405,22869,9211460,412,-7,2016-07-12
Arun Valley Hydropower Development Co. Ltd.,49,400,385,397,15233,6032779,405,-8,2016-07-13
Arun Valley Hydropower Development Co. Ltd.,56,423,395,412,42759,17863572,397,15,2016-07-14
Arun Valley Hydropower Development Co. Ltd.,42,435,415,421,32931,14193922,412,9,2016-07-17
Arun Valley Hydropower Development Co. Ltd.,35,429,413,415,13166,5493523,421,-6,2016-07-18
Arun Valley Hydropower Development Co. Ltd.,116,424,405,420,38058,15813328,415,5,2016-07-19
Arun Valley Hydropower Development Co. Ltd.,44,422,412,414,11320,4709535,420,-6,2016-07-20
Arun Valley Hydropower Development Co. Ltd.,45,414,401,413,23283,9504104,414,-1,2016-07-21
Arun Valley Hydropower Development Co. Ltd.,57,420,410,415,21184,8798701,413,2,2016-07-25
Arun Valley Hydropower Development Co. Ltd.,100,428,410,424,35590,14854924,415,9,2016-07-26
Arun Valley Hydropower Development Co. Ltd.,104,435,416,427,33978,14446653,424,3,2016-07-27
Arun Valley Hydropower Development Co. Ltd.,81,428,415,423,28720,12131249,427,-4,2016-07-28
Arun Valley Hydropower Development Co. Ltd.,315,465,420,465,135415,60799361,423,42,2016-07-31
Arun Valley Hydropower Development Co. Ltd.,176,485,440,458,50730,23334558,465,-7,2016-08-01
Arun Valley Hydropower Development Co. Ltd.,165,455,436,444,54916,24450641,458,-14,2016-08-02
Arun Valley Hydropower Development Co. Ltd.,82,444,416,444,24492,10715367,444,0,2016-08-03
Arun Valley Hydropower Development Co. Ltd.,95,452,415,415,29163,12420223,444,-29,2016-08-04
Arun Valley Hydropower Development Co. Ltd.,155,456,423,445,70764,32194670,415,30,2016-08-07
Arun Valley Hydropower Development Co. Ltd.,133,440,403,411,40204,16866048,445,-34,2016-08-08
Arun Valley Hydropower Development Co. Ltd.,22,445,419,430,5971,2612269,411,19,2016-08-09
Arun Valley Hydropower Development Co. Ltd.,162,453,414,436,65755,28330489,430,6,2016-08-10
Arun Valley Hydropower Development Co. Ltd.,174,439,424,430,89007,38528919,436,-6,2016-08-11
Arun Valley Hydropower Development Co. Ltd.,248,422,404,418,106293,43745221,430,-12,2016-08-14
Arun Valley Hydropower Development Co. Ltd.,90,394,350,370,35439,13017895,380,-10,2016-08-15
Arun Valley Hydropower Development Co. Ltd.,50,337,317,323,13230,4270026,343,-20,2016-08-31
Arun Valley Hydropower Development Co. Ltd.,22,367,349,355,6738,2413482,370,-15,2016-08-16
Arun Valley Hydropower Development Co. Ltd.,45,375,362,375,15832,5794669,355,20,2016-08-17
Arun Valley Hydropower Development Co. Ltd.,9,368,354,361,2985,1077430,375,-14,2016-08-21
Arun Valley Hydropower Development Co. Ltd.,58,354,325,335,12380,4198155,361,-26,2016-08-22
Arun Valley Hydropower Development Co. Ltd.,57,340,316,331,15006,4835643,335,-4,2016-08-23
Arun Valley Hydropower Development Co. Ltd.,38,338,315,324,7157,2314557,331,-7,2016-08-24
Arun Valley Hydropower Development Co. Ltd.,32,346,318,336,5064,1678818,324,12,2016-08-28
Arun Valley Hydropower Development Co. Ltd.,26,340,322,340,6465,2164147,336,4,2016-08-29
Arun Valley Hydropower Development Co. Ltd.,24,343,335,343,4138,1401841,340,3,2016-08-30
Arun Valley Hydropower Development Co. Ltd.,38,322,312,317,8824,2798249,323,-6,2016-09-01
Arun Valley Hydropower Development Co. Ltd.,30,339,313,339,15750,5092278,317,22,2016-09-04
Arun Valley Hydropower Development Co. Ltd.,27,345,323,329,7583,2520992,339,-10,2016-09-05
Arun Valley Hydropower Development Co. Ltd.,16,328,322,322,4247,1377398,329,-7,2016-09-06
Arun Valley Hydropower Development Co. Ltd.,20,327,315,322,8267,2629769,322,0,2016-09-07
Arun Valley Hydropower Development Co. Ltd.,26,322,317,319,6626,2117446,322,-3,2016-09-08
Arun Valley Hydropower Development Co. Ltd.,23,319,310,319,6643,2083811,319,0,2016-09-11
Arun Valley Hydropower Development Co. Ltd.,14,322,313,314,3344,1062406,319,-5,2016-09-12
Arun Valley Hydropower Development Co. Ltd.,32,319,311,317,14414,4514927,314,3,2016-09-14
Arun Valley Hydropower Development Co. Ltd.,30,321,310,316,9852,3088550,317,-1,2016-09-18
Arun Valley Hydropower Development Co. Ltd.,32,319,311,319,19641,6205518,316,3,2016-09-20
Arun Valley Hydropower Development Co. Ltd.,29,320,312,320,16016,5053317,319,1,2016-09-21
Arun Valley Hydropower Development Co. Ltd.,34,337,318,321,11901,3842454,320,1,2016-09-22
Arun Valley Hydropower Development Co. Ltd.,25,319,310,310,11747,3678779,321,-11,2016-09-25
Arun Valley Hydropower Development Co. Ltd.,28,316,308,312,12182,3824248,310,2,2016-09-26
Arun Valley Hydropower Development Co. Ltd.,32,315,310,312,11066,3457884,312,0,2016-09-27
Arun Valley Hydropower Development Co. Ltd.,7,315,306,311,4388,1360102,312,-1,2016-09-28
Arun Valley Hydropower Development Co. Ltd.,45,310,298,306,21704,6580505,311,-5,2016-09-29
Arun Valley Hydropower Development Co. Ltd.,47,308,289,308,16525,4890738,306,2,2016-10-02
Arun Valley Hydropower Development Co. Ltd.,25,306,300,305,18923,5720430,308,-3,2016-10-03
Arun Valley Hydropower Development Co. Ltd.,16,307,301,304,8603,2624214,305,-1,2016-10-04
Arun Valley Hydropower Development Co. Ltd.,28,317,305,305,15217,4693910,304,1,2016-10-05
Arun Valley Hydropower Development Co. Ltd.,29,322,306,322,9330,2953278,305,17,2016-10-06
Arun Valley Hydropower Development Co. Ltd.,20,324,311,315,5959,1888129,322,-7,2016-10-16
Arun Valley Hydropower Development Co. Ltd.,25,318,311,316,8800,2773422,315,1,2016-10-17
Arun Valley Hydropower Development Co. Ltd.,8,316,313,315,3832,1204503,316,-1,2016-10-18
Arun Valley Hydropower Development Co. Ltd.,25,321,311,314,6093,1907740,315,-1,2016-10-19
Arun Valley Hydropower Development Co. Ltd.,20,315,310,314,8394,2616278,314,0,2016-10-20
Arun Valley Hydropower Development Co. Ltd.,22,317,309,313,8181,2564535,314,-1,2016-10-23
Arun Valley Hydropower Development Co. Ltd.,23,319,308,318,8316,2614434,313,5,2016-10-24
Arun Valley Hydropower Development Co. Ltd.,24,316,310,314,6363,1997754,318,-4,2016-10-25
Arun Valley Hydropower Development Co. Ltd.,16,314,312,314,5324,1665863,314,0,2016-10-26
Arun Valley Hydropower Development Co. Ltd.,19,320,312,318,2273,717671,314,4,2016-10-27
Arun Valley Hydropower Development Co. Ltd.,5,312,306,312,1642,509052,318,-6,2016-11-03
Arun Valley Hydropower Development Co. Ltd.,19,311,306,310,6544,2021890,312,-2,2016-11-07
Arun Valley Hydropower Development Co. Ltd.,12,312,306,307,7379,2282711,310,-3,2016-11-08
Arun Valley Hydropower Development Co. Ltd.,25,307,300,300,9327,2829147,307,-7,2016-11-09
Arun Valley Hydropower Development Co. Ltd.,25,304,294,303,5246,1572226,300,3,2016-11-10
Arun Valley Hydropower Development Co. Ltd.,27,302,295,301,7990,2398746,303,-2,2016-11-13
Arun Valley Hydropower Development Co. Ltd.,16,301,295,296,3195,946965,301,-5,2016-11-14
Arun Valley Hydropower Development Co. Ltd.,12,298,293,298,2655,783348,296,2,2016-11-15
Arun Valley Hydropower Development Co. Ltd.,18,296,290,290,5329,1560995,298,-8,2016-11-16
Arun Valley Hydropower Development Co. Ltd.,18,295,285,295,2824,811976,290,5,2016-11-17
Arun Valley Hydropower Development Co. Ltd.,7,295,280,280,1020,291300,295,-15,2016-11-20
Arun Valley Hydropower Development Co. Ltd.,40,284,266,270,19562,5312805,280,-10,2016-11-21
Arun Valley Hydropower Development Co. Ltd.,24,278,265,273,6612,1796366,270,3,2016-11-22
Arun Valley Hydropower Development Co. Ltd.,30,275,260,265,8129,2177601,273,-8,2016-11-23
Arun Valley Hydropower Development Co. Ltd.,32,275,264,270,10701,2866924,265,5,2016-11-24
Arun Valley Hydropower Development Co. Ltd.,55,265,245,250,19305,4833527,270,-20,2016-11-27
Arun Valley Hydropower Development Co. Ltd.,22,270,232,270,5222,1290982,250,20,2016-11-28
Arun Valley Hydropower Development Co. Ltd.,31,280,255,280,7905,2145554,270,10,2016-11-29
Arun Valley Hydropower Development Co. Ltd.,42,291,272,290,21105,5936202,280,10,2016-11-30
Arun Valley Hydropower Development Co. Ltd.,34,290,272,272,9291,2587272,290,-18,2016-12-01
Arun Valley Hydropower Development Co. Ltd.,11,277,268,268,2417,661238,272,-4,2016-12-04
Arun Valley Hydropower Development Co. Ltd.,8,270,265,265,647,172790,268,-3,2016-12-05
Arun Valley Hydropower Development Co. Ltd.,21,270,260,270,4261,1131151,265,5,2016-12-06
Arun Valley Hydropower Development Co. Ltd.,15,270,267,268,4512,1208290,270,-2,2016-12-07
Arun Valley Hydropower Development Co. Ltd.,31,265,260,260,4478,1175753,268,-8,2016-12-08
Arun Valley Hydropower Development Co. Ltd.,10,260,255,256,2743,706381,260,-4,2016-12-11
Arun Valley Hydropower Development Co. Ltd.,16,257,250,252,1745,440150,256,-4,2016-12-12
Arun Valley Hydropower Development Co. Ltd.,10,259,253,259,1778,455434,252,7,2016-12-14
Arun Valley Hydropower Development Co. Ltd.,7,266,256,266,1660,434130,259,7,2016-12-15
Arun Valley Hydropower Development Co. Ltd.,9,271,259,271,990,260623,266,5,2016-12-18
Arun Valley Hydropower Development Co. Ltd.,16,266,261,261,3187,838598,271,-10,2016-12-19
Arun Valley Hydropower Development Co. Ltd.,13,260,255,255,4813,1233611,261,-6,2016-12-20
Arun Valley Hydropower Development Co. Ltd.,23,258,250,253,3627,918303,255,-2,2016-12-21
Arun Valley Hydropower Development Co. Ltd.,5,255,246,255,344,86510,253,2,2016-12-22
Arun Valley Hydropower Development Co. Ltd.,22,255,241,241,9156,2243726,255,-14,2016-12-26
Arun Valley Hydropower Development Co. Ltd.,26,246,236,242,4439,1063749,241,1,2016-12-27
Arun Valley Hydropower Development Co. Ltd.,28,250,239,245,7568,1843484,242,3,2016-12-28
Arun Valley Hydropower Development Co. Ltd.,24,250,246,248,7942,1975916,245,3,2016-12-29
Arun Valley Hydropower Development Co. Ltd.,42,260,246,250,10091,2547963,248,2,2017-01-01
Arun Valley Hydropower Development Co. Ltd.,27,255,246,246,9057,2257767,250,-4,2017-01-02
Arun Valley Hydropower Development Co. Ltd.,25,255,242,255,7007,1720776,246,9,2017-01-03
Arun Valley Hydropower Development Co. Ltd.,15,255,248,252,3661,918910,255,-3,2017-01-04
Arun Valley Hydropower Development Co. Ltd.,6,250,248,250,2129,531672,252,-2,2017-01-05
Arun Valley Hydropower Development Co. Ltd.,11,250,245,250,3126,771242,250,0,2017-01-08
Arun Valley Hydropower Development Co. Ltd.,5,252,248,252,336,83808,250,2,2017-01-09
Arun Valley Hydropower Development Co. Ltd.,7,255,250,255,1154,288950,252,3,2017-01-10
Arun Valley Hydropower Development Co. Ltd.,22,259,247,249,4037,1014494,255,-6,2017-01-11
Arun Valley Hydropower Development Co. Ltd.,32,255,249,253,6482,1619579,249,4,2017-01-12
Arun Valley Hydropower Development Co. Ltd.,16,252,247,247,2709,674791,253,-6,2017-01-15
Arun Valley Hydropower Development Co. Ltd.,28,249,243,245,4183,1029037,247,-2,2017-01-16
Arun Valley Hydropower Development Co. Ltd.,18,247,244,247,2049,501652,245,2,2017-01-17
Arun Valley Hydropower Development Co. Ltd.,8,247,244,245,491,120479,247,-2,2017-01-18
Arun Valley Hydropower Development Co. Ltd.,26,248,244,245,3921,960241,245,0,2017-01-19
Arun Valley Hydropower Development Co. Ltd.,22,251,243,251,4038,999334,245,6,2017-01-22
Arun Valley Hydropower Development Co. Ltd.,26,250,246,247,9685,2401792,251,-4,2017-01-23
Arun Valley Hydropower Development Co. Ltd.,31,250,245,247,7167,1771817,247,0,2017-01-24
Arun Valley Hydropower Development Co. Ltd.,15,245,240,241,3320,804530,247,-6,2017-01-25
Arun Valley Hydropower Development Co. Ltd.,31,237,226,233,7702,1784509,241,-8,2017-01-26
Arun Valley Hydropower Development Co. Ltd.,33,229,210,214,5775,1246499,233,-19,2017-01-30
Arun Valley Hydropower Development Co. Ltd.,11,223,206,223,2518,538276,214,9,2017-01-31
Arun Valley Hydropower Development Co. Ltd.,23,243,227,236,2764,652290,223,13,2017-02-01
Arun Valley Hydropower Development Co. Ltd.,28,244,230,230,18329,4384129,236,-6,2017-02-02
Arun Valley Hydropower Development Co. Ltd.,17,234,223,224,3768,847993,230,-6,2017-02-05
Arun Valley Hydropower Development Co. Ltd.,9,228,219,228,957,211944,224,4,2017-02-06
Arun Valley Hydropower Development Co. Ltd.,21,225,220,221,11067,2447624,228,-7,2017-02-07
Arun Valley Hydropower Development Co. Ltd.,18,221,218,218,4713,1030855,221,-3,2017-02-08
Arun Valley Hydropower Development Co. Ltd.,31,220,212,212,7226,1556944,218,-6,2017-02-09
Arun Valley Hydropower Development Co. Ltd.,37,212,205,205,5197,1079211,212,-7,2017-02-12
Arun Valley Hydropower Development Co. Ltd.,28,220,201,220,3448,702246,205,15,2017-02-13
Arun Valley Hydropower Development Co. Ltd.,19,216,200,216,5516,1123765,220,-4,2017-02-14
Arun Valley Hydropower Development Co. Ltd.,21,220,209,219,5154,1110435,216,3,2017-02-15
Arun Valley Hydropower Development Co. Ltd.,20,223,215,220,2683,586997,219,1,2017-02-16
Arun Valley Hydropower Development Co. Ltd.,20,222,216,222,6166,1349201,220,2,2017-02-19
Arun Valley Hydropower Development Co. Ltd.,23,230,215,215,5449,1191233,222,-7,2017-02-20
Arun Valley Hydropower Development Co. Ltd.,19,219,212,212,3733,813734,215,-3,2017-02-21
Arun Valley Hydropower Development Co. Ltd.,17,212,204,208,2484,514164,212,-4,2017-02-22
Arun Valley Hydropower Development Co. Ltd.,15,216,208,209,3577,758914,208,1,2017-02-23
Arun Valley Hydropower Development Co. Ltd.,8,208,205,207,1269,263012,209,-2,2017-02-26
Arun Valley Hydropower Development Co. Ltd.,8,210,206,208,1662,344153,207,1,2017-02-28
Arun Valley Hydropower Development Co. Ltd.,17,213,205,213,3317,690668,208,5,2017-03-01
Arun Valley Hydropower Development Co. Ltd.,16,214,207,214,2681,563722,213,1,2017-03-02
Arun Valley Hydropower Development Co. Ltd.,16,216,209,214,4612,988900,214,0,2017-03-05
Arun Valley Hydropower Development Co. Ltd.,28,240,227,240,4241,978686,232,8,2017-03-21
Arun Valley Hydropower Development Co. Ltd.,14,215,207,215,4875,1038759,214,1,2017-03-06
Arun Valley Hydropower Development Co. Ltd.,20,215,206,210,3347,703252,215,-5,2017-03-07
Arun Valley Hydropower Development Co. Ltd.,20,222,210,222,4040,881710,210,12,2017-03-09
Arun Valley Hydropower Development Co. Ltd.,47,229,219,228,11867,2671360,222,6,2017-03-13
Arun Valley Hydropower Development Co. Ltd.,30,226,219,222,6406,1423555,228,-6,2017-03-14
Arun Valley Hydropower Development Co. Ltd.,52,237,216,230,11463,2579796,222,8,2017-03-15
Arun Valley Hydropower Development Co. Ltd.,21,231,222,227,3869,871958,230,-3,2017-03-16
Arun Valley Hydropower Development Co. Ltd.,30,235,224,229,6260,1437929,227,2,2017-03-19
Arun Valley Hydropower Development Co. Ltd.,43,237,229,232,9785,2270260,229,3,2017-03-20
Arun Valley Hydropower Development Co. Ltd.,82,262,237,242,28299,6974338,240,2,2017-03-22
Arun Valley Hydropower Development Co. Ltd.,91,264,234,263,28717,7267277,242,21,2017-03-23
Arun Valley Hydropower Development Co. Ltd.,130,289,255,278,42623,11822526,263,15,2017-03-26
Arun Valley Hydropower Development Co. Ltd.,34,298,273,288,5931,1700500,278,10,2017-03-28
Arun Valley Hydropower Development Co. Ltd.,86,293,266,271,22957,6389380,288,-17,2017-03-29
Arun Valley Hydropower Development Co. Ltd.,34,279,266,270,9588,2587212,271,-1,2017-03-30
Arun Valley Hydropower Development Co. Ltd.,15,288,270,275,6514,1825821,270,5,2017-04-02
Arun Valley Hydropower Development Co. Ltd.,76,295,275,275,19680,5499086,275,0,2017-04-03
Arun Valley Hydropower Development Co. Ltd.,51,276,265,276,16352,4432406,275,1,2017-04-04
Arun Valley Hydropower Development Co. Ltd.,47,275,267,273,8798,2371632,276,-3,2017-04-06
Arun Valley Hydropower Development Co. Ltd.,63,290,271,290,18557,5142509,273,17,2017-04-09
Arun Valley Hydropower Development Co. Ltd.,121,304,286,300,39707,11737305,290,10,2017-04-10
Arun Valley Hydropower Development Co. Ltd.,92,316,296,301,20961,6294183,300,1,2017-04-11
Arun Valley Hydropower Development Co. Ltd.,60,306,295,295,22956,6866262,301,-6,2017-04-12
Arun Valley Hydropower Development Co. Ltd.,27,293,283,287,4349,1253273,295,-8,2017-04-13
Arun Valley Hydropower Development Co. Ltd.,54,292,273,280,14739,4146048,287,-7,2017-04-16
Arun Valley Hydropower Development Co. Ltd.,27,287,270,279,7247,1987409,280,-1,2017-04-18
Arun Valley Hydropower Development Co. Ltd.,36,284,272,284,8409,2355658,279,5,2017-04-19
Arun Valley Hydropower Development Co. Ltd.,20,291,275,291,4211,1180107,284,7,2017-04-20
Arun Valley Hydropower Development Co. Ltd.,46,304,286,290,16099,4712969,291,-1,2017-04-23
Arun Valley Hydropower Development Co. Ltd.,50,293,280,287,18004,5130040,290,-3,2017-04-24
Arun Valley Hydropower Development Co. Ltd.,35,286,278,283,10975,3080715,287,-4,2017-04-25
Arun Valley Hydropower Development Co. Ltd.,45,293,279,292,12747,3637430,283,9,2017-04-26
Arun Valley Hydropower Development Co. Ltd.,57,297,279,290,37296,10681554,292,-2,2017-04-27
Arun Valley Hydropower Development Co. Ltd.,32,295,276,290,14105,3989365,290,0,2017-04-30
Arun Valley Hydropower Development Co. Ltd.,42,290,275,275,14592,4119452,290,-15,2017-05-02
Arun Valley Hydropower Development Co. Ltd.,16,285,278,282,3195,897094,275,7,2017-05-03
Arun Valley Hydropower Development Co. Ltd.,14,280,276,277,3005,833880,282,-5,2017-05-04
Arun Valley Hydropower Development Co. Ltd.,16,279,266,270,1957,535684,277,-7,2017-05-07
Arun Valley Hydropower Development Co. Ltd.,37,286,265,275,8621,2379264,270,5,2017-05-08
Arun Valley Hydropower Development Co. Ltd.,46,294,270,285,19785,5573857,275,10,2017-05-09
Arun Valley Hydropower Development Co. Ltd.,253,310,288,308,92535,27815814,285,23,2017-05-11
Arun Valley Hydropower Development Co. Ltd.,139,318,294,302,78557,23668553,308,-6,2017-05-15
Arun Valley Hydropower Development Co. Ltd.,53,306,296,306,16506,4946728,302,4,2017-05-16
Arun Valley Hydropower Development Co. Ltd.,38,305,297,303,11239,3381222,306,-3,2017-05-17
Arun Valley Hydropower Development Co. Ltd.,37,300,293,299,11537,3413699,303,-4,2017-05-18
Arun Valley Hydropower Development Co. Ltd.,37,294,287,289,17037,4935702,299,-10,2017-05-21
Arun Valley Hydropower Development Co. Ltd.,33,299,286,286,4678,1351377,289,-3,2017-05-22
Arun Valley Hydropower Development Co. Ltd.,24,301,285,287,6478,1902454,286,1,2017-05-23
Arun Valley Hydropower Development Co. Ltd.,42,296,283,285,10074,2891049,287,-2,2017-05-24
Arun Valley Hydropower Development Co. Ltd.,22,288,281,282,4553,1291555,285,-3,2017-05-28
Arun Valley Hydropower Development Co. Ltd.,24,282,275,280,7659,2130341,282,-2,2017-05-30
Arun Valley Hydropower Development Co. Ltd.,28,290,276,290,6640,1852515,280,10,2017-05-31
Arun Valley Hydropower Development Co. Ltd.,29,289,279,280,7130,2007940,290,-10,2017-06-01
Arun Valley Hydropower Development Co. Ltd.,16,280,275,276,8708,2429374,280,-4,2017-06-04
Arun Valley Hydropower Development Co. Ltd.,19,280,277,280,13395,3746560,276,4,2017-06-05
Arun Valley Hydropower Development Co. Ltd.,20,287,277,282,5469,1537166,280,2,2017-06-06
Arun Valley Hydropower Development Co. Ltd.,18,287,277,278,3225,898872,282,-4,2017-06-07
Arun Valley Hydropower Development Co. Ltd.,35,277,274,275,8514,2344954,278,-3,2017-06-08
Arun Valley Hydropower Development Co. Ltd.,19,276,270,274,4800,1299658,275,-1,2017-06-11
Arun Valley Hydropower Development Co. Ltd.,21,276,264,264,5020,1344170,274,-10,2017-06-12
Arun Valley Hydropower Development Co. Ltd.,17,273,264,270,1890,507708,264,6,2017-06-13
Arun Valley Hydropower Development Co. Ltd.,9,284,266,284,2319,628967,270,14,2017-06-14
Arun Valley Hydropower Development Co. Ltd.,9,283,275,280,1132,317276,284,-4,2017-06-15
Arun Valley Hydropower Development Co. Ltd.,2,275,270,270,109,29480,280,-10,2017-06-18
Arun Valley Hydropower Development Co. Ltd.,15,275,265,270,2637,703751,270,0,2017-06-19
Arun Valley Hydropower Development Co. Ltd.,18,270,260,267,4312,1129819,270,-3,2017-06-20
Arun Valley Hydropower Development Co. Ltd.,8,270,265,265,854,228158,267,-2,2017-06-21
Arun Valley Hydropower Development Co. Ltd.,31,272,261,265,8865,2344874,265,0,2017-06-22
Arun Valley Hydropower Development Co. Ltd.,22,267,260,267,5824,1533351,265,2,2017-06-25
Arun Valley Hydropower Development Co. Ltd.,18,268,262,268,4715,1242696,267,1,2017-06-27
Arun Valley Hydropower Development Co. Ltd.,9,268,262,268,2666,702794,268,0,2017-06-28
Arun Valley Hydropower Development Co. Ltd.,24,265,258,263,3841,1002855,268,-5,2017-07-02
Arun Valley Hydropower Development Co. Ltd.,23,270,262,270,4820,1272857,263,7,2017-07-03
Arun Valley Hydropower Development Co. Ltd.,18,267,260,263,15104,3979034,270,-7,2017-07-04
Arun Valley Hydropower Development Co. Ltd.,20,270,258,270,3728,972449,263,7,2017-07-05
Arun Valley Hydropower Development Co. Ltd.,23,290,268,290,5233,1435371,270,20,2017-07-06
Arun Valley Hydropower Development Co. Ltd.,122,300,270,287,93320,26968513,290,-3,2017-07-09
Arun Valley Hydropower Development Co. Ltd.,25,292,280,280,15172,4293973,287,-7,2017-07-10
Arun Valley Hydropower Development Co. Ltd.,23,289,280,281,6088,1729662,280,1,2017-07-11
Arun Valley Hydropower Development Co. Ltd.,32,285,276,278,3725,1043489,281,-3,2017-07-12
Arun Valley Hydropower Development Co. Ltd.,27,280,276,276,7140,1980770,278,-2,2017-07-13
Arun Valley Hydropower Development Co. Ltd.,26,281,271,276,2554,702600,276,0,2017-07-16
Arun Valley Hydropower Development Co. Ltd.,33,284,270,284,8159,2238220,276,8,2017-07-17
Arun Valley Hydropower Development Co. Ltd.,17,285,279,284,5756,1620163,284,0,2017-07-18
Arun Valley Hydropower Development Co. Ltd.,24,280,270,274,8389,2296430,275,-1,2017-08-03
Arun Valley Hydropower Development Co. Ltd.,26,283,274,280,6581,1844672,284,-4,2017-07-19
Arun Valley Hydropower Development Co. Ltd.,25,283,272,272,3011,834704,280,-8,2017-07-20
Arun Valley Hydropower Development Co. Ltd.,18,274,270,270,3662,995053,272,-2,2017-07-23
Arun Valley Hydropower Development Co. Ltd.,38,278,266,266,12289,3308400,270,-4,2017-07-24
Arun Valley Hydropower Development Co. Ltd.,36,285,266,276,6911,1912279,266,10,2017-07-25
Arun Valley Hydropower Development Co. Ltd.,24,281,272,272,6739,1843583,276,-4,2017-07-26
Arun Valley Hydropower Development Co. Ltd.,22,275,270,270,5457,1484450,272,-2,2017-07-27
Arun Valley Hydropower Development Co. Ltd.,26,275,265,267,3718,998028,270,-3,2017-07-30
Arun Valley Hydropower Development Co. Ltd.,29,282,267,277,5952,1618976,267,10,2017-07-31
Arun Valley Hydropower Development Co. Ltd.,27,278,272,272,11369,3111952,277,-5,2017-08-01
Arun Valley Hydropower Development Co. Ltd.,35,283,270,275,12419,3408837,272,3,2017-08-02
Arun Valley Hydropower Development Co. Ltd.,19,277,270,272,3610,981129,274,-2,2017-08-06
Arun Valley Hydropower Development Co. Ltd.,34,275,267,270,10952,2944776,272,-2,2017-08-07
Arun Valley Hydropower Development Co. Ltd.,22,270,266,268,6547,1757116,270,-2,2017-08-09
Arun Valley Hydropower Development Co. Ltd.,33,273,266,267,13978,3757682,268,-1,2017-08-10
Arun Valley Hydropower Development Co. Ltd.,23,270,262,262,6478,1720478,267,-5,2017-08-13
Arun Valley Hydropower Development Co. Ltd.,14,268,257,268,4415,1169625,262,6,2017-08-15
Arun Valley Hydropower Development Co. Ltd.,19,278,263,265,4647,1234581,268,-3,2017-08-16
Arun Valley Hydropower Development Co. Ltd.,36,270,265,268,9752,2601307,265,3,2017-08-17
Arun Valley Hydropower Development Co. Ltd.,32,268,260,261,12534,3298378,268,-7,2017-08-20
Arun Valley Hydropower Development Co. Ltd.,13,268,257,268,1642,432125,261,7,2017-08-21
Arun Valley Hydropower Development Co. Ltd.,18,267,260,262,3721,984576,268,-6,2017-08-22
Arun Valley Hydropower Development Co. Ltd.,49,268,255,260,14855,3857740,262,-2,2017-08-23
Arun Valley Hydropower Development Co. Ltd.,86,268,260,268,34706,9182410,260,8,2017-08-24
Arun Valley Hydropower Development Co. Ltd.,18,244,236,240,2371,565192,244,-4,2017-08-27
Arun Valley Hydropower Development Co. Ltd.,18,237,231,235,2015,472028,240,-5,2017-08-28
Arun Valley Hydropower Development Co. Ltd.,28,235,225,229,13888,3171893,235,-6,2017-08-30
Arun Valley Hydropower Development Co. Ltd.,21,231,219,224,7816,1725941,229,-5,2017-08-31
Arun Valley Hydropower Development Co. Ltd.,34,220,212,213,8226,1770396,224,-11,2017-09-04
Arun Valley Hydropower Development Co. Ltd.,28,223,211,223,3339,711943,213,10,2017-09-06
Arun Valley Hydropower Development Co. Ltd.,17,225,211,211,6054,1319432,223,-12,2017-09-07
Arun Valley Hydropower Development Co. Ltd.,19,215,207,215,3622,759198,211,4,2017-09-10
Arun Valley Hydropower Development Co. Ltd.,8,215,212,213,3149,673638,215,-2,2017-09-11
Arun Valley Hydropower Development Co. Ltd.,3,215,212,214,812,172300,213,1,2017-09-12
Arun Valley Hydropower Development Co. Ltd.,30,214,206,214,8928,1867469,214,0,2017-09-13
Arun Valley Hydropower Development Co. Ltd.,11,215,210,213,4080,870080,214,-1,2017-09-14
Arun Valley Hydropower Development Co. Ltd.,22,218,209,215,3943,834795,213,2,2017-09-17
Arun Valley Hydropower Development Co. Ltd.,15,218,210,211,2597,550140,215,-4,2017-09-18
Arun Valley Hydropower Development Co. Ltd.,21,220,210,220,4735,1006450,211,9,2017-09-20
Arun Valley Hydropower Development Co. Ltd.,10,218,210,218,1430,309000,214,4,2017-10-09
Arun Valley Hydropower Development Co. Ltd.,16,220,212,218,1500,321600,220,-2,2017-09-24
Arun Valley Hydropower Development Co. Ltd.,15,219,215,219,4205,912128,218,1,2017-09-25
Arun Valley Hydropower Development Co. Ltd.,1,220,220,220,50,11000,219,1,2017-09-26
Arun Valley Hydropower Development Co. Ltd.,2,220,218,218,70,15300,220,-2,2017-10-04
Arun Valley Hydropower Development Co. Ltd.,4,218,214,214,229,49334,218,-4,2017-10-08
Arun Valley Hydropower Development Co. Ltd.,7,218,211,211,1578,333897,218,-7,2017-10-10
Arun Valley Hydropower Development Co. Ltd.,30,214,205,210,7501,1566955,211,-1,2017-10-11
Arun Valley Hydropower Development Co. Ltd.,13,211,209,210,11215,2356104,210,0,2017-10-12
Arun Valley Hydropower Development Co. Ltd.,9,212,206,210,1985,414990,210,0,2017-10-15
Arun Valley Hydropower Development Co. Ltd.,14,218,212,216,3770,810580,210,6,2017-10-16
Arun Valley Hydropower Development Co. Ltd.,6,220,216,216,526,114054,216,0,2017-10-17
Arun Valley Hydropower Development Co. Ltd.,5,217,216,217,550,119330,216,1,2017-10-18
Arun Valley Hydropower Development Co. Ltd.,10,219,214,217,1121,241743,217,0,2017-10-22
Arun Valley Hydropower Development Co. Ltd.,8,219,214,219,467,100650,217,2,2017-10-23
Arun Valley Hydropower Development Co. Ltd.,4,215,214,215,915,196675,219,-4,2017-10-24
Arun Valley Hydropower Development Co. Ltd.,19,216,212,216,4427,949665,215,1,2017-10-25
Arun Valley Hydropower Development Co. Ltd.,7,215,212,214,587,125138,216,-2,2017-10-29
Arun Valley Hydropower Development Co. Ltd.,16,214,210,212,3700,784852,214,-2,2017-10-30
Arun Valley Hydropower Development Co. Ltd.,10,212,211,212,1344,283699,212,0,2017-10-31
Arun Valley Hydropower Development Co. Ltd.,14,212,207,211,9509,1987353,212,-1,2017-11-01
Arun Valley Hydropower Development Co. Ltd.,21,210,207,210,13991,2908137,211,-1,2017-11-02
Arun Valley Hydropower Development Co. Ltd.,13,209,204,208,3579,737532,210,-2,2017-11-05
Arun Valley Hydropower Development Co. Ltd.,21,212,205,211,4527,932307,208,3,2017-11-06
Arun Valley Hydropower Development Co. Ltd.,11,210,203,205,2625,535295,211,-6,2017-11-07
Arun Valley Hydropower Development Co. Ltd.,23,208,200,204,8854,1780754,205,-1,2017-11-08
Arun Valley Hydropower Development Co. Ltd.,9,210,198,206,598,121754,204,2,2017-11-09
Arun Valley Hydropower Development Co. Ltd.,19,208,197,208,4680,944691,206,2,2017-11-12
Arun Valley Hydropower Development Co. Ltd.,14,214,208,214,1970,414419,208,6,2017-11-13
Arun Valley Hydropower Development Co. Ltd.,14,214,207,211,5632,1180346,214,-3,2017-11-14
Arun Valley Hydropower Development Co. Ltd.,11,211,206,206,3790,782193,211,-5,2017-11-15
Arun Valley Hydropower Development Co. Ltd.,19,208,202,207,3667,752411,206,1,2017-11-16
Arun Valley Hydropower Development Co. Ltd.,12,207,203,204,4581,934753,207,-3,2017-11-19
Arun Valley Hydropower Development Co. Ltd.,19,206,199,200,5960,1196293,204,-4,2017-11-20
Arun Valley Hydropower Development Co. Ltd.,23,206,200,206,6819,1370162,200,6,2017-11-21
Arun Valley Hydropower Development Co. Ltd.,11,207,203,206,746,152713,206,0,2017-11-22
Arun Valley Hydropower Development Co. Ltd.,17,208,202,206,1480,303028,206,0,2017-11-23
Arun Valley Hydropower Development Co. Ltd.,28,209,201,209,5776,1177906,206,3,2017-11-26
Arun Valley Hydropower Development Co. Ltd.,16,206,201,206,4938,1000244,209,-3,2017-11-27
Arun Valley Hydropower Development Co. Ltd.,16,209,202,209,4515,935416,206,3,2017-11-28
Arun Valley Hydropower Development Co. Ltd.,80,215,207,212,42888,9037112,209,3,2017-11-29
Arun Valley Hydropower Development Co. Ltd.,30,211,206,210,21257,4422213,212,-2,2017-11-30
Arun Valley Hydropower Development Co. Ltd.,40,216,205,210,15783,3318787,210,0,2017-12-04
Arun Valley Hydropower Development Co. Ltd.,16,210,207,210,7275,1522448,209,1,2017-12-20
Arun Valley Hydropower Development Co. Ltd.,13,212,207,211,3545,745010,210,1,2017-12-05
Arun Valley Hydropower Development Co. Ltd.,37,215,208,212,10239,2177831,211,1,2017-12-06
Arun Valley Hydropower Development Co. Ltd.,26,215,210,214,19266,4098460,212,2,2017-12-10
Arun Valley Hydropower Development Co. Ltd.,32,216,210,216,15799,3370716,214,2,2017-12-11
Arun Valley Hydropower Development Co. Ltd.,22,214,212,214,15440,3285895,216,-2,2017-12-12
Arun Valley Hydropower Development Co. Ltd.,32,216,208,215,14412,3087333,214,1,2017-12-13
Arun Valley Hydropower Development Co. Ltd.,20,217,211,217,5944,1270169,215,2,2017-12-14
Arun Valley Hydropower Development Co. Ltd.,16,217,210,210,8799,1863109,217,-7,2017-12-17
Arun Valley Hydropower Development Co. Ltd.,18,214,209,213,5983,1259610,210,3,2017-12-18
Arun Valley Hydropower Development Co. Ltd.,22,212,209,209,11430,2399903,213,-4,2017-12-19
Arun Valley Hydropower Development Co. Ltd.,13,210,208,208,2942,614456,210,-2,2017-12-21
Arun Valley Hydropower Development Co. Ltd.,17,210,207,207,7517,1559734,208,-1,2017-12-24
Arun Valley Hydropower Development Co. Ltd.,16,208,204,207,2628,540758,207,0,2017-12-26
Arun Valley Hydropower Development Co. Ltd.,14,207,203,203,5829,1190007,207,-4,2017-12-27
Arun Valley Hydropower Development Co. Ltd.,20,205,200,204,5969,1216849,203,1,2017-12-28
Arun Valley Hydropower Development Co. Ltd.,20,203,200,202,7169,1443913,204,-2,2017-12-31
Arun Valley Hydropower Development Co. Ltd.,15,206,202,206,5270,1073364,202,4,2018-01-01
Arun Valley Hydropower Development Co. Ltd.,9,206,203,206,2150,440210,206,0,2018-01-02
Arun Valley Hydropower Development Co. Ltd.,20,205,202,205,4363,885835,206,-1,2018-01-03
Arun Valley Hydropower Development Co. Ltd.,16,205,202,205,3085,624870,205,0,2018-01-04
Arun Valley Hydropower Development Co. Ltd.,14,203,201,203,3448,695377,205,-2,2018-01-07
Arun Valley Hydropower Development Co. Ltd.,21,204,200,204,4451,899728,203,1,2018-01-08
Arun Valley Hydropower Development Co. Ltd.,20,204,201,203,5804,1169077,204,-1,2018-01-09
Arun Valley Hydropower Development Co. Ltd.,15,204,200,204,4356,872220,203,1,2018-01-10
Arun Valley Hydropower Development Co. Ltd.,12,201,199,201,3458,689980,204,-3,2018-01-14
Arun Valley Hydropower Development Co. Ltd.,16,201,198,200,4347,866756,201,-1,2018-01-16
Arun Valley Hydropower Development Co. Ltd.,10,200,200,200,2453,490600,200,0,2018-01-17
Arun Valley Hydropower Development Co. Ltd.,22,200,197,199,4811,952307,200,-1,2018-01-21
Arun Valley Hydropower Development Co. Ltd.,17,200,196,200,3173,628877,199,1,2018-01-22
Arun Valley Hydropower Development Co. Ltd.,31,204,196,204,4363,859262,200,4,2018-01-23
Arun Valley Hydropower Development Co. Ltd.,7,201,197,198,3638,719282,204,-6,2018-01-24
Arun Valley Hydropower Development Co. Ltd.,4,199,197,199,3126,616313,198,1,2018-01-25
Arun Valley Hydropower Development Co. Ltd.,11,200,196,197,1256,247807,199,-2,2018-01-28
Arun Valley Hydropower Development Co. Ltd.,23,203,196,201,4686,929564,197,4,2018-01-29
Arun Valley Hydropower Development Co. Ltd.,21,199,195,198,6490,1272612,201,-3,2018-01-31
Arun Valley Hydropower Development Co. Ltd.,18,200,196,199,4081,803578,198,1,2018-02-01
Arun Valley Hydropower Development Co. Ltd.,16,200,194,200,8868,1729948,199,1,2018-02-04
Arun Valley Hydropower Development Co. Ltd.,13,200,195,200,3006,587672,200,0,2018-02-05
Arun Valley Hydropower Development Co. Ltd.,26,200,190,198,5670,1094028,200,-2,2018-02-06
Arun Valley Hydropower Development Co. Ltd.,16,197,191,197,4406,846925,198,-1,2018-02-07
Arun Valley Hydropower Development Co. Ltd.,5,199,196,197,358,70267,197,0,2018-02-08
Arun Valley Hydropower Development Co. Ltd.,26,195,189,192,5262,1003200,196,-4,2018-02-25
Arun Valley Hydropower Development Co. Ltd.,48,194,187,191,11647,2206960,197,-6,2018-02-11
Arun Valley Hydropower Development Co. Ltd.,40,189,183,184,10517,1962269,191,-7,2018-02-12
Arun Valley Hydropower Development Co. Ltd.,21,189,186,189,9211,1723437,184,5,2018-02-14
Arun Valley Hydropower Development Co. Ltd.,31,200,186,200,4132,802905,189,11,2018-02-15
Arun Valley Hydropower Development Co. Ltd.,20,200,190,190,4731,928910,200,-10,2018-02-18
Arun Valley Hydropower Development Co. Ltd.,133,209,193,199,31378,6349075,190,9,2018-02-20
Arun Valley Hydropower Development Co. Ltd.,43,200,193,195,9353,1833091,199,-4,2018-02-21
Arun Valley Hydropower Development Co. Ltd.,17,196,192,196,4416,854816,195,1,2018-02-22
Arun Valley Hydropower Development Co. Ltd.,50,195,184,184,11515,2133562,192,-8,2018-02-26
Arun Valley Hydropower Development Co. Ltd.,31,193,181,184,5150,959686,184,0,2018-02-27
Arun Valley Hydropower Development Co. Ltd.,35,186,180,185,8598,1566693,184,1,2018-02-28
Arun Valley Hydropower Development Co. Ltd.,21,182,170,172,5231,908223,185,-13,2018-03-04
Arun Valley Hydropower Development Co. Ltd.,58,179,169,169,8919,1528677,172,-3,2018-03-05
Arun Valley Hydropower Development Co. Ltd.,36,175,164,175,6658,1124094,169,6,2018-03-06
Arun Valley Hydropower Development Co. Ltd.,26,180,173,178,2982,526812,175,3,2018-03-07
Arun Valley Hydropower Development Co. Ltd.,21,175,170,174,4602,790223,178,-4,2018-03-11
Arun Valley Hydropower Development Co. Ltd.,5,174,172,174,674,116128,174,0,2018-03-12
Arun Valley Hydropower Development Co. Ltd.,10,172,170,172,3714,637775,174,-2,2018-03-13
Arun Valley Hydropower Development Co. Ltd.,4,174,174,174,251,43674,172,2,2018-03-14
Arun Valley Hydropower Development Co. Ltd.,19,177,171,171,8848,1538303,174,-3,2018-03-15
Arun Valley Hydropower Development Co. Ltd.,17,173,168,170,4322,731302,171,-1,2018-03-18
Arun Valley Hydropower Development Co. Ltd.,9,173,169,172,1532,261472,170,2,2018-03-19
Arun Valley Hydropower Development Co. Ltd.,39,169,163,163,12334,2037188,172,-9,2018-03-20
Arun Valley Hydropower Development Co. Ltd.,38,162,155,162,12760,2009588,163,-1,2018-03-21
Arun Valley Hydropower Development Co. Ltd.,26,165,156,160,7328,1170408,162,-2,2018-03-22
Arun Valley Hydropower Development Co. Ltd.,37,157,147,150,7149,1079337,160,-10,2018-03-26
Arun Valley Hydropower Development Co. Ltd.,30,161,147,161,8348,1260261,150,11,2018-03-27
Arun Valley Hydropower Development Co. Ltd.,19,160,154,154,3656,569739,161,-7,2018-03-28
Arun Valley Hydropower Development Co. Ltd.,13,160,155,157,910,142261,154,3,2018-03-29
Arun Valley Hydropower Development Co. Ltd.,22,158,153,158,4244,657224,157,1,2018-04-01
Arun Valley Hydropower Development Co. Ltd.,6,155,153,155,1815,279935,158,-3,2018-04-02
Arun Valley Hydropower Development Co. Ltd.,69,152,147,147,22685,3374975,155,-8,2018-04-03
Arun Valley Hydropower Development Co. Ltd.,59,158,147,158,25792,3843344,147,11,2018-04-04
Arun Valley Hydropower Development Co. Ltd.,61,161,149,159,16913,2622245,158,1,2018-04-05
Arun Valley Hydropower Development Co. Ltd.,143,174,159,174,41891,7141690,159,15,2018-04-08
Arun Valley Hydropower Development Co. Ltd.,69,186,167,167,15518,2701488,174,-7,2018-04-09
Arun Valley Hydropower Development Co. Ltd.,57,169,160,168,34206,5579817,167,1,2018-04-10
Arun Valley Hydropower Development Co. Ltd.,36,169,159,167,15954,2559118,168,-1,2018-04-11
Arun Valley Hydropower Development Co. Ltd.,30,169,165,168,22339,3718425,167,1,2018-04-12
Arun Valley Hydropower Development Co. Ltd.,18,170,160,168,4516,754211,168,0,2018-04-15
Arun Valley Hydropower Development Co. Ltd.,29,174,166,174,48132,8217600,168,6,2018-04-16
Arun Valley Hydropower Development Co. Ltd.,48,185,168,178,15313,2696243,174,4,2018-04-17
Arun Valley Hydropower Development Co. Ltd.,84,190,172,186,39437,7337873,178,8,2018-04-18
Arun Valley Hydropower Development Co. Ltd.,73,192,180,192,37644,6974326,186,6,2018-04-19
Arun Valley Hydropower Development Co. Ltd.,114,197,189,196,50278,9633358,192,4,2018-04-22
Arun Valley Hydropower Development Co. Ltd.,94,202,186,186,36818,7082922,196,-10,2018-04-23
Arun Valley Hydropower Development Co. Ltd.,35,189,183,189,7344,1363247,186,3,2018-04-24
Arun Valley Hydropower Development Co. Ltd.,21,186,180,186,14988,2715171,189,-3,2018-04-25
Arun Valley Hydropower Development Co. Ltd.,43,188,176,185,10501,1890826,186,-1,2018-04-26
Arun Valley Hydropower Development Co. Ltd.,8,185,180,183,942,170390,185,-2,2018-04-29
Arun Valley Hydropower Development Co. Ltd.,12,182,177,182,3714,665009,183,-1,2018-05-02
Arun Valley Hydropower Development Co. Ltd.,34,185,179,183,7193,1307321,182,1,2018-05-03
Arun Valley Hydropower Development Co. Ltd.,22,182,177,180,3971,705000,183,-3,2018-05-06
Arun Valley Hydropower Development Co. Ltd.,17,179,174,176,3148,550202,180,-4,2018-05-07
Arun Valley Hydropower Development Co. Ltd.,28,179,171,174,7524,1305506,176,-2,2018-05-08
Arun Valley Hydropower Development Co. Ltd.,20,177,167,171,14604,2531554,174,-3,2018-05-09
Arun Valley Hydropower Development Co. Ltd.,25,176,168,176,6625,1143587,171,5,2018-05-10
Arun Valley Hydropower Development Co. Ltd.,35,179,169,169,5772,983347,176,-7,2018-05-14
Arun Valley Hydropower Development Co. Ltd.,2,172,170,172,80,13628,169,3,2018-05-15
Arun Valley Hydropower Development Co. Ltd.,33,171,166,170,15848,2680518,172,-2,2018-05-16
Arun Valley Hydropower Development Co. Ltd.,34,173,168,172,24103,4059201,170,2,2018-05-17
Arun Valley Hydropower Development Co. Ltd.,20,175,168,169,5758,973664,172,-3,2018-05-20
Arun Valley Hydropower Development Co. Ltd.,22,170,166,169,5952,994635,169,0,2018-05-21
Arun Valley Hydropower Development Co. Ltd.,38,170,164,169,9200,1521339,169,0,2018-05-22
Asian Life Insurance Co. Limited,24,1500,1477,1491,4264,6329896,1490,1,2016-05-23
Asian Life Insurance Co. Limited,29,1500,1470,1480,6737,10017480,1491,-11,2016-05-24
Asian Life Insurance Co. Limited,31,1500,1460,1460,5313,7852884,1480,-20,2016-05-25
Asian Life Insurance Co. Limited,16,1475,1412,1470,2250,3266243,1460,10,2016-05-26
Asian Life Insurance Co. Limited,19,1477,1460,1460,4736,6955158,1470,-10,2016-05-29
Asian Life Insurance Co. Limited,38,1484,1453,1478,8201,11994288,1460,18,2016-05-30
Asian Life Insurance Co. Limited,29,1490,1470,1470,7004,10339705,1478,-8,2016-05-31
Asian Life Insurance Co. Limited,22,1475,1460,1465,3566,5237994,1470,-5,2016-06-01
Asian Life Insurance Co. Limited,15,1465,1440,1444,2162,3121255,1465,-21,2016-06-02
Asian Life Insurance Co. Limited,27,1435,1400,1400,4786,6716692,1444,-44,2016-06-05
Asian Life Insurance Co. Limited,8,1428,1407,1410,575,814345,1400,10,2016-06-06
Asian Life Insurance Co. Limited,18,1448,1412,1434,4480,6418070,1410,24,2016-06-07
Asian Life Insurance Co. Limited,188,1989,1880,1880,31702,61252329,1880,0,2016-06-23
Asian Life Insurance Co. Limited,25,1485,1440,1485,8101,11922413,1434,51,2016-06-08
Asian Life Insurance Co. Limited,96,1610,1470,1575,21723,33148695,1485,90,2016-06-09
Asian Life Insurance Co. Limited,69,1600,1515,1551,17744,27980743,1575,-24,2016-06-12
Asian Life Insurance Co. Limited,63,1585,1525,1585,24210,37665887,1551,34,2016-06-13
Asian Life Insurance Co. Limited,95,1645,1590,1635,26431,42638068,1585,50,2016-06-14
Asian Life Insurance Co. Limited,156,1755,1667,1745,32064,54845457,1635,110,2016-06-15
Asian Life Insurance Co. Limited,192,1919,1779,1870,39483,73846350,1745,125,2016-06-16
Asian Life Insurance Co. Limited,128,1900,1740,1790,28046,51136409,1870,-80,2016-06-19
Asian Life Insurance Co. Limited,64,1805,1700,1733,9451,16513139,1790,-57,2016-06-20
Asian Life Insurance Co. Limited,41,1775,1745,1770,6139,10820643,1733,37,2016-06-21
Asian Life Insurance Co. Limited,101,1892,1770,1880,28042,51172388,1770,110,2016-06-22
Asian Life Insurance Co. Limited,52,1885,1845,1850,8974,16735577,1880,-30,2016-06-26
Asian Life Insurance Co. Limited,60,1860,1790,1790,10132,18522116,1850,-60,2016-06-27
Asian Life Insurance Co. Limited,60,1850,1760,1816,12863,23127474,1790,26,2016-06-28
Asian Life Insurance Co. Limited,43,1880,1820,1820,7227,13265806,1816,4,2016-06-29
Asian Life Insurance Co. Limited,24,1837,1821,1822,2998,5483396,1820,2,2016-06-30
Asian Life Insurance Co. Limited,34,1820,1770,1770,8371,14969000,1822,-52,2016-07-03
Asian Life Insurance Co. Limited,27,1790,1751,1790,8086,14280610,1770,20,2016-07-04
Asian Life Insurance Co. Limited,20,1790,1745,1790,4305,7570011,1790,0,2016-07-05
Asian Life Insurance Co. Limited,41,1790,1750,1750,7831,13857758,1790,-40,2016-07-06
Asian Life Insurance Co. Limited,43,1780,1735,1758,8742,15289979,1750,8,2016-07-10
Asian Life Insurance Co. Limited,29,1740,1715,1720,4437,7656355,1758,-38,2016-07-11
Asian Life Insurance Co. Limited,29,1730,1641,1695,4506,7635940,1720,-25,2016-07-12
Asian Life Insurance Co. Limited,25,1700,1653,1700,3960,6630186,1695,5,2016-07-13
Asian Life Insurance Co. Limited,20,1750,1700,1710,4467,7687821,1700,10,2016-07-14
Asian Life Insurance Co. Limited,28,1754,1657,1715,7656,13092066,1710,5,2016-07-17
Asian Life Insurance Co. Limited,44,1886,1715,1886,7605,14059544,1715,171,2016-07-18
Asian Life Insurance Co. Limited,27,1930,1785,1800,7339,13333816,1886,-86,2016-07-19
Asian Life Insurance Co. Limited,52,1830,1800,1815,12992,23455301,1800,15,2016-07-20
Asian Life Insurance Co. Limited,33,1830,1790,1812,4188,7604710,1815,-3,2016-07-21
Asian Life Insurance Co. Limited,40,1855,1810,1836,19383,35367253,1812,24,2016-07-25
Asian Life Insurance Co. Limited,39,1870,1840,1860,5801,10776609,1836,24,2016-07-26
Asian Life Insurance Co. Limited,47,1890,1821,1840,9745,18164696,1860,-20,2016-07-27
Asian Life Insurance Co. Limited,42,1880,1815,1871,5123,9529242,1840,31,2016-07-28
Asian Life Insurance Co. Limited,40,1881,1844,1850,12028,22411139,1871,-21,2016-07-31
Asian Life Insurance Co. Limited,42,1880,1830,1870,9300,17237394,1850,20,2016-08-01
Asian Life Insurance Co. Limited,52,1880,1841,1860,9599,17896460,1870,-10,2016-08-02
Asian Life Insurance Co. Limited,45,1874,1803,1837,14180,26188066,1860,-23,2016-08-03
Asian Life Insurance Co. Limited,44,1835,1750,1770,6954,12520560,1837,-67,2016-08-04
Asian Life Insurance Co. Limited,31,1815,1753,1756,5026,8942760,1770,-14,2016-08-07
Asian Life Insurance Co. Limited,26,1726,1665,1665,3979,6753044,1756,-91,2016-08-08
Asian Life Insurance Co. Limited,3,1731,1698,1731,630,1090200,1665,66,2016-08-09
Asian Life Insurance Co. Limited,50,1836,1696,1760,8352,14790668,1731,29,2016-08-10
Asian Life Insurance Co. Limited,26,1770,1750,1764,3643,6394106,1760,4,2016-08-11
Asian Life Insurance Co. Limited,21,1735,1699,1700,3154,5385522,1764,-64,2016-08-14
Asian Life Insurance Co. Limited,31,1666,1601,1630,3971,6495437,1700,-70,2016-08-15
Asian Life Insurance Co. Limited,10,1749,1721,1721,1326,2294830,1740,-19,2016-08-31
Asian Life Insurance Co. Limited,22,1695,1595,1695,4907,7883961,1630,65,2016-08-16
Asian Life Insurance Co. Limited,21,1728,1690,1707,3077,5255802,1695,12,2016-08-17
Asian Life Insurance Co. Limited,8,1725,1650,1650,1173,1963103,1707,-57,2016-08-21
Asian Life Insurance Co. Limited,26,1650,1595,1595,3424,5538892,1650,-55,2016-08-22
Asian Life Insurance Co. Limited,28,1639,1588,1605,3078,4930431,1595,10,2016-08-23
Asian Life Insurance Co. Limited,40,1765,1637,1764,5654,9830135,1605,159,2016-08-24
Asian Life Insurance Co. Limited,29,1799,1730,1746,3103,5450410,1764,-18,2016-08-28
Asian Life Insurance Co. Limited,13,1780,1730,1745,1984,3459985,1746,-1,2016-08-29
Asian Life Insurance Co. Limited,14,1750,1711,1740,2183,3797686,1745,-5,2016-08-30
Asian Life Insurance Co. Limited,8,1730,1711,1711,1850,3186888,1721,-10,2016-09-01
Asian Life Insurance Co. Limited,9,1730,1710,1730,1593,2733154,1711,19,2016-09-04
Asian Life Insurance Co. Limited,9,1725,1700,1725,3044,5209082,1730,-5,2016-09-05
Asian Life Insurance Co. Limited,27,1730,1705,1725,4382,7547359,1725,0,2016-09-06
Asian Life Insurance Co. Limited,11,1735,1720,1720,3006,5178635,1725,-5,2016-09-07
Asian Life Insurance Co. Limited,17,1775,1720,1775,2847,4949135,1720,55,2016-09-08
Asian Life Insurance Co. Limited,27,1810,1775,1775,5224,9337882,1775,0,2016-09-11
Asian Life Insurance Co. Limited,37,1805,1772,1799,5974,10716436,1775,24,2016-09-12
Asian Life Insurance Co. Limited,34,1820,1785,1805,5648,10151057,1799,6,2016-09-14
Asian Life Insurance Co. Limited,25,1805,1735,1795,3226,5701959,1805,-10,2016-09-18
Asian Life Insurance Co. Limited,1,1790,1790,1790,100,179000,1795,-5,2016-09-20
Asian Life Insurance Co. Limited,14,1790,1736,1745,3269,5724365,1790,-45,2016-09-21
Asian Life Insurance Co. Limited,20,1750,1725,1745,2752,4791677,1745,0,2016-09-22
Asian Life Insurance Co. Limited,10,1745,1685,1700,1508,2567592,1745,-45,2016-09-25
Asian Life Insurance Co. Limited,24,1730,1690,1730,6243,10677910,1700,30,2016-09-26
Asian Life Insurance Co. Limited,8,1745,1705,1730,934,1624967,1730,0,2016-09-27
Asian Life Insurance Co. Limited,5,1720,1707,1720,348,597003,1730,-10,2016-09-28
Asian Life Insurance Co. Limited,10,1720,1712,1715,995,1708095,1720,-5,2016-09-29
Asian Life Insurance Co. Limited,4,1720,1700,1720,655,1122817,1715,5,2016-10-02
Asian Life Insurance Co. Limited,9,1740,1706,1726,1473,2544258,1720,6,2016-10-03
Asian Life Insurance Co. Limited,14,1765,1750,1765,3684,6468510,1726,39,2016-10-04
Asian Life Insurance Co. Limited,2,1755,1750,1755,155,271525,1765,-10,2016-10-05
Asian Life Insurance Co. Limited,10,1775,1755,1763,549,971380,1755,8,2016-10-06
Asian Life Insurance Co. Limited,2,1779,1755,1779,157,277935,1763,16,2016-10-16
Asian Life Insurance Co. Limited,20,1750,1725,1736,4174,7234877,1779,-43,2016-10-17
Asian Life Insurance Co. Limited,9,1759,1715,1759,1943,3372562,1736,23,2016-10-18
Asian Life Insurance Co. Limited,10,1742,1730,1731,1469,2550583,1759,-28,2016-10-19
Asian Life Insurance Co. Limited,18,1750,1730,1740,2392,4158497,1731,9,2016-10-20
Asian Life Insurance Co. Limited,3,1760,1739,1740,169,296021,1740,0,2016-10-23
Asian Life Insurance Co. Limited,13,1740,1720,1740,1323,2287270,1740,0,2016-10-24
Asian Life Insurance Co. Limited,10,1744,1712,1740,945,1643207,1740,0,2016-10-25
Asian Life Insurance Co. Limited,13,1740,1715,1740,3416,5884210,1740,0,2016-10-26
Asian Life Insurance Co. Limited,3,1720,1712,1712,272,466536,1740,-28,2016-10-27
Asian Life Insurance Co. Limited,3,1712,1700,1700,101,172684,1712,-12,2016-11-03
Asian Life Insurance Co. Limited,24,1760,1670,1735,4396,7613365,1700,35,2016-11-07
Asian Life Insurance Co. Limited,42,1800,1760,1787,9803,17336672,1735,52,2016-11-08
Asian Life Insurance Co. Limited,31,1783,1730,1760,5794,10117510,1787,-27,2016-11-09
Asian Life Insurance Co. Limited,18,1774,1730,1730,3797,6616480,1760,-30,2016-11-10
Asian Life Insurance Co. Limited,19,1740,1710,1740,2870,4971054,1730,10,2016-11-13
Asian Life Insurance Co. Limited,14,1738,1716,1738,5512,9538696,1740,-2,2016-11-14
Asian Life Insurance Co. Limited,9,1743,1716,1716,1746,3023149,1738,-22,2016-11-15
Asian Life Insurance Co. Limited,41,1795,1725,1780,6002,10589064,1716,64,2016-11-16
Asian Life Insurance Co. Limited,28,1760,1710,1735,6330,10937605,1780,-45,2016-11-17
Asian Life Insurance Co. Limited,17,1705,1642,1662,2327,3911327,1735,-73,2016-11-20
Asian Life Insurance Co. Limited,19,1700,1630,1680,2469,4088992,1662,18,2016-11-21
Asian Life Insurance Co. Limited,21,1700,1653,1666,3577,5944364,1680,-14,2016-11-22
Asian Life Insurance Co. Limited,15,1650,1570,1580,1026,1628235,1666,-86,2016-11-23
Asian Life Insurance Co. Limited,29,1611,1450,1480,3482,5194388,1580,-100,2016-11-24
Asian Life Insurance Co. Limited,22,1470,1338,1338,1862,2639744,1480,-142,2016-11-27
Asian Life Insurance Co. Limited,75,1410,1205,1410,17926,22908380,1338,72,2016-11-28
Asian Life Insurance Co. Limited,55,1479,1324,1479,16225,22286853,1410,69,2016-11-29
Asian Life Insurance Co. Limited,46,1601,1448,1601,7540,11526923,1479,122,2016-11-30
Asian Life Insurance Co. Limited,49,1600,1520,1580,7854,12328908,1601,-21,2016-12-01
Asian Life Insurance Co. Limited,42,1570,1489,1510,11384,17569500,1580,-70,2016-12-04
Asian Life Insurance Co. Limited,51,1521,1471,1475,10764,16031725,1510,-35,2016-12-05
Asian Life Insurance Co. Limited,45,1519,1472,1500,9130,13657173,1475,25,2016-12-06
Asian Life Insurance Co. Limited,14,1539,1507,1507,2520,3841241,1500,7,2016-12-07
Asian Life Insurance Co. Limited,26,1525,1464,1470,7060,10436411,1507,-37,2016-12-08
Asian Life Insurance Co. Limited,29,1499,1422,1450,6106,8781236,1470,-20,2016-12-11
Asian Life Insurance Co. Limited,42,1455,1420,1440,12735,18246037,1450,-10,2016-12-12
Asian Life Insurance Co. Limited,27,1468,1422,1450,3169,4583382,1440,10,2016-12-14
Asian Life Insurance Co. Limited,30,1520,1455,1500,8580,12690006,1450,50,2016-12-15
Asian Life Insurance Co. Limited,32,1525,1472,1525,5577,8409793,1500,25,2016-12-18
Asian Life Insurance Co. Limited,12,1530,1488,1490,808,1206900,1525,-35,2016-12-19
Asian Life Insurance Co. Limited,24,1480,1451,1451,3083,4496788,1490,-39,2016-12-20
Asian Life Insurance Co. Limited,49,1451,1420,1420,6970,9960065,1451,-31,2016-12-21
Asian Life Insurance Co. Limited,22,1450,1420,1420,2723,3912966,1420,0,2016-12-22
Asian Life Insurance Co. Limited,30,1410,1382,1384,3588,4992584,1420,-36,2016-12-26
Asian Life Insurance Co. Limited,34,1370,1304,1330,6532,8756015,1384,-54,2016-12-27
Asian Life Insurance Co. Limited,19,1383,1330,1377,3101,4207156,1330,47,2016-12-28
Asian Life Insurance Co. Limited,40,1465,1369,1400,7869,11132887,1377,23,2016-12-29
Asian Life Insurance Co. Limited,24,1428,1400,1410,7194,10130400,1400,10,2017-01-01
Asian Life Insurance Co. Limited,11,1438,1405,1411,2672,3789812,1410,1,2017-01-02
Asian Life Insurance Co. Limited,18,1411,1360,1375,2163,2973015,1411,-36,2017-01-03
Asian Life Insurance Co. Limited,6,1425,1374,1390,480,669308,1375,15,2017-01-04
Asian Life Insurance Co. Limited,10,1390,1375,1375,1940,2676800,1390,-15,2017-01-05
Asian Life Insurance Co. Limited,17,1390,1375,1390,1596,2201090,1375,15,2017-01-08
Asian Life Insurance Co. Limited,4,1422,1366,1422,395,548650,1390,32,2017-01-09
Asian Life Insurance Co. Limited,18,1458,1408,1430,1429,2058370,1422,8,2017-01-10
Asian Life Insurance Co. Limited,12,1458,1420,1420,1404,2003445,1430,-10,2017-01-11
Asian Life Insurance Co. Limited,6,1420,1400,1420,417,589446,1420,0,2017-01-12
Asian Life Insurance Co. Limited,6,1400,1392,1400,1429,1990220,1420,-20,2017-01-15
Asian Life Insurance Co. Limited,7,1400,1372,1385,2140,2945000,1400,-15,2017-01-16
Asian Life Insurance Co. Limited,14,1400,1360,1400,2447,3398550,1385,15,2017-01-17
Asian Life Insurance Co. Limited,6,1393,1390,1390,783,1089620,1400,-10,2017-01-18
Asian Life Insurance Co. Limited,25,1400,1380,1380,3482,4833920,1390,-10,2017-01-19
Asian Life Insurance Co. Limited,10,1407,1380,1380,2230,3089090,1380,0,2017-01-22
Asian Life Insurance Co. Limited,22,1377,1350,1360,3307,4496740,1380,-20,2017-01-23
Asian Life Insurance Co. Limited,31,1350,1320,1320,5175,6902860,1360,-40,2017-01-24
Asian Life Insurance Co. Limited,23,1320,1269,1269,1991,2565795,1320,-51,2017-01-25
Asian Life Insurance Co. Limited,27,1300,1245,1245,2837,3618235,1269,-24,2017-01-26
Asian Life Insurance Co. Limited,63,1244,1121,1121,12860,14623335,1245,-124,2017-01-30
Asian Life Insurance Co. Limited,79,1163,1056,1100,18638,20427973,1121,-21,2017-01-31
Asian Life Insurance Co. Limited,27,1173,1100,1173,6271,7065811,1100,73,2017-02-01
Asian Life Insurance Co. Limited,33,1195,1128,1135,5617,6527240,1173,-38,2017-02-02
Asian Life Insurance Co. Limited,19,1160,1110,1130,2510,2862800,1135,-5,2017-02-05
Asian Life Insurance Co. Limited,22,1150,1110,1110,1826,2054795,1130,-20,2017-02-06
Asian Life Insurance Co. Limited,6,1110,1090,1090,889,973190,1110,-20,2017-02-07
Asian Life Insurance Co. Limited,43,1095,1048,1075,6116,6480364,1090,-15,2017-02-08
Asian Life Insurance Co. Limited,53,1055,1014,1015,9101,9360448,1075,-60,2017-02-09
Asian Life Insurance Co. Limited,60,1035,956,956,6921,6834687,1015,-59,2017-02-12
Asian Life Insurance Co. Limited,38,998,902,998,4789,4428254,956,42,2017-02-13
Asian Life Insurance Co. Limited,39,1000,960,1000,4561,4474822,998,2,2017-02-14
Asian Life Insurance Co. Limited,129,1100,1015,1100,16582,17538033,1000,100,2017-02-15
Asian Life Insurance Co. Limited,170,1185,1106,1178,17461,20027130,1100,78,2017-02-16
Asian Life Insurance Co. Limited,122,1243,1125,1230,14697,17535935,1178,52,2017-02-19
Asian Life Insurance Co. Limited,138,1290,1200,1230,17330,21932852,1230,0,2017-02-20
Asian Life Insurance Co. Limited,81,1285,1201,1220,10922,13471815,1230,-10,2017-02-21
Asian Life Insurance Co. Limited,36,1219,1186,1188,4475,5369113,1220,-32,2017-02-22
Asian Life Insurance Co. Limited,12,1200,1176,1176,2277,2703174,1188,-12,2017-02-23
Asian Life Insurance Co. Limited,47,1156,1118,1118,3660,4154645,1176,-58,2017-02-26
Asian Life Insurance Co. Limited,50,1160,1096,1099,5208,5797108,1118,-19,2017-02-28
Asian Life Insurance Co. Limited,25,1160,1110,1160,2941,3347737,1099,61,2017-03-01
Asian Life Insurance Co. Limited,44,1183,1140,1176,5593,6500391,1160,16,2017-03-02
Asian Life Insurance Co. Limited,83,1263,1186,1250,8591,10531118,1176,74,2017-03-05
Asian Life Insurance Co. Limited,93,1280,1240,1258,11818,14921371,1260,-2,2017-03-21
Asian Life Insurance Co. Limited,120,1300,1250,1265,8299,10569287,1250,15,2017-03-06
Asian Life Insurance Co. Limited,69,1255,1222,1228,8238,10215444,1265,-37,2017-03-07
Asian Life Insurance Co. Limited,50,1280,1235,1255,5881,7406194,1228,27,2017-03-09
Asian Life Insurance Co. Limited,86,1305,1272,1296,11920,15327820,1255,41,2017-03-13
Asian Life Insurance Co. Limited,130,1313,1274,1300,17526,22660543,1296,4,2017-03-14
Asian Life Insurance Co. Limited,243,1304,1265,1299,29126,37608457,1300,-1,2017-03-15
Asian Life Insurance Co. Limited,24,1110,1085,1100,2331,2555250,1083,17,2017-03-16
Asian Life Insurance Co. Limited,20,1150,1100,1149,3400,3867590,1100,49,2017-03-19
Asian Life Insurance Co. Limited,84,1263,1162,1260,13133,15979765,1149,111,2017-03-20
Asian Life Insurance Co. Limited,69,1283,1220,1220,9589,12061951,1258,-38,2017-03-22
Asian Life Insurance Co. Limited,26,1244,1205,1220,3691,4504470,1220,0,2017-03-23
Asian Life Insurance Co. Limited,56,1319,1197,1280,7798,10057903,1220,60,2017-03-26
Asian Life Insurance Co. Limited,50,1350,1305,1348,7093,9468732,1280,68,2017-03-28
Asian Life Insurance Co. Limited,84,1374,1300,1300,9747,13057319,1348,-48,2017-03-29
Asian Life Insurance Co. Limited,30,1345,1315,1325,1891,2516865,1300,25,2017-03-30
Asian Life Insurance Co. Limited,8,1457,1351,1457,1010,1460270,1325,132,2017-04-02
Asian Life Insurance Co. Limited,291,1602,1486,1580,52051,83086113,1457,123,2017-04-03
Asian Life Insurance Co. Limited,139,1639,1520,1590,18912,30041886,1580,10,2017-04-04
Asian Life Insurance Co. Limited,145,1610,1561,1595,20908,33275457,1590,5,2017-04-06
Asian Life Insurance Co. Limited,49,1610,1580,1590,5539,8821420,1595,-5,2017-04-09
Asian Life Insurance Co. Limited,124,1630,1560,1611,28644,45800811,1590,21,2017-04-10
Asian Life Insurance Co. Limited,129,1690,1615,1680,22809,37551556,1611,69,2017-04-11
Asian Life Insurance Co. Limited,130,1709,1620,1620,23367,39366081,1680,-60,2017-04-12
Asian Life Insurance Co. Limited,81,1660,1590,1620,13242,21490254,1620,0,2017-04-13
Asian Life Insurance Co. Limited,55,1620,1566,1566,7330,11619850,1620,-54,2017-04-16
Asian Life Insurance Co. Limited,74,1560,1447,1510,9177,13885769,1566,-56,2017-04-18
Asian Life Insurance Co. Limited,56,1618,1511,1610,6385,10017535,1510,100,2017-04-19
Asian Life Insurance Co. Limited,100,1674,1600,1630,14439,23557140,1610,20,2017-04-20
Asian Life Insurance Co. Limited,80,1695,1617,1660,10945,18195323,1630,30,2017-04-23
Asian Life Insurance Co. Limited,67,1670,1615,1632,6965,11393154,1660,-28,2017-04-24
Asian Life Insurance Co. Limited,57,1640,1601,1625,8483,13791833,1632,-7,2017-04-25
Asian Life Insurance Co. Limited,21,1621,1600,1621,2485,3994367,1625,-4,2017-04-26
Asian Life Insurance Co. Limited,31,1629,1582,1601,3731,5988223,1621,-20,2017-04-27
Asian Life Insurance Co. Limited,38,1600,1560,1585,3298,5195280,1601,-16,2017-04-30
Asian Life Insurance Co. Limited,15,1620,1571,1594,3109,4949843,1585,9,2017-05-02
Asian Life Insurance Co. Limited,31,1600,1575,1575,5939,9404474,1594,-19,2017-05-03
Asian Life Insurance Co. Limited,16,1575,1561,1567,2301,3609653,1575,-8,2017-05-04
Asian Life Insurance Co. Limited,47,1580,1550,1564,5864,9116906,1567,-3,2017-05-07
Asian Life Insurance Co. Limited,24,1565,1550,1563,2275,3542357,1564,-1,2017-05-08
Asian Life Insurance Co. Limited,12,1585,1551,1584,2027,3185021,1563,21,2017-05-09
Asian Life Insurance Co. Limited,28,1608,1570,1570,4330,6809910,1584,-14,2017-05-11
Asian Life Insurance Co. Limited,19,1600,1560,1565,3390,5315440,1570,-5,2017-05-15
Asian Life Insurance Co. Limited,25,1585,1550,1561,2327,3644339,1565,-4,2017-05-16
Asian Life Insurance Co. Limited,19,1560,1552,1553,2757,4293527,1561,-8,2017-05-17
Asian Life Insurance Co. Limited,23,1555,1550,1555,1693,2627913,1553,2,2017-05-18
Asian Life Insurance Co. Limited,27,1559,1510,1526,3530,5423310,1555,-29,2017-05-21
Asian Life Insurance Co. Limited,36,1522,1498,1510,6480,9754783,1526,-16,2017-05-22
Asian Life Insurance Co. Limited,20,1540,1510,1515,5255,7998675,1510,5,2017-05-23
Asian Life Insurance Co. Limited,28,1535,1500,1534,2959,4478948,1515,19,2017-05-24
Asian Life Insurance Co. Limited,17,1530,1505,1505,2562,3885037,1534,-29,2017-05-28
Asian Life Insurance Co. Limited,50,1505,1475,1475,6092,9109239,1505,-30,2017-05-30
Asian Life Insurance Co. Limited,44,1503,1452,1501,4552,6683635,1475,26,2017-05-31
Asian Life Insurance Co. Limited,29,1500,1485,1489,3170,4728564,1501,-12,2017-06-01
Asian Life Insurance Co. Limited,23,1480,1455,1475,2727,4003075,1489,-14,2017-06-04
Asian Life Insurance Co. Limited,14,1498,1450,1491,2684,3977727,1475,16,2017-06-05
Asian Life Insurance Co. Limited,22,1530,1500,1518,2531,3827485,1491,27,2017-06-06
Asian Life Insurance Co. Limited,28,1530,1500,1506,4286,6487680,1518,-12,2017-06-07
Asian Life Insurance Co. Limited,57,1545,1510,1514,6924,10524740,1506,8,2017-06-08
Asian Life Insurance Co. Limited,60,1503,1490,1490,8528,12750018,1514,-24,2017-06-11
Asian Life Insurance Co. Limited,25,1499,1446,1474,1370,2017765,1490,-16,2017-06-12
Asian Life Insurance Co. Limited,13,1490,1470,1476,580,860896,1474,2,2017-06-13
Asian Life Insurance Co. Limited,20,1504,1480,1490,2391,3555673,1476,14,2017-06-14
Asian Life Insurance Co. Limited,22,1516,1480,1488,2169,3233762,1490,-2,2017-06-15
Asian Life Insurance Co. Limited,55,1519,1487,1500,5563,8376235,1488,12,2017-06-18
Asian Life Insurance Co. Limited,21,1501,1470,1487,1339,1979059,1500,-13,2017-06-19
Asian Life Insurance Co. Limited,15,1500,1465,1480,864,1278040,1487,-7,2017-06-20
Asian Life Insurance Co. Limited,23,1500,1461,1465,1831,2704734,1480,-15,2017-06-21
Asian Life Insurance Co. Limited,11,1494,1466,1466,496,733936,1465,1,2017-06-22
Asian Life Insurance Co. Limited,31,1490,1466,1466,4317,6347898,1466,0,2017-06-25
Asian Life Insurance Co. Limited,23,1489,1460,1487,2186,3233030,1466,21,2017-06-27
Asian Life Insurance Co. Limited,18,1486,1475,1486,2202,3257664,1487,-1,2017-06-28
Asian Life Insurance Co. Limited,22,1485,1450,1450,1760,2563088,1486,-36,2017-07-02
Asian Life Insurance Co. Limited,19,1460,1450,1452,1298,1884910,1450,2,2017-07-03
Asian Life Insurance Co. Limited,18,1469,1446,1446,988,1440256,1452,-6,2017-07-04
Asian Life Insurance Co. Limited,30,1455,1441,1455,3800,5499608,1446,9,2017-07-05
Asian Life Insurance Co. Limited,37,1484,1445,1484,8837,12872794,1455,29,2017-07-06
Asian Life Insurance Co. Limited,34,1512,1445,1473,5260,7803560,1484,-11,2017-07-09
Asian Life Insurance Co. Limited,20,1475,1445,1452,1904,2782613,1473,-21,2017-07-10
Asian Life Insurance Co. Limited,23,1480,1455,1470,5674,8312935,1452,18,2017-07-11
Asian Life Insurance Co. Limited,12,1470,1460,1460,1930,2821000,1470,-10,2017-07-12
Asian Life Insurance Co. Limited,40,1465,1450,1458,6010,8733359,1460,-2,2017-07-13
Asian Life Insurance Co. Limited,21,1469,1445,1460,2404,3494676,1458,2,2017-07-16
Asian Life Insurance Co. Limited,17,1490,1468,1480,1914,2844325,1460,20,2017-07-17
Asian Life Insurance Co. Limited,83,1554,1481,1554,15229,23082333,1480,74,2017-07-18
Asian Life Insurance Co. Limited,43,1640,1599,1611,4116,6660030,1631,-20,2017-08-03
Asian Life Insurance Co. Limited,65,1565,1525,1530,10115,15566547,1554,-24,2017-07-19
Asian Life Insurance Co. Limited,28,1555,1530,1542,1731,2673740,1530,12,2017-07-20
Asian Life Insurance Co. Limited,75,1600,1552,1574,8665,13665731,1542,32,2017-07-23
Asian Life Insurance Co. Limited,80,1594,1570,1585,8700,13766792,1574,11,2017-07-24
Asian Life Insurance Co. Limited,137,1634,1580,1634,19548,31320674,1585,49,2017-07-25
Asian Life Insurance Co. Limited,129,1695,1635,1695,13266,22126519,1634,61,2017-07-26
Asian Life Insurance Co. Limited,85,1723,1660,1667,8895,14858435,1695,-28,2017-07-27
Asian Life Insurance Co. Limited,83,1680,1639,1680,7398,12244953,1667,13,2017-07-30
Asian Life Insurance Co. Limited,45,1670,1627,1631,4293,7053875,1680,-49,2017-07-31
Asian Life Insurance Co. Limited,48,1647,1625,1635,4029,6579839,1631,4,2017-08-01
Asian Life Insurance Co. Limited,24,1645,1630,1631,1632,2666433,1635,-4,2017-08-02
Asian Life Insurance Co. Limited,45,1600,1575,1587,5172,8212227,1611,-24,2017-08-06
Asian Life Insurance Co. Limited,64,1600,1587,1600,7566,12061386,1587,13,2017-08-07
Asian Life Insurance Co. Limited,73,1630,1605,1628,11446,18542837,1600,28,2017-08-09
Asian Life Insurance Co. Limited,49,1628,1597,1624,7625,12250034,1628,-4,2017-08-10
Asian Life Insurance Co. Limited,47,1615,1599,1601,5097,8160110,1624,-23,2017-08-13
Asian Life Insurance Co. Limited,28,1603,1580,1580,2096,3326125,1601,-21,2017-08-15
Asian Life Insurance Co. Limited,40,1600,1580,1593,8272,13159389,1580,13,2017-08-16
Asian Life Insurance Co. Limited,37,1595,1579,1590,4066,6432103,1593,-3,2017-08-17
Asian Life Insurance Co. Limited,25,1590,1575,1585,2594,4103439,1590,-5,2017-08-20
Asian Life Insurance Co. Limited,17,1590,1575,1581,1180,1867472,1585,-4,2017-08-21
Asian Life Insurance Co. Limited,30,1612,1570,1600,3339,5295519,1581,19,2017-08-22
Asian Life Insurance Co. Limited,29,1601,1588,1601,3050,4856479,1600,1,2017-08-23
Asian Life Insurance Co. Limited,26,1620,1594,1613,1587,2547483,1601,12,2017-08-24
Asian Life Insurance Co. Limited,55,1615,1590,1600,4425,7094349,1613,-13,2017-08-27
Asian Life Insurance Co. Limited,14,1600,1572,1600,1592,2529540,1600,0,2017-08-28
Asian Life Insurance Co. Limited,43,1600,1580,1596,3018,4789125,1600,-4,2017-08-30
Asian Life Insurance Co. Limited,33,1596,1541,1555,3384,5272960,1596,-41,2017-08-31
Asian Life Insurance Co. Limited,64,1555,1500,1508,8672,13172345,1555,-47,2017-09-04
Asian Life Insurance Co. Limited,14,1549,1490,1535,708,1082024,1508,27,2017-09-06
Asian Life Insurance Co. Limited,17,1565,1525,1550,2487,3820310,1535,15,2017-09-07
Asian Life Insurance Co. Limited,22,1550,1505,1520,3205,4893327,1550,-30,2017-09-10
Asian Life Insurance Co. Limited,36,1525,1492,1514,5964,8982065,1520,-6,2017-09-11
Asian Life Insurance Co. Limited,41,1505,1460,1470,4496,6642025,1514,-44,2017-09-12
Asian Life Insurance Co. Limited,38,1495,1453,1461,5097,7476900,1470,-9,2017-09-13
Asian Life Insurance Co. Limited,25,1503,1450,1503,2164,3201171,1461,42,2017-09-14
Asian Life Insurance Co. Limited,47,1533,1490,1508,11371,17028440,1503,5,2017-09-17
Asian Life Insurance Co. Limited,15,1508,1490,1498,1626,2431787,1508,-10,2017-09-18
Asian Life Insurance Co. Limited,16,1500,1479,1489,1304,1942630,1498,-9,2017-09-20
Asian Life Insurance Co. Limited,16,1468,1440,1468,2804,4058340,1441,27,2017-10-09
Asian Life Insurance Co. Limited,12,1495,1490,1491,1710,2552045,1489,2,2017-09-24
Asian Life Insurance Co. Limited,10,1499,1490,1492,1561,2329274,1491,1,2017-09-25
Asian Life Insurance Co. Limited,17,1505,1498,1505,2383,3574850,1492,13,2017-09-26
Asian Life Insurance Co. Limited,5,1505,1486,1495,870,1296300,1505,-10,2017-10-03
Asian Life Insurance Co. Limited,2,1500,1500,1500,345,517500,1495,5,2017-10-04
Asian Life Insurance Co. Limited,31,1471,1441,1441,2315,3352605,1500,-59,2017-10-08
Asian Life Insurance Co. Limited,8,1485,1461,1465,514,754382,1468,-3,2017-10-10
Asian Life Insurance Co. Limited,13,1470,1460,1460,1980,2893477,1465,-5,2017-10-11
Asian Life Insurance Co. Limited,8,1470,1463,1470,574,841724,1460,10,2017-10-12
Asian Life Insurance Co. Limited,12,1475,1450,1475,452,660140,1470,5,2017-10-15
Asian Life Insurance Co. Limited,19,1514,1473,1514,1914,2863324,1475,39,2017-10-16
Asian Life Insurance Co. Limited,25,1538,1504,1519,1934,2929718,1514,5,2017-10-17
Asian Life Insurance Co. Limited,22,1549,1501,1549,2688,4090264,1519,30,2017-10-18
Asian Life Insurance Co. Limited,5,1577,1535,1535,119,183925,1549,-14,2017-10-22
Asian Life Insurance Co. Limited,10,1549,1522,1530,872,1330653,1535,-5,2017-10-23
Asian Life Insurance Co. Limited,14,1510,1495,1510,713,1070505,1530,-20,2017-10-24
Asian Life Insurance Co. Limited,24,1520,1480,1520,3823,5700665,1510,10,2017-10-25
Asian Life Insurance Co. Limited,13,1520,1490,1492,1720,2578828,1520,-28,2017-10-29
Asian Life Insurance Co. Limited,5,1490,1489,1490,186,277024,1492,-2,2017-10-30
Asian Life Insurance Co. Limited,10,1515,1480,1480,478,710345,1490,-10,2017-10-31
Asian Life Insurance Co. Limited,19,1461,1440,1456,2454,3562969,1480,-24,2017-11-01
Asian Life Insurance Co. Limited,33,1456,1435,1450,3583,5180878,1456,-6,2017-11-02
Asian Life Insurance Co. Limited,54,1445,1425,1426,5768,8245346,1450,-24,2017-11-05
Asian Life Insurance Co. Limited,25,1450,1421,1424,4142,5918782,1426,-2,2017-11-06
Asian Life Insurance Co. Limited,28,1430,1405,1425,2412,3426248,1424,1,2017-11-07
Asian Life Insurance Co. Limited,13,1410,1390,1397,949,1325952,1425,-28,2017-11-08
Asian Life Insurance Co. Limited,24,1420,1366,1399,3336,4650658,1397,2,2017-11-09
Asian Life Insurance Co. Limited,3,1407,1405,1407,250,351556,1399,8,2017-11-12
Asian Life Insurance Co. Limited,30,1437,1395,1437,5009,7070634,1407,30,2017-11-13
Asian Life Insurance Co. Limited,21,1467,1432,1440,2327,3350347,1437,3,2017-11-14
Asian Life Insurance Co. Limited,18,1435,1415,1435,1847,2638120,1440,-5,2017-11-15
Asian Life Insurance Co. Limited,9,1430,1420,1420,809,1151300,1435,-15,2017-11-16
Asian Life Insurance Co. Limited,11,1420,1380,1393,3164,4424950,1420,-27,2017-11-19
Asian Life Insurance Co. Limited,17,1410,1392,1410,1381,1923906,1393,17,2017-11-20
Asian Life Insurance Co. Limited,21,1420,1390,1400,2527,3546905,1410,-10,2017-11-21
Asian Life Insurance Co. Limited,13,1405,1400,1405,1195,1675400,1400,5,2017-11-22
Asian Life Insurance Co. Limited,16,1410,1400,1402,594,833769,1405,-3,2017-11-23
Asian Life Insurance Co. Limited,13,1449,1400,1437,976,1393445,1402,35,2017-11-26
Asian Life Insurance Co. Limited,16,1440,1410,1421,2335,3324480,1437,-16,2017-11-27
Asian Life Insurance Co. Limited,5,1435,1425,1425,613,878545,1421,4,2017-11-28
Asian Life Insurance Co. Limited,7,1468,1425,1440,636,924121,1425,15,2017-11-29
Asian Life Insurance Co. Limited,13,1468,1447,1460,991,1447390,1440,20,2017-11-30
Asian Life Insurance Co. Limited,8,1449,1430,1440,626,900973,1460,-20,2017-12-04
Asian Life Insurance Co. Limited,14,1440,1432,1433,1686,2416992,1449,-16,2017-12-20
Asian Life Insurance Co. Limited,53,1485,1455,1485,4497,6622093,1440,45,2017-12-05
Asian Life Insurance Co. Limited,49,1512,1482,1512,7248,10877681,1485,27,2017-12-06
Asian Life Insurance Co. Limited,9,1500,1479,1499,1121,1663843,1512,-13,2017-12-10
Asian Life Insurance Co. Limited,14,1498,1453,1482,2054,3054349,1499,-17,2017-12-11
Asian Life Insurance Co. Limited,22,1455,1435,1437,1681,2426623,1482,-45,2017-12-12
Asian Life Insurance Co. Limited,11,1462,1435,1462,1248,1817430,1437,25,2017-12-13
Asian Life Insurance Co. Limited,17,1460,1449,1449,2111,3064869,1462,-13,2017-12-14
Asian Life Insurance Co. Limited,10,1452,1440,1440,497,716544,1449,-9,2017-12-17
Asian Life Insurance Co. Limited,27,1455,1438,1441,6659,9619438,1440,1,2017-12-18
Asian Life Insurance Co. Limited,17,1449,1440,1449,846,1219417,1441,8,2017-12-19
Asian Life Insurance Co. Limited,20,1430,1410,1425,3110,4420200,1433,-8,2017-12-21
Asian Life Insurance Co. Limited,15,1450,1425,1425,1913,2735065,1425,0,2017-12-24
Asian Life Insurance Co. Limited,22,1405,1393,1394,3234,4514240,1425,-31,2017-12-26
Asian Life Insurance Co. Limited,31,1399,1371,1380,4427,6133885,1394,-14,2017-12-27
Asian Life Insurance Co. Limited,30,1395,1360,1384,4164,5704809,1380,4,2017-12-28
Asian Life Insurance Co. Limited,10,1380,1363,1372,760,1042110,1384,-12,2017-12-31
Asian Life Insurance Co. Limited,28,1404,1365,1403,4831,6694213,1372,31,2018-01-01
Asian Life Insurance Co. Limited,24,1419,1380,1381,2506,3487987,1403,-22,2018-01-02
Asian Life Insurance Co. Limited,10,1381,1365,1366,870,1194555,1381,-15,2018-01-03
Asian Life Insurance Co. Limited,27,1380,1361,1361,3546,4847995,1366,-5,2018-01-04
Asian Life Insurance Co. Limited,9,1388,1344,1375,386,527582,1361,14,2018-01-07
Asian Life Insurance Co. Limited,44,1450,1399,1450,8299,11743359,1375,75,2018-01-08
Asian Life Insurance Co. Limited,49,1452,1420,1420,6091,8717803,1450,-30,2018-01-09
Asian Life Insurance Co. Limited,58,1448,1391,1400,3810,5368806,1420,-20,2018-01-10
Asian Life Insurance Co. Limited,31,1401,1375,1383,2268,3141006,1400,-17,2018-01-14
Asian Life Insurance Co. Limited,35,1390,1359,1365,4454,6092179,1383,-18,2018-01-16
Asian Life Insurance Co. Limited,56,1353,1338,1339,8799,11847723,1365,-26,2018-01-17
Asian Life Insurance Co. Limited,177,1350,1316,1316,18945,25263216,1339,-23,2018-01-21
Asian Life Insurance Co. Limited,32,911,885,891,2651,2362711,911,-20,2018-01-22
Asian Life Insurance Co. Limited,20,890,878,878,1075,947476,891,-13,2018-01-23
Asian Life Insurance Co. Limited,8,880,878,879,1094,961598,878,1,2018-01-24
Asian Life Insurance Co. Limited,29,905,880,905,2893,2578212,879,26,2018-01-25
Asian Life Insurance Co. Limited,23,905,880,887,2316,2055396,905,-18,2018-01-28
Asian Life Insurance Co. Limited,11,885,875,883,836,735647,887,-4,2018-01-29
Asian Life Insurance Co. Limited,13,884,870,880,810,708718,883,-3,2018-01-31
Asian Life Insurance Co. Limited,12,885,876,877,1447,1269856,880,-3,2018-02-01
Asian Life Insurance Co. Limited,19,880,872,872,1401,1226052,877,-5,2018-02-04
Asian Life Insurance Co. Limited,10,870,865,865,665,576850,872,-7,2018-02-05
Asian Life Insurance Co. Limited,2,865,860,865,113,97430,865,0,2018-02-06
Asian Life Insurance Co. Limited,16,860,840,840,995,843338,865,-25,2018-02-07
Asian Life Insurance Co. Limited,22,855,841,855,2709,2291961,840,15,2018-02-08
Asian Life Insurance Co. Limited,8,846,840,840,291,245514,845,-5,2018-02-25
Asian Life Insurance Co. Limited,12,867,846,867,1642,1394472,855,12,2018-02-11
Asian Life Insurance Co. Limited,12,861,845,855,871,739981,867,-12,2018-02-12
Asian Life Insurance Co. Limited,19,860,842,860,1626,1378330,855,5,2018-02-14
Asian Life Insurance Co. Limited,20,902,860,902,2508,2178427,860,42,2018-02-15
Asian Life Insurance Co. Limited,32,920,875,890,2937,2629463,902,-12,2018-02-18
Asian Life Insurance Co. Limited,9,890,856,872,1154,1002944,890,-18,2018-02-20
Asian Life Insurance Co. Limited,5,860,854,854,251,214632,872,-18,2018-02-21
Asian Life Insurance Co. Limited,11,855,843,845,738,626365,854,-9,2018-02-22
Asian Life Insurance Co. Limited,16,835,811,820,1275,1051105,840,-20,2018-02-26
Asian Life Insurance Co. Limited,16,835,812,820,1458,1200240,820,0,2018-02-27
Asian Life Insurance Co. Limited,13,820,800,805,1490,1198460,820,-15,2018-02-28
Asian Life Insurance Co. Limited,20,805,745,759,2044,1596315,805,-46,2018-03-04
Asian Life Insurance Co. Limited,22,752,731,731,1463,1083675,759,-28,2018-03-05
Asian Life Insurance Co. Limited,23,758,710,758,2165,1553630,731,27,2018-03-06
Asian Life Insurance Co. Limited,25,765,743,761,2514,1890416,758,3,2018-03-07
Asian Life Insurance Co. Limited,37,746,704,707,4184,3013592,761,-54,2018-03-11
Asian Life Insurance Co. Limited,22,719,700,700,1481,1042100,707,-7,2018-03-12
Asian Life Insurance Co. Limited,4,705,702,705,370,260150,700,5,2018-03-13
Asian Life Insurance Co. Limited,1,710,710,710,38,26980,705,5,2018-03-14
Asian Life Insurance Co. Limited,10,724,702,702,1055,745188,710,-8,2018-03-15
Asian Life Insurance Co. Limited,20,702,697,702,1349,944278,702,0,2018-03-18
Asian Life Insurance Co. Limited,13,700,689,689,1099,761310,702,-13,2018-03-19
Asian Life Insurance Co. Limited,30,690,663,663,2337,1565425,689,-26,2018-03-20
Asian Life Insurance Co. Limited,18,660,635,640,1600,1034368,663,-23,2018-03-21
Asian Life Insurance Co. Limited,27,646,600,633,3874,2380056,640,-7,2018-03-22
Asian Life Insurance Co. Limited,27,621,570,570,2440,1448740,633,-63,2018-03-26
Asian Life Insurance Co. Limited,60,608,529,581,7171,4108749,570,11,2018-03-27
Asian Life Insurance Co. Limited,74,591,560,560,8019,4606467,581,-21,2018-03-28
Asian Life Insurance Co. Limited,26,591,571,584,2040,1184795,560,24,2018-03-29
Asian Life Insurance Co. Limited,30,586,560,580,3028,1750108,584,-4,2018-04-01
Asian Life Insurance Co. Limited,8,591,580,589,383,223885,580,9,2018-04-02
Asian Life Insurance Co. Limited,19,600,579,600,1864,1090342,589,11,2018-04-03
Asian Life Insurance Co. Limited,25,624,605,620,2317,1418245,600,20,2018-04-04
Asian Life Insurance Co. Limited,57,650,600,650,8414,5338842,620,30,2018-04-05
Asian Life Insurance Co. Limited,68,715,640,680,9002,6204792,650,30,2018-04-08
Asian Life Insurance Co. Limited,83,730,680,700,8861,6263742,680,20,2018-04-09
Asian Life Insurance Co. Limited,52,725,675,680,4394,3058645,700,-20,2018-04-10
Asian Life Insurance Co. Limited,45,693,653,693,5321,3579513,680,13,2018-04-11
Asian Life Insurance Co. Limited,54,717,696,700,8218,5793229,693,7,2018-04-12
Asian Life Insurance Co. Limited,37,718,672,718,4093,2840028,700,18,2018-04-15
Asian Life Insurance Co. Limited,137,789,715,789,17368,12994977,718,71,2018-04-16
Asian Life Insurance Co. Limited,181,867,785,867,18025,14720153,789,78,2018-04-17
Asian Life Insurance Co. Limited,171,890,827,830,19435,16699971,867,-37,2018-04-18
Asian Life Insurance Co. Limited,107,872,838,860,15448,13238797,830,30,2018-04-19
Asian Life Insurance Co. Limited,74,914,865,914,10547,9371044,860,54,2018-04-22
Asian Life Insurance Co. Limited,112,940,865,870,13566,12251528,914,-44,2018-04-23
Asian Life Insurance Co. Limited,71,900,845,882,9228,8096065,870,12,2018-04-24
Asian Life Insurance Co. Limited,67,886,860,874,11250,9775575,882,-8,2018-04-25
Asian Life Insurance Co. Limited,124,857,830,831,17824,15025909,874,-43,2018-04-26
Asian Life Insurance Co. Limited,35,847,816,831,6798,5627804,831,0,2018-04-29
Asian Life Insurance Co. Limited,15,858,825,858,3182,2676058,831,27,2018-05-02
Asian Life Insurance Co. Limited,35,869,852,852,6112,5232273,858,-6,2018-05-03
Asian Life Insurance Co. Limited,24,859,851,853,3883,3311650,852,1,2018-05-06
Asian Life Insurance Co. Limited,14,855,850,854,2565,2188182,853,1,2018-05-07
Asian Life Insurance Co. Limited,114,885,856,878,14113,12202385,854,24,2018-05-08
Asian Life Insurance Co. Limited,64,885,875,875,4386,3862284,878,-3,2018-05-09
Asian Life Insurance Co. Limited,28,890,865,870,2628,2292373,875,-5,2018-05-10
Asian Life Insurance Co. Limited,21,863,853,858,2369,2033050,870,-12,2018-05-14
Asian Life Insurance Co. Limited,16,848,840,840,2613,2206090,858,-18,2018-05-15
Asian Life Insurance Co. Limited,17,856,850,850,2375,2024825,840,10,2018-05-16
Asian Life Insurance Co. Limited,35,867,851,853,2531,2164830,850,3,2018-05-17
Asian Life Insurance Co. Limited,24,817,804,804,4220,3417750,820,-16,2018-05-20
Asian Life Insurance Co. Limited,14,802,790,790,2160,1708340,804,-14,2018-05-21
Asian Life Insurance Co. Limited,15,785,766,777,2485,1930031,790,-13,2018-05-22
Asian Life Insurance Co. Ltd Promoter Share,3,860,860,860,52125,44827500,860,0,2016-09-26
Asian Life Insurance Co. Ltd Promoter Share,3,850,850,850,8836,7510600,860,-10,2016-11-27
Asian Life Insurance Co. Ltd Promoter Share,1,833,833,833,28239,23523087,850,-17,2017-01-24
Asian Life Insurance Co. Ltd Promoter Share,1,817,817,817,75000,61275000,833,-16,2017-05-15
Asian Life Insurance Co. Ltd Promoter Share,2,801,800,800,77933,62364333,817,-17,2017-06-01
Asian Life Insurance Co. Ltd Promoter Share,1,800,800,800,60000,48000000,800,0,2017-06-05
Asian Life Insurance Co. Ltd Promoter Share,1,800,800,800,24000,19200000,800,0,2017-09-13
Asian Life Insurance Co. Ltd Promoter Share,1,800,800,800,22268,17814400,800,0,2017-10-16
Asian Life Insurance Co. Ltd Promoter Share,1,800,800,800,3855,3084000,800,0,2017-10-30
Asian Life Insurance Co. Ltd Promoter Share,8,785,720,720,166017,122695795,800,-80,2018-01-04
Asian Life Insurance Co. Ltd Promoter Share,2,720,719,720,14000,10079500,720,0,2018-01-09
Asian Life Insurance Co. Ltd Promoter Share,2,706,700,700,13182,9246492,720,-20,2018-01-21
Bank of Kathmandu Limited Promoter Share,3,401,387,401,37800,14636300,380,21,2016-10-19
Bank of Kathmandu Limited Promoter Share,1,405,405,405,175868,71226540,401,4,2017-03-16
Bank of Kathmandu Limited Promoter Share,1,275,275,275,60000,16500000,275,0,2017-08-27
Bank of Kathmandu Limited Promoter Share,1,270,270,270,5000,1350000,275,-5,2017-09-06
Bank of Kathmandu Limited Promoter Share,1,270,270,270,107060,28906200,270,0,2017-11-12
Bank of Kathmandu Limited Promoter Share,1,211,211,211,40449,8534739,210,1,2018-02-20
Bank of Kathmandu Limited Promoter Share,2,212,212,212,27441,5817492,211,1,2018-03-29
Bank of Kathmandu Limited Promoter Share,4,212,212,212,579914,122941768,212,0,2018-04-09
Bank of Kathmandu Ltd.,7,510,473,510,4437,2248769,464,46,2016-09-28
Bank of Kathmandu Ltd.,5,561,520,561,50,27010,510,51,2016-09-29
Bank of Kathmandu Ltd.,6,617,572,617,469,288233,561,56,2016-10-02
Bank of Kathmandu Ltd.,7,678,629,678,420,283410,617,61,2016-10-03
Bank of Kathmandu Ltd.,17,745,691,745,3322,2473540,678,67,2016-10-04
Bank of Kathmandu Ltd.,1258,819,755,787,381177,298821622,745,42,2016-10-05
Bank of Kathmandu Ltd.,653,794,775,780,178136,139315580,787,-7,2016-10-06
Bank of Kathmandu Ltd.,229,780,755,764,58598,44628295,780,-16,2016-10-16
Bank of Kathmandu Ltd.,304,770,736,752,75678,56632146,764,-12,2016-10-17
Bank of Kathmandu Ltd.,246,753,715,740,51936,38553106,752,-12,2016-10-18
Bank of Kathmandu Ltd.,173,751,735,738,34634,25557977,740,-2,2016-10-19
Bank of Kathmandu Ltd.,202,744,739,741,40919,30330712,738,3,2016-10-20
Bank of Kathmandu Ltd.,230,750,723,730,48414,35292211,741,-11,2016-10-23
Bank of Kathmandu Ltd.,193,728,713,719,35840,25731388,730,-11,2016-10-24
Bank of Kathmandu Ltd.,157,730,706,720,39244,27867100,719,1,2016-10-25
Bank of Kathmandu Ltd.,170,720,707,718,36563,26063174,720,-2,2016-10-26
Bank of Kathmandu Ltd.,205,729,714,719,45651,32855530,718,1,2016-10-27
Bank of Kathmandu Ltd.,105,720,710,713,22970,16445127,719,-6,2016-11-03
Bank of Kathmandu Ltd.,153,714,705,706,49484,35049382,713,-7,2016-11-07
Bank of Kathmandu Ltd.,197,707,691,700,53317,37143505,706,-6,2016-11-08
Bank of Kathmandu Ltd.,177,700,666,688,42648,29353179,700,-12,2016-11-09
Bank of Kathmandu Ltd.,263,693,670,688,63495,43164697,688,0,2016-11-10
Bank of Kathmandu Ltd.,175,688,666,676,42870,29120790,688,-12,2016-11-13
Bank of Kathmandu Ltd.,205,705,666,698,60427,41620122,676,22,2016-11-14
Bank of Kathmandu Ltd.,257,710,692,698,66240,46245204,698,0,2016-11-15
Bank of Kathmandu Ltd.,115,700,690,691,19983,13853338,698,-7,2016-11-16
Bank of Kathmandu Ltd.,223,690,660,675,53578,36194636,691,-16,2016-11-17
Bank of Kathmandu Ltd.,346,688,638,655,77691,50652743,675,-20,2016-11-20
Bank of Kathmandu Ltd.,271,669,631,658,67806,44022568,655,3,2016-11-21
Bank of Kathmandu Ltd.,290,659,615,644,58544,37697393,658,-14,2016-11-22
Bank of Kathmandu Ltd.,402,650,620,630,77629,49037931,644,-14,2016-11-23
Bank of Kathmandu Ltd.,317,654,620,629,63443,40128467,630,-1,2016-11-24
Bank of Kathmandu Ltd.,338,635,611,617,73178,45405731,629,-12,2016-11-27
Bank of Kathmandu Ltd.,398,650,595,646,109608,67365565,617,29,2016-11-28
Bank of Kathmandu Ltd.,459,658,609,651,96962,62635770,646,5,2016-11-29
Bank of Kathmandu Ltd.,511,675,652,669,90494,60208034,651,18,2016-11-30
Bank of Kathmandu Ltd.,415,682,654,669,66851,44807863,669,0,2016-12-01
Bank of Kathmandu Ltd.,228,681,649,660,40874,27080926,669,-9,2016-12-04
Bank of Kathmandu Ltd.,240,660,646,653,45679,29750945,660,-7,2016-12-05
Bank of Kathmandu Ltd.,197,670,647,660,38914,25497642,653,7,2016-12-06
Bank of Kathmandu Ltd.,171,673,633,658,31067,20399428,660,-2,2016-12-07
Bank of Kathmandu Ltd.,150,658,650,656,20692,13528561,658,-2,2016-12-08
Bank of Kathmandu Ltd.,206,658,640,641,34307,22225577,656,-15,2016-12-11
Bank of Kathmandu Ltd.,161,648,620,637,26635,16925878,641,-4,2016-12-12
Bank of Kathmandu Ltd.,145,645,635,639,25739,16442300,637,2,2016-12-14
Bank of Kathmandu Ltd.,144,651,635,650,27803,17887178,639,11,2016-12-15
Bank of Kathmandu Ltd.,262,650,638,646,41502,26637395,650,-4,2016-12-18
Bank of Kathmandu Ltd.,196,650,636,643,34377,21994583,646,-3,2016-12-19
Bank of Kathmandu Ltd.,171,640,625,625,25930,16437553,643,-18,2016-12-20
Bank of Kathmandu Ltd.,166,627,620,621,29990,18687145,625,-4,2016-12-21
Bank of Kathmandu Ltd.,105,626,615,620,19840,12332470,621,-1,2016-12-22
Bank of Kathmandu Ltd.,260,615,600,603,55924,33782626,620,-17,2016-12-26
Bank of Kathmandu Ltd.,206,609,578,595,43724,25960533,603,-8,2016-12-27
Bank of Kathmandu Ltd.,167,607,592,600,29792,17824865,595,5,2016-12-28
Bank of Kathmandu Ltd.,223,625,596,615,42205,25813924,600,15,2016-12-29
Bank of Kathmandu Ltd.,193,631,620,625,29831,18595774,615,10,2017-01-01
Bank of Kathmandu Ltd.,214,640,623,625,37538,23650798,625,0,2017-01-02
Bank of Kathmandu Ltd.,160,627,610,612,25697,15894419,625,-13,2017-01-03
Bank of Kathmandu Ltd.,116,618,600,614,16585,10162839,612,2,2017-01-04
Bank of Kathmandu Ltd.,119,632,603,612,21291,13111973,614,-2,2017-01-05
Bank of Kathmandu Ltd.,98,614,606,613,149829,91243153,612,1,2017-01-08
Bank of Kathmandu Ltd.,76,616,610,616,14193,8704056,613,3,2017-01-09
Bank of Kathmandu Ltd.,81,626,617,621,16048,9987547,616,5,2017-01-10
Bank of Kathmandu Ltd.,78,626,619,619,11953,7429264,621,-2,2017-01-11
Bank of Kathmandu Ltd.,60,620,614,614,11035,6811290,619,-5,2017-01-12
Bank of Kathmandu Ltd.,51,616,610,612,10360,6339781,614,-2,2017-01-15
Bank of Kathmandu Ltd.,44,613,608,609,7024,4284353,612,-3,2017-01-16
Bank of Kathmandu Ltd.,73,611,600,610,19781,12020579,609,1,2017-01-17
Bank of Kathmandu Ltd.,43,613,608,611,11726,7163864,610,1,2017-01-18
Bank of Kathmandu Ltd.,56,611,601,609,9518,5793197,611,-2,2017-01-19
Bank of Kathmandu Ltd.,56,611,605,606,12086,7338585,609,-3,2017-01-22
Bank of Kathmandu Ltd.,92,607,600,603,17889,10770634,606,-3,2017-01-23
Bank of Kathmandu Ltd.,106,603,590,596,21459,12776623,603,-7,2017-01-24
Bank of Kathmandu Ltd.,106,596,578,585,18628,10866042,596,-11,2017-01-25
Bank of Kathmandu Ltd.,168,585,565,570,32501,18644181,585,-15,2017-01-26
Bank of Kathmandu Ltd.,189,573,537,540,37872,20671684,570,-30,2017-01-30
Bank of Kathmandu Ltd.,102,560,510,545,16759,8955600,540,5,2017-01-31
Bank of Kathmandu Ltd.,113,573,548,573,24179,13625747,545,28,2017-02-01
Bank of Kathmandu Ltd.,167,595,560,570,28786,16529866,573,-3,2017-02-02
Bank of Kathmandu Ltd.,81,565,553,558,8133,4548835,570,-12,2017-02-05
Bank of Kathmandu Ltd.,70,561,544,550,12842,7071894,558,-8,2017-02-06
Bank of Kathmandu Ltd.,65,550,534,548,7990,4338677,550,-2,2017-02-07
Bank of Kathmandu Ltd.,89,550,535,541,15736,8511349,548,-7,2017-02-08
Bank of Kathmandu Ltd.,143,540,525,526,24053,12776920,541,-15,2017-02-09
Bank of Kathmandu Ltd.,144,525,500,508,25795,13269350,526,-18,2017-02-12
Bank of Kathmandu Ltd.,216,527,490,525,52492,26344511,508,17,2017-02-13
Bank of Kathmandu Ltd.,158,528,512,519,26751,13932842,525,-6,2017-02-14
Bank of Kathmandu Ltd.,138,531,513,531,39286,20487911,519,12,2017-02-15
Bank of Kathmandu Ltd.,333,548,526,548,76411,40961688,531,17,2017-02-16
Bank of Kathmandu Ltd.,321,558,539,548,57690,31654601,548,0,2017-02-19
Bank of Kathmandu Ltd.,286,559,544,546,58284,32133075,548,-2,2017-02-20
Bank of Kathmandu Ltd.,247,564,539,539,43351,23744428,546,-7,2017-02-21
Bank of Kathmandu Ltd.,182,545,530,531,27687,14853621,539,-8,2017-02-22
Bank of Kathmandu Ltd.,493,536,529,529,87307,46478112,531,-2,2017-02-23
Bank of Kathmandu Ltd.,110,426,408,412,21747,9044099,430,-18,2017-02-26
Bank of Kathmandu Ltd.,73,412,401,409,13178,5361811,412,-3,2017-02-28
Bank of Kathmandu Ltd.,46,416,409,415,8384,3457952,409,6,2017-03-01
Bank of Kathmandu Ltd.,54,418,413,417,8740,3633825,415,2,2017-03-02
Bank of Kathmandu Ltd.,80,420,410,418,15674,6548196,417,1,2017-03-05
Bank of Kathmandu Ltd.,104,445,427,445,27748,12224575,434,11,2017-03-21
Bank of Kathmandu Ltd.,71,435,417,423,12979,5497401,418,5,2017-03-06
Bank of Kathmandu Ltd.,48,423,415,416,8537,3550995,423,-7,2017-03-07
Bank of Kathmandu Ltd.,32,421,415,415,4446,1850555,416,-1,2017-03-09
Bank of Kathmandu Ltd.,18,423,415,417,2969,1239109,415,2,2017-03-13
Bank of Kathmandu Ltd.,71,418,409,409,13746,5679666,417,-8,2017-03-14
Bank of Kathmandu Ltd.,37,412,406,409,8811,3614036,409,0,2017-03-15
Bank of Kathmandu Ltd.,49,417,409,411,16417,6748735,409,2,2017-03-16
Bank of Kathmandu Ltd.,71,415,409,415,22955,9484747,411,4,2017-03-19
Bank of Kathmandu Ltd.,109,438,417,434,24270,10356719,415,19,2017-03-20
Bank of Kathmandu Ltd.,171,462,435,440,32282,14648477,445,-5,2017-03-22
Bank of Kathmandu Ltd.,133,454,435,450,23724,10575205,440,10,2017-03-23
Bank of Kathmandu Ltd.,140,475,446,465,34806,16158039,450,15,2017-03-26
Bank of Kathmandu Ltd.,132,498,460,490,54876,26550543,465,25,2017-03-28
Bank of Kathmandu Ltd.,229,516,474,474,59171,29101053,490,-16,2017-03-29
Bank of Kathmandu Ltd.,112,485,463,470,30548,14443957,474,-4,2017-03-30
Bank of Kathmandu Ltd.,93,510,479,510,46216,22835590,470,40,2017-04-02
Bank of Kathmandu Ltd.,228,560,495,505,72939,38601135,510,-5,2017-04-03
Bank of Kathmandu Ltd.,142,511,496,500,39066,19711214,505,-5,2017-04-04
Bank of Kathmandu Ltd.,144,508,491,500,39265,19634485,500,0,2017-04-06
Bank of Kathmandu Ltd.,140,525,504,516,40237,20713633,500,16,2017-04-09
Bank of Kathmandu Ltd.,196,541,510,530,67764,35562651,516,14,2017-04-10
Bank of Kathmandu Ltd.,205,558,534,547,56543,30964003,530,17,2017-04-11
Bank of Kathmandu Ltd.,161,557,530,530,38975,21399528,547,-17,2017-04-12
Bank of Kathmandu Ltd.,146,539,510,529,32412,17112733,530,-1,2017-04-13
Bank of Kathmandu Ltd.,136,530,510,513,43820,22631133,529,-16,2017-04-16
Bank of Kathmandu Ltd.,148,520,496,505,29882,15111380,513,-8,2017-04-18
Bank of Kathmandu Ltd.,84,525,505,525,21860,11259709,505,20,2017-04-19
Bank of Kathmandu Ltd.,157,535,515,522,43532,22806468,525,-3,2017-04-20
Bank of Kathmandu Ltd.,189,563,522,530,50236,27031813,522,8,2017-04-23
Bank of Kathmandu Ltd.,98,530,515,516,29763,15496090,530,-14,2017-04-24
Bank of Kathmandu Ltd.,115,520,508,511,36694,18785833,516,-5,2017-04-25
Bank of Kathmandu Ltd.,88,513,504,510,31274,15885583,511,-1,2017-04-26
Bank of Kathmandu Ltd.,81,520,504,508,22245,11338734,510,-2,2017-04-27
Bank of Kathmandu Ltd.,74,514,504,510,16811,8528460,508,2,2017-04-30
Bank of Kathmandu Ltd.,114,512,500,510,33513,16912286,510,0,2017-05-02
Bank of Kathmandu Ltd.,78,524,505,508,20443,10485177,510,-2,2017-05-03
Bank of Kathmandu Ltd.,78,512,501,503,17748,8971473,508,-5,2017-05-04
Bank of Kathmandu Ltd.,79,500,490,498,25421,12530732,503,-5,2017-05-07
Bank of Kathmandu Ltd.,54,503,490,493,16141,7951360,498,-5,2017-05-08
Bank of Kathmandu Ltd.,57,502,494,497,20264,10067992,493,4,2017-05-09
Bank of Kathmandu Ltd.,88,506,498,502,24585,12302492,497,5,2017-05-11
Bank of Kathmandu Ltd.,30,512,500,503,5764,2901032,502,1,2017-05-15
Bank of Kathmandu Ltd.,56,504,494,498,10804,5375813,503,-5,2017-05-16
Bank of Kathmandu Ltd.,36,501,492,493,7338,3631507,498,-5,2017-05-17
Bank of Kathmandu Ltd.,58,493,485,492,12584,6158716,493,-1,2017-05-18
Bank of Kathmandu Ltd.,69,490,480,480,15327,7430820,492,-12,2017-05-21
Bank of Kathmandu Ltd.,88,498,455,498,77897,35754650,480,18,2017-05-22
Bank of Kathmandu Ltd.,62,498,485,492,16724,8233975,498,-6,2017-05-23
Bank of Kathmandu Ltd.,45,490,483,490,8857,4311429,492,-2,2017-05-24
Bank of Kathmandu Ltd.,106,485,477,480,29795,14344462,490,-10,2017-05-28
Bank of Kathmandu Ltd.,91,480,470,471,34372,16260319,480,-9,2017-05-30
Bank of Kathmandu Ltd.,137,480,460,470,61568,28768412,471,-1,2017-05-31
Bank of Kathmandu Ltd.,146,479,465,470,51745,24382793,470,0,2017-06-01
Bank of Kathmandu Ltd.,125,479,460,465,25983,12104217,470,-5,2017-06-04
Bank of Kathmandu Ltd.,102,479,458,472,36567,17129558,465,7,2017-06-05
Bank of Kathmandu Ltd.,117,490,466,490,29021,13791878,472,18,2017-06-06
Bank of Kathmandu Ltd.,166,495,470,477,32131,15411937,490,-13,2017-06-07
Bank of Kathmandu Ltd.,62,479,473,473,12984,6174721,477,-4,2017-06-08
Bank of Kathmandu Ltd.,99,470,457,463,15500,7184362,473,-10,2017-06-11
Bank of Kathmandu Ltd.,86,468,452,460,16267,7497170,463,-3,2017-06-12
Bank of Kathmandu Ltd.,56,470,461,469,11297,5264044,460,9,2017-06-13
Bank of Kathmandu Ltd.,63,473,460,470,17376,8112519,469,1,2017-06-14
Bank of Kathmandu Ltd.,72,476,463,463,13300,6247390,470,-7,2017-06-15
Bank of Kathmandu Ltd.,70,467,456,464,12812,5931878,463,1,2017-06-18
Bank of Kathmandu Ltd.,93,460,453,456,24698,11262716,464,-8,2017-06-19
Bank of Kathmandu Ltd.,117,460,445,454,24078,10838984,456,-2,2017-06-20
Bank of Kathmandu Ltd.,86,454,445,453,19146,8641244,454,-1,2017-06-21
Bank of Kathmandu Ltd.,72,460,453,453,7694,3498893,453,0,2017-06-22
Bank of Kathmandu Ltd.,91,461,452,457,14073,6428150,453,4,2017-06-25
Bank of Kathmandu Ltd.,73,465,453,455,14092,6452782,457,-2,2017-06-27
Bank of Kathmandu Ltd.,59,458,452,456,11217,5106731,455,1,2017-06-28
Bank of Kathmandu Ltd.,86,456,443,448,17371,7789931,456,-8,2017-07-02
Bank of Kathmandu Ltd.,82,456,450,455,16608,7513917,448,7,2017-07-03
Bank of Kathmandu Ltd.,52,455,448,450,9075,4097085,455,-5,2017-07-04
Bank of Kathmandu Ltd.,76,450,443,450,16520,7400106,450,0,2017-07-05
Bank of Kathmandu Ltd.,119,463,452,463,27679,12636881,450,13,2017-07-06
Bank of Kathmandu Ltd.,128,475,452,458,32270,14976293,463,-5,2017-07-09
Bank of Kathmandu Ltd.,56,467,457,461,14147,6512713,458,3,2017-07-10
Bank of Kathmandu Ltd.,58,465,457,462,12872,5937273,461,1,2017-07-11
Bank of Kathmandu Ltd.,66,468,462,462,9652,4485666,462,0,2017-07-12
Bank of Kathmandu Ltd.,74,465,460,462,11332,5238576,462,0,2017-07-13
Bank of Kathmandu Ltd.,50,464,456,462,7342,3386387,462,0,2017-07-16
Bank of Kathmandu Ltd.,82,472,462,470,15778,7355825,462,8,2017-07-17
Bank of Kathmandu Ltd.,143,476,467,476,29290,13802789,470,6,2017-07-18
Bank of Kathmandu Ltd.,123,494,480,485,23051,11161768,485,0,2017-08-03
Bank of Kathmandu Ltd.,114,480,465,470,23422,11148743,476,-6,2017-07-19
Bank of Kathmandu Ltd.,73,480,472,472,14142,6724028,470,2,2017-07-20
Bank of Kathmandu Ltd.,83,472,464,464,15817,7378138,472,-8,2017-07-23
Bank of Kathmandu Ltd.,62,465,460,461,14829,6839750,464,-3,2017-07-24
Bank of Kathmandu Ltd.,90,470,452,459,26374,12144838,461,-2,2017-07-25
Bank of Kathmandu Ltd.,114,470,455,458,23893,11004879,459,-1,2017-07-26
Bank of Kathmandu Ltd.,173,484,461,484,43141,20404616,458,26,2017-07-27
Bank of Kathmandu Ltd.,264,503,473,494,85128,41973929,484,10,2017-07-30
Bank of Kathmandu Ltd.,221,503,485,487,53248,26352667,494,-7,2017-07-31
Bank of Kathmandu Ltd.,76,490,481,484,14489,7025155,487,-3,2017-08-01
Bank of Kathmandu Ltd.,96,485,479,485,14875,7165354,484,1,2017-08-02
Bank of Kathmandu Ltd.,125,489,476,486,20499,9958744,485,1,2017-08-06
Bank of Kathmandu Ltd.,109,490,485,488,21021,10231097,486,2,2017-08-07
Bank of Kathmandu Ltd.,106,492,480,480,19588,9459627,488,-8,2017-08-09
Bank of Kathmandu Ltd.,81,485,475,476,13119,6285843,480,-4,2017-08-10
Bank of Kathmandu Ltd.,156,500,479,481,34530,16646317,476,5,2017-08-13
Bank of Kathmandu Ltd.,116,480,474,475,27295,13019006,481,-6,2017-08-15
Bank of Kathmandu Ltd.,81,480,468,477,14726,7036256,475,2,2017-08-16
Bank of Kathmandu Ltd.,68,480,474,478,8530,4064231,477,1,2017-08-17
Bank of Kathmandu Ltd.,138,480,463,465,18926,8837314,478,-13,2017-08-20
Bank of Kathmandu Ltd.,40,465,456,462,5894,2710898,465,-3,2017-08-21
Bank of Kathmandu Ltd.,58,469,457,467,9914,4578215,462,5,2017-08-22
Bank of Kathmandu Ltd.,65,471,460,460,16701,7731512,467,-7,2017-08-23
Bank of Kathmandu Ltd.,53,465,458,462,9422,4347058,460,2,2017-08-24
Bank of Kathmandu Ltd.,69,465,458,458,12806,5901946,462,-4,2017-08-27
Bank of Kathmandu Ltd.,64,460,450,453,20395,9243286,458,-5,2017-08-28
Bank of Kathmandu Ltd.,129,455,442,445,28917,12862856,453,-8,2017-08-30
Bank of Kathmandu Ltd.,133,445,435,435,24713,10844478,445,-10,2017-08-31
Bank of Kathmandu Ltd.,150,435,423,424,32246,13769757,435,-11,2017-09-04
Bank of Kathmandu Ltd.,66,440,425,435,15314,6596712,424,11,2017-09-06
Bank of Kathmandu Ltd.,74,435,426,428,11484,4918857,435,-7,2017-09-07
Bank of Kathmandu Ltd.,88,428,420,420,15342,6482757,428,-8,2017-09-10
Bank of Kathmandu Ltd.,61,430,415,420,11686,4929648,420,0,2017-09-11
Bank of Kathmandu Ltd.,80,422,416,420,14092,5905546,420,0,2017-09-12
Bank of Kathmandu Ltd.,69,422,415,419,18376,7700323,420,-1,2017-09-13
Bank of Kathmandu Ltd.,57,434,420,433,12294,5243772,419,14,2017-09-14
Bank of Kathmandu Ltd.,96,440,426,440,15457,6717090,433,7,2017-09-17
Bank of Kathmandu Ltd.,83,448,438,443,11810,5208837,440,3,2017-09-18
Bank of Kathmandu Ltd.,43,451,425,438,11701,5197002,443,-5,2017-09-20
Bank of Kathmandu Ltd.,47,425,420,425,7869,3329861,426,-1,2017-10-09
Bank of Kathmandu Ltd.,68,445,433,435,15164,6598424,438,-3,2017-09-24
Bank of Kathmandu Ltd.,42,439,427,439,9113,3964136,435,4,2017-09-25
Bank of Kathmandu Ltd.,58,443,433,434,12120,5277699,439,-5,2017-09-26
Bank of Kathmandu Ltd.,15,436,426,434,4001,1735098,434,0,2017-10-03
Bank of Kathmandu Ltd.,32,436,431,434,7230,3133709,434,0,2017-10-04
Bank of Kathmandu Ltd.,71,430,419,426,19432,8215898,434,-8,2017-10-08
Bank of Kathmandu Ltd.,70,429,420,425,15622,6625722,425,0,2017-10-10
Bank of Kathmandu Ltd.,56,426,421,424,12823,5440352,425,-1,2017-10-11
Bank of Kathmandu Ltd.,39,426,420,424,8288,3510351,424,0,2017-10-12
Bank of Kathmandu Ltd.,30,434,425,432,6175,2639993,424,8,2017-10-15
Bank of Kathmandu Ltd.,85,448,430,445,252428,108534706,432,13,2017-10-16
Bank of Kathmandu Ltd.,80,450,437,443,12280,5427308,445,-2,2017-10-17
Bank of Kathmandu Ltd.,66,452,442,450,11979,5369349,443,7,2017-10-18
Bank of Kathmandu Ltd.,49,458,447,447,8055,3652957,450,-3,2017-10-22
Bank of Kathmandu Ltd.,103,452,445,449,22132,9960987,447,2,2017-10-23
Bank of Kathmandu Ltd.,40,452,449,449,11336,5104533,449,0,2017-10-24
Bank of Kathmandu Ltd.,39,448,442,444,5196,2309275,449,-5,2017-10-25
Bank of Kathmandu Ltd.,48,445,439,440,11166,4926941,444,-4,2017-10-29
Bank of Kathmandu Ltd.,35,445,440,440,7113,3141768,440,0,2017-10-30
Bank of Kathmandu Ltd.,39,442,438,438,7396,3247282,440,-2,2017-10-31
Bank of Kathmandu Ltd.,36,440,433,435,5652,2465833,438,-3,2017-11-01
Bank of Kathmandu Ltd.,39,436,430,435,8399,3636339,435,0,2017-11-02
Bank of Kathmandu Ltd.,158,433,413,415,28314,11846079,435,-20,2017-11-05
Bank of Kathmandu Ltd.,62,431,408,414,10803,4494790,415,-1,2017-11-06
Bank of Kathmandu Ltd.,58,422,414,414,15411,6414819,414,0,2017-11-07
Bank of Kathmandu Ltd.,92,414,405,410,20047,8201017,414,-4,2017-11-08
Bank of Kathmandu Ltd.,140,410,400,404,37712,15204611,410,-6,2017-11-09
Bank of Kathmandu Ltd.,91,408,400,408,25785,10385932,404,4,2017-11-12
Bank of Kathmandu Ltd.,66,414,408,414,11555,4747882,408,6,2017-11-13
Bank of Kathmandu Ltd.,66,422,413,419,11146,4643405,414,5,2017-11-14
Bank of Kathmandu Ltd.,75,422,413,413,13502,5623616,419,-6,2017-11-15
Bank of Kathmandu Ltd.,73,413,404,404,15242,6199140,413,-9,2017-11-16
Bank of Kathmandu Ltd.,61,407,401,402,17641,7131271,404,-2,2017-11-19
Bank of Kathmandu Ltd.,65,404,400,404,31209,12497478,402,2,2017-11-20
Bank of Kathmandu Ltd.,73,410,402,403,16320,6588128,404,-1,2017-11-21
Bank of Kathmandu Ltd.,50,411,403,406,15434,6259483,403,3,2017-11-22
Bank of Kathmandu Ltd.,85,411,406,408,17588,7185611,406,2,2017-11-23
Bank of Kathmandu Ltd.,86,412,406,411,15240,6241584,408,3,2017-11-26
Bank of Kathmandu Ltd.,73,415,409,409,13278,5465053,411,-2,2017-11-27
Bank of Kathmandu Ltd.,73,411,407,409,13219,5410121,409,0,2017-11-28
Bank of Kathmandu Ltd.,116,423,410,416,23393,9671097,409,7,2017-11-29
Bank of Kathmandu Ltd.,48,418,410,412,6918,2860260,416,-4,2017-11-30
Bank of Kathmandu Ltd.,69,417,410,410,11894,4919090,412,-2,2017-12-04
Bank of Kathmandu Ltd.,129,423,410,421,40474,16911457,414,7,2017-12-20
Bank of Kathmandu Ltd.,66,410,406,409,12503,5095201,410,-1,2017-12-05
Bank of Kathmandu Ltd.,50,418,410,418,10398,4328001,409,9,2017-12-06
Bank of Kathmandu Ltd.,61,433,412,413,12203,5116016,418,-5,2017-12-10
Bank of Kathmandu Ltd.,77,415,405,410,18191,7451408,413,-3,2017-12-11
Bank of Kathmandu Ltd.,52,410,406,407,10993,4485774,410,-3,2017-12-12
Bank of Kathmandu Ltd.,43,416,400,412,10074,4144257,407,5,2017-12-13
Bank of Kathmandu Ltd.,35,415,407,409,13078,5350694,412,-3,2017-12-14
Bank of Kathmandu Ltd.,56,414,409,413,20124,8279624,409,4,2017-12-17
Bank of Kathmandu Ltd.,78,418,411,418,24285,10114712,413,5,2017-12-18
Bank of Kathmandu Ltd.,54,420,414,414,8516,3533826,418,-4,2017-12-19
Bank of Kathmandu Ltd.,97,426,417,418,27398,11482586,421,-3,2017-12-21
Bank of Kathmandu Ltd.,76,420,415,415,15142,6326577,418,-3,2017-12-24
Bank of Kathmandu Ltd.,63,414,410,410,13819,5683203,415,-5,2017-12-26
Bank of Kathmandu Ltd.,98,410,395,405,20576,8338094,410,-5,2017-12-27
Bank of Kathmandu Ltd.,99,410,397,402,23512,9466520,405,-3,2017-12-28
Bank of Kathmandu Ltd.,91,403,397,401,22108,8838611,402,-1,2017-12-31
Bank of Kathmandu Ltd.,60,410,403,409,18032,7322976,401,8,2018-01-01
Bank of Kathmandu Ltd.,91,415,405,407,24488,10061679,409,-2,2018-01-02
Bank of Kathmandu Ltd.,80,407,401,402,18022,7271390,407,-5,2018-01-03
Bank of Kathmandu Ltd.,77,407,401,405,17768,7164022,402,3,2018-01-04
Bank of Kathmandu Ltd.,45,409,405,405,10670,4338156,405,0,2018-01-07
Bank of Kathmandu Ltd.,79,409,404,405,24371,9883701,405,0,2018-01-08
Bank of Kathmandu Ltd.,73,410,405,409,15188,6201942,405,4,2018-01-09
Bank of Kathmandu Ltd.,70,416,407,414,21984,9073185,409,5,2018-01-10
Bank of Kathmandu Ltd.,72,415,408,410,11021,4526242,414,-4,2018-01-14
Bank of Kathmandu Ltd.,53,409,405,406,10370,4221987,410,-4,2018-01-16
Bank of Kathmandu Ltd.,50,409,401,407,9587,3882031,406,1,2018-01-17
Bank of Kathmandu Ltd.,82,408,402,403,14651,5920480,407,-4,2018-01-21
Bank of Kathmandu Ltd.,61,405,403,405,9353,3777216,403,2,2018-01-22
Bank of Kathmandu Ltd.,43,404,401,402,7910,3182444,405,-3,2018-01-23
Bank of Kathmandu Ltd.,40,403,401,402,8308,3335610,402,0,2018-01-24
Bank of Kathmandu Ltd.,66,407,400,401,15710,6313700,402,-1,2018-01-25
Bank of Kathmandu Ltd.,54,405,400,401,12547,5026648,401,0,2018-01-28
Bank of Kathmandu Ltd.,70,400,394,397,13014,5158458,401,-4,2018-01-29
Bank of Kathmandu Ltd.,55,402,391,394,10468,4133161,397,-3,2018-01-31
Bank of Kathmandu Ltd.,76,399,391,393,22218,8759313,394,-1,2018-02-01
Bank of Kathmandu Ltd.,72,396,390,390,14249,5585467,393,-3,2018-02-04
Bank of Kathmandu Ltd.,48,391,386,389,7735,3003668,390,-1,2018-02-05
Bank of Kathmandu Ltd.,75,387,383,385,17852,6875041,389,-4,2018-02-06
Bank of Kathmandu Ltd.,57,385,378,379,13312,5069202,385,-6,2018-02-07
Bank of Kathmandu Ltd.,68,383,376,380,13774,5220362,379,1,2018-02-08
Bank of Kathmandu Ltd.,44,376,373,373,8238,3081404,375,-2,2018-02-25
Bank of Kathmandu Ltd.,47,380,375,376,8481,3192010,380,-4,2018-02-11
Bank of Kathmandu Ltd.,60,377,370,375,11942,4450887,376,-1,2018-02-12
Bank of Kathmandu Ltd.,52,376,372,376,12203,4555733,375,1,2018-02-14
Bank of Kathmandu Ltd.,128,391,377,391,37572,14441915,376,15,2018-02-15
Bank of Kathmandu Ltd.,111,400,384,387,24095,9466436,391,-4,2018-02-18
Bank of Kathmandu Ltd.,74,396,378,378,15358,5878648,387,-9,2018-02-20
Bank of Kathmandu Ltd.,125,378,370,370,31726,11816515,378,-8,2018-02-21
Bank of Kathmandu Ltd.,65,376,368,375,14138,5255204,370,5,2018-02-22
Bank of Kathmandu Ltd.,73,371,369,370,14415,5335563,373,-3,2018-02-26
Bank of Kathmandu Ltd.,67,377,370,370,14315,5328660,370,0,2018-02-27
Bank of Kathmandu Ltd.,78,370,365,366,20063,7348767,370,-4,2018-02-28
Bank of Kathmandu Ltd.,81,368,352,360,16285,5814777,366,-6,2018-03-04
Bank of Kathmandu Ltd.,57,362,350,355,17095,6044801,360,-5,2018-03-05
Bank of Kathmandu Ltd.,85,362,348,358,23924,8435871,355,3,2018-03-06
Bank of Kathmandu Ltd.,75,370,362,370,14659,5355293,358,12,2018-03-07
Bank of Kathmandu Ltd.,55,377,355,357,11472,4112074,370,-13,2018-03-11
Bank of Kathmandu Ltd.,40,364,354,358,7507,2685544,357,1,2018-03-12
Bank of Kathmandu Ltd.,34,362,358,362,7335,2640202,358,4,2018-03-13
Bank of Kathmandu Ltd.,29,364,361,362,4636,1678682,362,0,2018-03-14
Bank of Kathmandu Ltd.,36,365,363,363,8801,3207550,362,1,2018-03-15
Bank of Kathmandu Ltd.,39,364,361,361,9424,3410588,363,-2,2018-03-18
Bank of Kathmandu Ltd.,40,362,355,355,5554,1984318,361,-6,2018-03-19
Bank of Kathmandu Ltd.,46,355,350,355,11647,4098548,355,0,2018-03-20
Bank of Kathmandu Ltd.,70,353,343,344,13930,4818671,355,-11,2018-03-21
Bank of Kathmandu Ltd.,79,350,331,340,13659,4636088,344,-4,2018-03-22
Bank of Kathmandu Ltd.,207,334,308,310,45346,14262500,340,-30,2018-03-26
Bank of Kathmandu Ltd.,124,322,294,316,24965,7576032,310,6,2018-03-27
Bank of Kathmandu Ltd.,133,322,304,310,22860,7141442,316,-6,2018-03-28
Bank of Kathmandu Ltd.,74,320,307,317,23880,7504394,310,7,2018-03-29
Bank of Kathmandu Ltd.,75,317,308,311,15133,4713257,317,-6,2018-04-01
Bank of Kathmandu Ltd.,43,318,309,313,6123,1907548,311,2,2018-04-02
Bank of Kathmandu Ltd.,36,316,310,316,7698,2414961,313,3,2018-04-03
Bank of Kathmandu Ltd.,50,322,317,321,10372,3320996,316,5,2018-04-04
Bank of Kathmandu Ltd.,96,330,320,325,18275,5965287,321,4,2018-04-05
Bank of Kathmandu Ltd.,105,342,329,339,22524,7573215,325,14,2018-04-08
Bank of Kathmandu Ltd.,111,345,333,335,17989,6113508,339,-4,2018-04-09
Bank of Kathmandu Ltd.,70,336,329,329,13447,4462814,335,-6,2018-04-10
Bank of Kathmandu Ltd.,48,334,325,334,6439,2110672,329,5,2018-04-11
Bank of Kathmandu Ltd.,54,340,333,334,6179,2067780,334,0,2018-04-12
Bank of Kathmandu Ltd.,44,334,321,331,8017,2635218,334,-3,2018-04-15
Bank of Kathmandu Ltd.,37,337,332,335,7165,2392057,331,4,2018-04-16
Bank of Kathmandu Ltd.,39,340,332,336,9010,3027448,335,1,2018-04-17
Bank of Kathmandu Ltd.,66,366,335,350,16440,5667225,336,14,2018-04-18
Bank of Kathmandu Ltd.,131,361,350,356,30277,10769591,350,6,2018-04-19
Bank of Kathmandu Ltd.,111,367,354,365,30818,11119956,356,9,2018-04-22
Bank of Kathmandu Ltd.,123,368,353,358,31536,11419427,365,-7,2018-04-23
Bank of Kathmandu Ltd.,44,362,351,353,10130,3594494,358,-5,2018-04-24
Bank of Kathmandu Ltd.,50,354,348,349,10398,3637651,353,-4,2018-04-25
Bank of Kathmandu Ltd.,51,352,341,342,8851,3046309,349,-7,2018-04-26
Bank of Kathmandu Ltd.,57,342,334,335,9756,3290186,342,-7,2018-04-29
Bank of Kathmandu Ltd.,37,341,330,340,5713,1902375,335,5,2018-05-02
Bank of Kathmandu Ltd.,48,342,336,339,14024,4764086,340,-1,2018-05-03
Bank of Kathmandu Ltd.,55,340,333,335,11605,3891825,339,-4,2018-05-06
Bank of Kathmandu Ltd.,32,334,330,332,3275,1086426,335,-3,2018-05-07
Bank of Kathmandu Ltd.,27,335,330,335,3816,1269678,332,3,2018-05-08
Bank of Kathmandu Ltd.,28,338,333,334,7303,2445184,335,-1,2018-05-09
Bank of Kathmandu Ltd.,51,340,334,335,9607,3222571,334,1,2018-05-10
Bank of Kathmandu Ltd.,49,335,329,331,8533,2836440,335,-4,2018-05-14
Bank of Kathmandu Ltd.,36,335,327,334,5505,1808936,331,3,2018-05-15
Bank of Kathmandu Ltd.,24,335,328,328,4255,1404675,334,-6,2018-05-16
Bank of Kathmandu Ltd.,29,334,330,331,3940,1303358,328,3,2018-05-17
Bank of Kathmandu Ltd.,46,337,326,333,10862,3574140,331,2,2018-05-20
Bank of Kathmandu Ltd.,28,330,327,330,4287,1408629,333,-3,2018-05-21
Bank of Kathmandu Ltd.,25,328,325,326,6847,2233565,330,-4,2018-05-22
Barun Hydropower Co. Ltd.,41,406,400,400,410,165000,403,-3,2016-05-23
Barun Hydropower Co. Ltd.,22,405,399,401,250,100160,400,1,2016-05-24
Barun Hydropower Co. Ltd.,20,405,372,372,280,111680,401,-29,2016-05-25
Barun Hydropower Co. Ltd.,13,390,366,390,130,48970,372,18,2016-05-26
Barun Hydropower Co. Ltd.,8,400,395,399,220,87110,390,9,2016-05-29
Barun Hydropower Co. Ltd.,15,400,391,400,360,142860,399,1,2016-05-30
Barun Hydropower Co. Ltd.,76,440,400,440,6320,2738830,400,40,2016-05-31
Barun Hydropower Co. Ltd.,60,456,412,412,2960,1282520,440,-28,2016-06-01
Barun Hydropower Co. Ltd.,32,425,403,410,510,211530,412,-2,2016-06-02
Barun Hydropower Co. Ltd.,21,402,394,395,1300,512500,410,-15,2016-06-05
Barun Hydropower Co. Ltd.,15,400,391,400,280,111100,395,5,2016-06-06
Barun Hydropower Co. Ltd.,23,408,400,404,300,120430,400,4,2016-06-07
Barun Hydropower Co. Ltd.,96,530,506,522,2720,1406480,510,12,2016-06-23
Barun Hydropower Co. Ltd.,18,416,395,400,380,154390,404,-4,2016-06-08
Barun Hydropower Co. Ltd.,12,405,394,394,120,47960,400,-6,2016-06-09
Barun Hydropower Co. Ltd.,18,395,390,393,510,200790,394,-1,2016-06-12
Barun Hydropower Co. Ltd.,12,412,391,412,220,89130,393,19,2016-06-13
Barun Hydropower Co. Ltd.,59,441,412,425,8270,3535880,412,13,2016-06-14
Barun Hydropower Co. Ltd.,76,467,430,467,3290,1532890,425,42,2016-06-15
Barun Hydropower Co. Ltd.,63,513,476,513,2780,1424330,467,46,2016-06-16
Barun Hydropower Co. Ltd.,116,523,504,505,8350,4269560,513,-8,2016-06-19
Barun Hydropower Co. Ltd.,124,510,498,505,4950,2488860,505,0,2016-06-20
Barun Hydropower Co. Ltd.,92,515,500,515,3220,1636640,505,10,2016-06-21
Barun Hydropower Co. Ltd.,51,515,500,510,3240,1648540,515,-5,2016-06-22
Barun Hydropower Co. Ltd.,61,570,520,535,3300,1779310,522,13,2016-06-26
Barun Hydropower Co. Ltd.,47,540,520,520,770,408590,535,-15,2016-06-27
Barun Hydropower Co. Ltd.,44,525,515,521,1440,750810,520,1,2016-06-28
Barun Hydropower Co. Ltd.,28,520,511,512,800,413550,521,-9,2016-06-29
Barun Hydropower Co. Ltd.,32,522,500,510,1120,565830,512,-2,2016-06-30
Barun Hydropower Co. Ltd.,29,510,490,503,3930,1946740,510,-7,2016-07-03
Barun Hydropower Co. Ltd.,57,526,504,526,2620,1359660,503,23,2016-07-04
Barun Hydropower Co. Ltd.,37,530,506,521,1050,553000,526,-5,2016-07-05
Barun Hydropower Co. Ltd.,34,525,515,525,1410,733300,521,4,2016-07-06
Barun Hydropower Co. Ltd.,31,530,520,520,510,265870,525,-5,2016-07-10
Barun Hydropower Co. Ltd.,27,520,510,520,390,201220,520,0,2016-07-11
Barun Hydropower Co. Ltd.,17,520,490,520,170,86230,520,0,2016-07-12
Barun Hydropower Co. Ltd.,24,510,490,495,880,442200,520,-25,2016-07-13
Barun Hydropower Co. Ltd.,28,510,495,495,635,318730,495,0,2016-07-14
Barun Hydropower Co. Ltd.,17,504,486,500,190,95020,495,5,2016-07-17
Barun Hydropower Co. Ltd.,6,499,481,499,60,29400,500,-1,2016-07-18
Barun Hydropower Co. Ltd.,22,500,490,500,310,153350,499,1,2016-07-19
Barun Hydropower Co. Ltd.,18,500,490,492,180,88740,500,-8,2016-07-20
Barun Hydropower Co. Ltd.,18,508,495,496,180,89910,492,4,2016-07-21
Barun Hydropower Co. Ltd.,9,495,487,491,290,142960,496,-5,2016-07-25
Barun Hydropower Co. Ltd.,47,540,495,530,3535,1843235,491,39,2016-07-26
Barun Hydropower Co. Ltd.,22,535,510,535,380,198250,530,5,2016-07-27
Barun Hydropower Co. Ltd.,18,540,520,540,450,236490,535,5,2016-07-28
Barun Hydropower Co. Ltd.,17,530,520,520,310,161300,540,-20,2016-07-31
Barun Hydropower Co. Ltd.,9,510,500,500,160,81210,520,-20,2016-08-01
Barun Hydropower Co. Ltd.,34,510,480,510,450,221460,500,10,2016-08-02
Barun Hydropower Co. Ltd.,28,510,500,506,800,406080,510,-4,2016-08-03
Barun Hydropower Co. Ltd.,6,506,488,488,60,29770,506,-18,2016-08-04
Barun Hydropower Co. Ltd.,13,530,488,530,160,80280,488,42,2016-08-07
Barun Hydropower Co. Ltd.,6,520,510,510,130,67300,530,-20,2016-08-08
Barun Hydropower Co. Ltd.,39,520,500,500,1031,525330,510,-10,2016-08-10
Barun Hydropower Co. Ltd.,30,493,480,485,2410,1174910,500,-15,2016-08-11
Barun Hydropower Co. Ltd.,29,489,472,475,480,229670,485,-10,2016-08-14
Barun Hydropower Co. Ltd.,11,466,450,465,490,226080,475,-10,2016-08-15
Barun Hydropower Co. Ltd.,23,432,403,403,960,395140,440,-37,2016-08-31
Barun Hydropower Co. Ltd.,12,456,444,444,1020,457120,465,-21,2016-08-16
Barun Hydropower Co. Ltd.,25,455,436,455,250,112600,444,11,2016-08-17
Barun Hydropower Co. Ltd.,6,455,450,452,60,27080,455,-3,2016-08-21
Barun Hydropower Co. Ltd.,28,469,443,443,2380,1082300,452,-9,2016-08-22
Barun Hydropower Co. Ltd.,14,445,440,441,440,194860,443,-2,2016-08-23
Barun Hydropower Co. Ltd.,14,445,437,445,335,148615,441,4,2016-08-24
Barun Hydropower Co. Ltd.,10,440,440,440,330,145200,445,-5,2016-08-28
Barun Hydropower Co. Ltd.,7,447,427,427,110,47970,440,-13,2016-08-29
Barun Hydropower Co. Ltd.,12,446,430,440,210,91760,427,13,2016-08-30
Barun Hydropower Co. Ltd.,21,406,396,406,580,231860,403,3,2016-09-01
Barun Hydropower Co. Ltd.,12,410,399,410,190,77330,406,4,2016-09-04
Barun Hydropower Co. Ltd.,16,412,402,410,160,65430,410,0,2016-09-05
Barun Hydropower Co. Ltd.,23,412,403,405,640,259430,410,-5,2016-09-06
Barun Hydropower Co. Ltd.,13,413,404,410,230,93930,405,5,2016-09-07
Barun Hydropower Co. Ltd.,18,420,406,412,250,103060,410,2,2016-09-08
Barun Hydropower Co. Ltd.,10,420,406,415,140,57980,412,3,2016-09-11
Barun Hydropower Co. Ltd.,8,412,407,412,80,32700,415,-3,2016-09-12
Barun Hydropower Co. Ltd.,46,428,412,420,760,322320,412,8,2016-09-14
Barun Hydropower Co. Ltd.,100,433,415,430,1360,584600,420,10,2016-09-18
Barun Hydropower Co. Ltd.,73,435,430,435,730,317210,430,5,2016-09-20
Barun Hydropower Co. Ltd.,12,435,430,430,120,51950,435,-5,2016-09-21
Barun Hydropower Co. Ltd.,27,431,422,430,499,212748,430,0,2016-09-22
Barun Hydropower Co. Ltd.,4,425,420,420,40,16950,430,-10,2016-09-25
Barun Hydropower Co. Ltd.,10,425,417,417,100,42170,420,-3,2016-09-26
Barun Hydropower Co. Ltd.,6,415,410,410,80,32890,417,-7,2016-09-27
Barun Hydropower Co. Ltd.,10,405,403,403,140,56620,410,-7,2016-09-28
Barun Hydropower Co. Ltd.,11,400,392,397,540,213370,403,-6,2016-09-29
Barun Hydropower Co. Ltd.,7,395,394,394,80,31530,397,-3,2016-10-02
Barun Hydropower Co. Ltd.,4,398,395,398,40,15860,394,4,2016-10-03
Barun Hydropower Co. Ltd.,3,398,395,398,90,35580,398,0,2016-10-04
Barun Hydropower Co. Ltd.,4,395,395,395,40,15800,398,-3,2016-10-05
Barun Hydropower Co. Ltd.,7,402,394,402,70,27740,395,7,2016-10-06
Barun Hydropower Co. Ltd.,7,402,400,400,70,28050,402,-2,2016-10-16
Barun Hydropower Co. Ltd.,1,392,392,392,10,3920,400,-8,2016-10-18
Barun Hydropower Co. Ltd.,2,392,385,392,20,7770,392,0,2016-10-19
Barun Hydropower Co. Ltd.,9,399,390,399,310,123010,392,7,2016-10-20
Barun Hydropower Co. Ltd.,5,400,398,398,50,19940,399,-1,2016-10-23
Barun Hydropower Co. Ltd.,12,398,391,391,120,47020,398,-7,2016-10-25
Barun Hydropower Co. Ltd.,5,395,388,388,50,19470,391,-3,2016-10-26
Barun Hydropower Co. Ltd.,10,392,382,385,100,38650,388,-3,2016-10-27
Barun Hydropower Co. Ltd.,3,385,384,385,310,119340,385,0,2016-11-03
Barun Hydropower Co. Ltd.,11,390,385,385,120,46250,385,0,2016-11-08
Barun Hydropower Co. Ltd.,5,380,380,380,100,38000,385,-5,2016-11-09
Barun Hydropower Co. Ltd.,1,378,378,378,10,3780,380,-2,2016-11-13
Barun Hydropower Co. Ltd.,10,375,374,375,100,37490,378,-3,2016-11-14
Barun Hydropower Co. Ltd.,11,382,360,365,410,152160,375,-10,2016-11-15
Barun Hydropower Co. Ltd.,15,365,360,360,290,104600,365,-5,2016-11-16
Barun Hydropower Co. Ltd.,14,363,348,348,440,156240,360,-12,2016-11-17
Barun Hydropower Co. Ltd.,2,354,354,354,20,7080,348,6,2016-11-21
Barun Hydropower Co. Ltd.,13,348,341,341,170,58720,354,-13,2016-11-22
Barun Hydropower Co. Ltd.,2,335,335,335,20,6700,341,-6,2016-11-24
Barun Hydropower Co. Ltd.,9,329,317,317,180,57960,335,-18,2016-11-27
Barun Hydropower Co. Ltd.,5,315,301,301,140,43200,317,-16,2016-11-28
Barun Hydropower Co. Ltd.,13,310,300,306,1240,382530,301,5,2016-11-29
Barun Hydropower Co. Ltd.,5,320,312,320,50,15780,306,14,2016-11-30
Barun Hydropower Co. Ltd.,5,315,314,314,90,28280,320,-6,2016-12-01
Barun Hydropower Co. Ltd.,14,315,308,308,140,43540,314,-6,2016-12-04
Barun Hydropower Co. Ltd.,29,314,307,314,290,89190,308,6,2016-12-05
Barun Hydropower Co. Ltd.,23,308,297,297,230,69730,314,-17,2016-12-06
Barun Hydropower Co. Ltd.,3,304,302,304,30,9100,297,7,2016-12-07
Barun Hydropower Co. Ltd.,31,304,285,294,310,89850,304,-10,2016-12-08
Barun Hydropower Co. Ltd.,10,292,282,282,100,28850,294,-12,2016-12-11
Barun Hydropower Co. Ltd.,31,282,267,267,500,139780,282,-15,2016-12-12
Barun Hydropower Co. Ltd.,8,272,267,267,170,45890,267,0,2016-12-14
Barun Hydropower Co. Ltd.,4,270,267,270,40,10720,267,3,2016-12-15
Barun Hydropower Co. Ltd.,4,275,275,275,40,11000,270,5,2016-12-18
Barun Hydropower Co. Ltd.,6,280,275,280,390,108910,275,5,2016-12-19
Barun Hydropower Co. Ltd.,10,280,275,280,100,27600,280,0,2016-12-20
Barun Hydropower Co. Ltd.,12,275,265,270,120,32550,280,-10,2016-12-21
Barun Hydropower Co. Ltd.,10,277,270,277,100,27330,270,7,2016-12-22
Barun Hydropower Co. Ltd.,6,280,275,275,60,16550,277,-2,2016-12-26
Barun Hydropower Co. Ltd.,8,275,265,275,310,82750,275,0,2016-12-27
Barun Hydropower Co. Ltd.,7,275,270,270,70,18950,275,-5,2016-12-28
Barun Hydropower Co. Ltd.,6,275,272,275,70,19140,270,5,2016-12-29
Barun Hydropower Co. Ltd.,4,290,280,290,40,11450,275,15,2017-01-01
Barun Hydropower Co. Ltd.,16,286,281,286,160,45610,290,-4,2017-01-03
Barun Hydropower Co. Ltd.,7,286,266,266,70,19520,286,-20,2017-01-04
Barun Hydropower Co. Ltd.,12,272,267,271,120,32470,266,5,2017-01-05
Barun Hydropower Co. Ltd.,4,267,266,267,40,10650,271,-4,2017-01-08
Barun Hydropower Co. Ltd.,4,272,266,272,90,24340,267,5,2017-01-09
Barun Hydropower Co. Ltd.,4,277,272,277,120,33190,272,5,2017-01-10
Barun Hydropower Co. Ltd.,4,277,275,276,40,11040,277,-1,2017-01-11
Barun Hydropower Co. Ltd.,8,285,280,285,110,31090,276,9,2017-01-12
Barun Hydropower Co. Ltd.,1,285,285,285,10,2850,285,0,2017-01-15
Barun Hydropower Co. Ltd.,4,285,275,275,2020,556350,285,-10,2017-01-16
Barun Hydropower Co. Ltd.,3,275,270,275,30,8150,275,0,2017-01-17
Barun Hydropower Co. Ltd.,4,275,275,275,220,60500,275,0,2017-01-18
Barun Hydropower Co. Ltd.,4,272,268,268,40,10820,275,-7,2017-01-19
Barun Hydropower Co. Ltd.,10,268,265,265,100,26610,268,-3,2017-01-22
Barun Hydropower Co. Ltd.,4,265,263,265,40,10540,265,0,2017-01-23
Barun Hydropower Co. Ltd.,17,274,265,274,170,45650,265,9,2017-01-24
Barun Hydropower Co. Ltd.,10,269,250,250,100,25680,274,-24,2017-01-25
Barun Hydropower Co. Ltd.,15,253,240,248,460,111800,250,-2,2017-01-26
Barun Hydropower Co. Ltd.,5,252,247,251,540,135960,248,3,2017-01-31
Barun Hydropower Co. Ltd.,17,266,256,266,330,85160,251,15,2017-02-01
Barun Hydropower Co. Ltd.,4,270,265,269,70,18830,266,3,2017-02-02
Barun Hydropower Co. Ltd.,12,266,265,265,120,31810,269,-4,2017-02-05
Barun Hydropower Co. Ltd.,12,266,260,265,130,34410,265,0,2017-02-06
Barun Hydropower Co. Ltd.,5,265,260,260,50,13150,265,-5,2017-02-07
Barun Hydropower Co. Ltd.,6,264,257,257,60,15670,260,-3,2017-02-08
Barun Hydropower Co. Ltd.,3,257,254,254,30,7670,257,-3,2017-02-09
Barun Hydropower Co. Ltd.,8,249,241,241,150,37020,254,-13,2017-02-12
Barun Hydropower Co. Ltd.,7,241,230,230,110,26150,241,-11,2017-02-13
Barun Hydropower Co. Ltd.,66,234,220,220,660,151240,230,-10,2017-02-14
Barun Hydropower Co. Ltd.,6,236,224,236,170,39190,220,16,2017-02-15
Barun Hydropower Co. Ltd.,4,244,240,240,50,12040,236,4,2017-02-16
Barun Hydropower Co. Ltd.,9,245,240,241,190,45910,240,1,2017-02-19
Barun Hydropower Co. Ltd.,4,249,245,249,40,9840,241,8,2017-02-20
Barun Hydropower Co. Ltd.,12,253,250,250,200,50300,249,1,2017-02-21
Barun Hydropower Co. Ltd.,6,253,245,253,100,25180,250,3,2017-02-22
Barun Hydropower Co. Ltd.,39,258,249,250,470,119010,253,-3,2017-02-23
Barun Hydropower Co. Ltd.,15,250,237,241,600,145920,250,-9,2017-02-26
Barun Hydropower Co. Ltd.,3,237,233,233,30,7070,241,-8,2017-02-28
Barun Hydropower Co. Ltd.,4,234,230,230,40,9280,233,-3,2017-03-01
Barun Hydropower Co. Ltd.,5,230,230,230,50,11500,230,0,2017-03-02
Barun Hydropower Co. Ltd.,3,230,226,226,30,6820,230,-4,2017-03-05
Barun Hydropower Co. Ltd.,5,236,233,233,50,11710,234,-1,2017-03-21
Barun Hydropower Co. Ltd.,2,226,226,226,20,4520,226,0,2017-03-06
Barun Hydropower Co. Ltd.,3,226,222,226,440,98680,226,0,2017-03-07
Barun Hydropower Co. Ltd.,5,226,223,224,50,11210,226,-2,2017-03-09
Barun Hydropower Co. Ltd.,7,225,223,223,150,33730,224,-1,2017-03-13
Barun Hydropower Co. Ltd.,10,223,220,220,350,77510,223,-3,2017-03-14
Barun Hydropower Co. Ltd.,1,224,224,224,10,2240,220,4,2017-03-15
Barun Hydropower Co. Ltd.,3,228,228,228,30,6840,224,4,2017-03-16
Barun Hydropower Co. Ltd.,7,228,227,228,70,15950,228,0,2017-03-19
Barun Hydropower Co. Ltd.,3,234,232,234,30,6990,228,6,2017-03-20
Barun Hydropower Co. Ltd.,5,238,230,238,50,11740,233,5,2017-03-22
Barun Hydropower Co. Ltd.,21,254,238,254,490,120200,238,16,2017-03-23
Barun Hydropower Co. Ltd.,12,279,259,279,170,45620,254,25,2017-03-26
Barun Hydropower Co. Ltd.,16,304,284,300,1030,305480,279,21,2017-03-28
Barun Hydropower Co. Ltd.,24,318,306,317,440,138730,300,17,2017-03-29
Barun Hydropower Co. Ltd.,25,319,309,313,470,147860,317,-4,2017-03-30
Barun Hydropower Co. Ltd.,11,310,298,298,470,143640,313,-15,2017-04-04
Barun Hydropower Co. Ltd.,12,298,289,298,150,43820,298,0,2017-04-09
Barun Hydropower Co. Ltd.,14,318,293,318,350,107390,298,20,2017-04-10
Barun Hydropower Co. Ltd.,21,318,308,315,260,81740,318,-3,2017-04-11
Barun Hydropower Co. Ltd.,17,311,305,306,750,229160,315,-9,2017-04-12
Barun Hydropower Co. Ltd.,8,300,294,294,80,23820,306,-12,2017-04-13
Barun Hydropower Co. Ltd.,7,294,289,290,190,55410,294,-4,2017-04-16
Barun Hydropower Co. Ltd.,5,285,275,275,70,19550,290,-15,2017-04-18
Barun Hydropower Co. Ltd.,5,280,275,275,140,38550,275,0,2017-04-19
Barun Hydropower Co. Ltd.,9,280,270,280,90,24920,275,5,2017-04-20
Barun Hydropower Co. Ltd.,4,280,280,280,40,11200,280,0,2017-04-23
Barun Hydropower Co. Ltd.,24,285,280,280,390,109450,280,0,2017-04-24
Barun Hydropower Co. Ltd.,16,290,280,290,160,45790,280,10,2017-04-25
Barun Hydropower Co. Ltd.,14,295,290,290,140,40800,290,0,2017-04-26
Barun Hydropower Co. Ltd.,16,285,275,280,250,69500,290,-10,2017-04-27
Barun Hydropower Co. Ltd.,10,280,265,275,620,172690,280,-5,2017-04-30
Barun Hydropower Co. Ltd.,22,270,265,270,220,58480,275,-5,2017-05-02
Barun Hydropower Co. Ltd.,14,275,270,275,140,38250,270,5,2017-05-03
Barun Hydropower Co. Ltd.,27,285,275,280,400,112680,275,5,2017-05-04
Barun Hydropower Co. Ltd.,11,280,275,278,110,30540,280,-2,2017-05-07
Barun Hydropower Co. Ltd.,5,276,275,276,50,13770,278,-2,2017-05-08
Barun Hydropower Co. Ltd.,11,276,273,276,110,30260,276,0,2017-05-09
Barun Hydropower Co. Ltd.,21,295,271,295,280,79840,276,19,2017-05-11
Barun Hydropower Co. Ltd.,6,301,296,297,110,32930,295,2,2017-05-15
Barun Hydropower Co. Ltd.,4,293,288,293,140,40880,297,-4,2017-05-16
Barun Hydropower Co. Ltd.,21,293,282,285,220,62890,293,-8,2017-05-17
Barun Hydropower Co. Ltd.,23,298,285,294,1911,559847,285,9,2017-05-18
Barun Hydropower Co. Ltd.,14,310,291,310,590,173120,294,16,2017-05-21
Barun Hydropower Co. Ltd.,19,310,304,310,310,94840,310,0,2017-05-22
Barun Hydropower Co. Ltd.,14,314,303,308,340,105000,310,-2,2017-05-23
Barun Hydropower Co. Ltd.,15,302,290,290,240,71600,308,-18,2017-05-24
Barun Hydropower Co. Ltd.,22,290,280,285,220,63230,290,-5,2017-05-28
Barun Hydropower Co. Ltd.,61,280,265,280,720,199420,285,-5,2017-05-30
Barun Hydropower Co. Ltd.,11,285,275,280,140,39050,280,0,2017-05-31
Barun Hydropower Co. Ltd.,2,280,280,280,20,5600,280,0,2017-06-01
Barun Hydropower Co. Ltd.,9,278,273,276,90,24800,280,-4,2017-06-04
Barun Hydropower Co. Ltd.,8,280,271,276,80,22020,276,0,2017-06-05
Barun Hydropower Co. Ltd.,11,285,277,285,260,73650,276,9,2017-06-06
Barun Hydropower Co. Ltd.,17,296,280,296,180,51500,285,11,2017-06-07
Barun Hydropower Co. Ltd.,18,291,286,290,220,63660,296,-6,2017-06-08
Barun Hydropower Co. Ltd.,27,295,285,295,340,97310,290,5,2017-06-11
Barun Hydropower Co. Ltd.,7,290,285,285,80,23110,295,-10,2017-06-12
Barun Hydropower Co. Ltd.,27,280,271,275,900,247270,285,-10,2017-06-13
Barun Hydropower Co. Ltd.,8,275,270,272,1260,342830,275,-3,2017-06-14
Barun Hydropower Co. Ltd.,42,279,267,279,450,124290,272,7,2017-06-15
Barun Hydropower Co. Ltd.,5,274,274,274,90,24660,279,-5,2017-06-18
Barun Hydropower Co. Ltd.,7,270,265,270,70,18690,274,-4,2017-06-19
Barun Hydropower Co. Ltd.,11,270,265,270,110,29620,270,0,2017-06-20
Barun Hydropower Co. Ltd.,10,271,265,271,100,27000,270,1,2017-06-21
Barun Hydropower Co. Ltd.,93,273,266,273,930,249480,271,2,2017-06-22
Barun Hydropower Co. Ltd.,7,268,263,263,140,37020,273,-10,2017-06-25
Barun Hydropower Co. Ltd.,9,265,260,261,280,73310,263,-2,2017-06-27
Barun Hydropower Co. Ltd.,10,261,260,261,150,39110,261,0,2017-06-28
Barun Hydropower Co. Ltd.,6,265,261,265,60,15800,261,4,2017-07-02
Barun Hydropower Co. Ltd.,14,265,260,262,140,36990,265,-3,2017-07-03
Barun Hydropower Co. Ltd.,10,260,257,260,100,25940,262,-2,2017-07-04
Barun Hydropower Co. Ltd.,2,255,255,255,60,15300,260,-5,2017-07-05
Barun Hydropower Co. Ltd.,8,265,253,265,80,20650,255,10,2017-07-06
Barun Hydropower Co. Ltd.,10,270,260,260,180,47750,265,-5,2017-07-09
Barun Hydropower Co. Ltd.,10,261,260,260,100,26050,260,0,2017-07-10
Barun Hydropower Co. Ltd.,6,262,255,255,90,23200,260,-5,2017-07-11
Barun Hydropower Co. Ltd.,19,256,251,252,190,48120,255,-3,2017-07-12
Barun Hydropower Co. Ltd.,14,253,248,253,140,35110,252,1,2017-07-13
Barun Hydropower Co. Ltd.,13,252,248,252,130,32500,253,-1,2017-07-16
Barun Hydropower Co. Ltd.,21,255,250,251,270,67920,252,-1,2017-07-17
Barun Hydropower Co. Ltd.,12,260,255,260,120,30870,251,9,2017-07-18
Barun Hydropower Co. Ltd.,15,260,250,260,480,123750,260,0,2017-07-19
Barun Hydropower Co. Ltd.,53,260,250,256,19992,5094360,260,-4,2017-07-20
Barun Hydropower Co. Ltd.,13,254,248,251,370,93520,256,-5,2017-07-23
Barun Hydropower Co. Ltd.,25,250,246,250,250,62000,251,-1,2017-07-24
Barun Hydropower Co. Ltd.,14,270,248,270,1317,335109,250,20,2017-07-25
Barun Hydropower Co. Ltd.,28,275,263,263,280,75670,270,-7,2017-07-26
Barun Hydropower Co. Ltd.,5,265,258,265,50,13110,263,2,2017-07-27
Barun Hydropower Co. Ltd.,1,260,260,260,10,2600,265,-5,2017-07-30
Barun Hydropower Co. Ltd.,27,260,249,250,1812,455400,260,-10,2017-07-31
Barun Hydropower Co. Ltd.,38,260,246,255,602,152690,250,5,2017-08-01
Barun Hydropower Co. Ltd.,28,270,250,270,2727,708731,255,15,2017-08-02
Barun Hydropower Co. Ltd.,10,265,265,265,100,26500,270,-5,2017-08-06
Barun Hydropower Co. Ltd.,20,260,245,250,1410,355800,265,-15,2017-08-07
Barun Hydropower Co. Ltd.,39,250,241,249,2240,551100,250,-1,2017-08-09
Barun Hydropower Co. Ltd.,20,247,241,247,1076,265312,249,-2,2017-08-10
Barun Hydropower Co. Ltd.,15,243,239,243,521,125359,247,-4,2017-08-13
Barun Hydropower Co. Ltd.,4,240,239,240,40,9580,243,-3,2017-08-15
Barun Hydropower Co. Ltd.,9,249,240,245,210,51460,240,5,2017-08-16
Barun Hydropower Co. Ltd.,21,245,241,241,397,96254,245,-4,2017-08-17
Barun Hydropower Co. Ltd.,16,240,239,240,548,131330,241,-1,2017-08-20
Barun Hydropower Co. Ltd.,6,240,236,240,60,14330,240,0,2017-08-21
Barun Hydropower Co. Ltd.,20,246,238,246,572,137372,240,6,2017-08-22
Barun Hydropower Co. Ltd.,29,250,240,245,1306,319597,246,-1,2017-08-23
Barun Hydropower Co. Ltd.,2,242,242,242,20,4840,245,-3,2017-08-24
Barun Hydropower Co. Ltd.,18,240,237,239,270,64440,242,-3,2017-08-27
Barun Hydropower Co. Ltd.,21,248,231,245,920,221190,239,6,2017-08-28
Barun Hydropower Co. Ltd.,21,245,238,238,770,185960,245,-7,2017-08-30
Barun Hydropower Co. Ltd.,10,238,234,236,180,42600,238,-2,2017-08-31
Barun Hydropower Co. Ltd.,9,232,224,226,90,20480,236,-10,2017-09-04
Barun Hydropower Co. Ltd.,20,226,218,226,868,192766,226,0,2017-09-06
Barun Hydropower Co. Ltd.,16,225,216,216,480,104800,226,-10,2017-09-07
Barun Hydropower Co. Ltd.,8,222,214,214,467,100538,216,-2,2017-09-10
Barun Hydropower Co. Ltd.,2,215,214,215,20,4290,214,1,2017-09-11
Barun Hydropower Co. Ltd.,10,214,210,210,180,37940,215,-5,2017-09-12
Barun Hydropower Co. Ltd.,6,218,212,218,350,76080,210,8,2017-09-13
Barun Hydropower Co. Ltd.,17,217,210,213,2536,544268,218,-5,2017-09-14
Barun Hydropower Co. Ltd.,16,210,204,206,324,67108,213,-7,2017-09-17
Barun Hydropower Co. Ltd.,22,206,196,197,1066,214208,206,-9,2017-09-18
Barun Hydropower Co. Ltd.,12,203,194,203,1050,209116,197,6,2017-09-20
Barun Hydropower Co. Ltd.,6,223,207,223,60,12980,203,20,2017-09-24
Barun Hydropower Co. Ltd.,63,245,214,214,6728,1530054,223,-9,2017-09-25
Barun Hydropower Co. Ltd.,32,233,217,222,1633,363267,214,8,2017-09-26
Barun Hydropower Co. Ltd.,15,222,218,219,1335,294815,222,-3,2017-10-03
Barun Hydropower Co. Ltd.,4,217,210,213,40,8530,209,4,2017-10-04
Barun Hydropower Co. Ltd.,3,214,210,214,58,12332,213,1,2017-10-08
Barun Hydropower Co. Ltd.,4,210,206,210,40,8350,214,-4,2017-10-10
Barun Hydropower Co. Ltd.,4,206,202,203,40,8170,210,-7,2017-10-11
Barun Hydropower Co. Ltd.,2,199,199,199,20,3980,203,-4,2017-10-15
Barun Hydropower Co. Ltd.,6,204,197,200,70,13980,199,1,2017-10-16
Barun Hydropower Co. Ltd.,4,199,196,199,80,15770,200,-1,2017-10-17
Barun Hydropower Co. Ltd.,11,213,198,209,187,38243,199,10,2017-10-18
Barun Hydropower Co. Ltd.,11,222,213,220,1065,233080,209,11,2017-10-22
Barun Hydropower Co. Ltd.,7,220,220,220,184,40480,220,0,2017-10-23
Barun Hydropower Co. Ltd.,14,232,217,232,495,112220,220,12,2017-10-24
Barun Hydropower Co. Ltd.,12,230,218,218,2292,509064,232,-14,2017-10-25
Barun Hydropower Co. Ltd.,5,214,210,210,50,10540,218,-8,2017-10-29
Barun Hydropower Co. Ltd.,9,211,207,211,1082,224384,210,1,2017-10-30
Barun Hydropower Co. Ltd.,5,211,207,207,243,51193,211,-4,2017-10-31
Barun Hydropower Co. Ltd.,11,207,203,207,110,22480,207,0,2017-11-01
Barun Hydropower Co. Ltd.,12,210,205,206,508,105214,207,-1,2017-11-02
Barun Hydropower Co. Ltd.,16,205,203,205,874,178306,206,-1,2017-11-05
Barun Hydropower Co. Ltd.,34,208,201,208,430,88630,205,3,2017-11-06
Barun Hydropower Co. Ltd.,14,205,204,205,220,44970,208,-3,2017-11-07
Barun Hydropower Co. Ltd.,3,203,202,203,60,12170,205,-2,2017-11-08
Barun Hydropower Co. Ltd.,11,202,197,197,150,29980,203,-6,2017-11-09
Barun Hydropower Co. Ltd.,8,205,200,204,274,55782,197,7,2017-11-12
Barun Hydropower Co. Ltd.,7,205,204,204,70,14290,204,0,2017-11-13
Barun Hydropower Co. Ltd.,15,206,200,202,220,44720,204,-2,2017-11-14
Barun Hydropower Co. Ltd.,3,206,202,203,50,10170,202,1,2017-11-15
Barun Hydropower Co. Ltd.,1,200,200,200,10,2000,203,-3,2017-11-16
Barun Hydropower Co. Ltd.,16,202,196,201,1567,314777,200,1,2017-11-19
Barun Hydropower Co. Ltd.,6,197,192,195,60,11620,201,-6,2017-11-20
Barun Hydropower Co. Ltd.,10,202,195,202,438,87232,195,7,2017-11-21
Barun Hydropower Co. Ltd.,10,204,198,204,100,20150,202,2,2017-11-22
Barun Hydropower Co. Ltd.,12,201,196,198,358,71788,204,-6,2017-11-23
Barun Hydropower Co. Ltd.,9,198,195,197,90,17690,198,-1,2017-11-26
Barun Hydropower Co. Ltd.,5,200,195,200,240,47710,197,3,2017-11-27
Barun Hydropower Co. Ltd.,9,204,197,201,328,65948,200,1,2017-11-28
Barun Hydropower Co. Ltd.,6,205,202,204,298,60286,201,3,2017-11-29
Barun Hydropower Co. Ltd.,3,208,200,208,398,81712,204,4,2017-11-30
Barun Hydropower Co. Ltd.,6,204,199,200,398,79660,208,-8,2017-12-04
Barun Hydropower Co. Ltd.,10,204,200,201,100,20060,200,1,2017-12-20
Barun Hydropower Co. Ltd.,8,201,198,201,80,15890,200,1,2017-12-05
Barun Hydropower Co. Ltd.,10,204,200,201,190,38130,201,0,2017-12-06
Barun Hydropower Co. Ltd.,15,208,201,202,1407,291916,201,1,2017-12-10
Barun Hydropower Co. Ltd.,13,213,203,209,710,147822,202,7,2017-12-11
Barun Hydropower Co. Ltd.,7,205,201,202,130,26400,209,-7,2017-12-12
Barun Hydropower Co. Ltd.,17,209,197,205,1132,228532,202,3,2017-12-13
Barun Hydropower Co. Ltd.,1,201,201,201,10,2010,205,-4,2017-12-14
Barun Hydropower Co. Ltd.,13,206,202,202,250,50910,201,1,2017-12-17
Barun Hydropower Co. Ltd.,10,205,201,202,100,20230,202,0,2017-12-18
Barun Hydropower Co. Ltd.,14,208,200,200,280,56820,202,-2,2017-12-19
Barun Hydropower Co. Ltd.,9,200,197,197,170,33910,201,-4,2017-12-21
Barun Hydropower Co. Ltd.,8,208,200,206,80,16360,197,9,2017-12-24
Barun Hydropower Co. Ltd.,7,209,202,202,70,14370,206,-4,2017-12-26
Barun Hydropower Co. Ltd.,9,201,198,199,240,47800,202,-3,2017-12-27
Barun Hydropower Co. Ltd.,9,201,199,199,1088,217224,199,0,2017-12-28
Barun Hydropower Co. Ltd.,7,197,186,186,1495,290435,199,-13,2017-12-31
Barun Hydropower Co. Ltd.,7,194,189,194,150,28580,186,8,2018-01-01
Barun Hydropower Co. Ltd.,4,197,194,195,120,23590,194,1,2018-01-02
Barun Hydropower Co. Ltd.,8,198,192,198,280,55070,195,3,2018-01-03
Barun Hydropower Co. Ltd.,9,198,193,195,729,142735,198,-3,2018-01-04
Barun Hydropower Co. Ltd.,8,195,192,193,80,15420,195,-2,2018-01-07
Barun Hydropower Co. Ltd.,10,197,190,194,410,79080,193,1,2018-01-08
Barun Hydropower Co. Ltd.,3,195,195,195,30,5850,194,1,2018-01-09
Barun Hydropower Co. Ltd.,5,196,191,191,50,9690,195,-4,2018-01-10
Barun Hydropower Co. Ltd.,15,194,188,190,1247,238501,191,-1,2018-01-14
Barun Hydropower Co. Ltd.,8,190,187,188,495,93440,190,-2,2018-01-16
Barun Hydropower Co. Ltd.,8,190,185,190,200,37240,188,2,2018-01-17
Barun Hydropower Co. Ltd.,8,188,185,188,120,22440,190,-2,2018-01-21
Barun Hydropower Co. Ltd.,6,188,188,188,60,11280,188,0,2018-01-22
Barun Hydropower Co. Ltd.,4,190,187,190,170,32030,188,2,2018-01-23
Barun Hydropower Co. Ltd.,2,190,190,190,75,14250,190,0,2018-01-24
Barun Hydropower Co. Ltd.,10,188,187,188,130,24380,190,-2,2018-01-25
Barun Hydropower Co. Ltd.,9,191,188,189,90,16980,188,1,2018-01-28
Barun Hydropower Co. Ltd.,13,186,180,185,360,65610,189,-4,2018-01-29
Barun Hydropower Co. Ltd.,8,190,186,186,120,22440,185,1,2018-01-31
Barun Hydropower Co. Ltd.,8,189,183,183,720,134280,186,-3,2018-02-01
Barun Hydropower Co. Ltd.,2,184,181,184,20,3650,183,1,2018-02-04
Barun Hydropower Co. Ltd.,4,182,181,181,120,21820,184,-3,2018-02-05
Barun Hydropower Co. Ltd.,4,181,180,181,40,7220,181,0,2018-02-06
Barun Hydropower Co. Ltd.,12,182,175,182,130,23080,181,1,2018-02-07
Barun Hydropower Co. Ltd.,1,181,181,181,10,1810,182,-1,2018-02-08
Barun Hydropower Co. Ltd.,7,184,181,182,70,12830,187,-5,2018-02-25
Barun Hydropower Co. Ltd.,6,187,184,187,370,68720,181,6,2018-02-11
Barun Hydropower Co. Ltd.,23,192,190,190,655,124590,187,3,2018-02-12
Barun Hydropower Co. Ltd.,4,187,184,187,40,7450,190,-3,2018-02-14
Barun Hydropower Co. Ltd.,12,196,190,196,770,148830,187,9,2018-02-15
Barun Hydropower Co. Ltd.,4,199,193,199,90,17700,196,3,2018-02-18
Barun Hydropower Co. Ltd.,2,196,193,193,110,21530,199,-6,2018-02-20
Barun Hydropower Co. Ltd.,5,190,190,190,60,11400,193,-3,2018-02-21
Barun Hydropower Co. Ltd.,10,190,187,187,330,62010,190,-3,2018-02-22
Barun Hydropower Co. Ltd.,3,180,179,179,150,26900,182,-3,2018-02-26
Barun Hydropower Co. Ltd.,4,179,176,179,80,14280,179,0,2018-02-27
Barun Hydropower Co. Ltd.,5,179,179,179,50,8950,179,0,2018-02-28
Barun Hydropower Co. Ltd.,11,178,176,178,110,19380,179,-1,2018-03-04
Barun Hydropower Co. Ltd.,5,175,172,172,50,8690,178,-6,2018-03-06
Barun Hydropower Co. Ltd.,12,180,172,177,1710,301620,172,5,2018-03-07
Barun Hydropower Co. Ltd.,8,179,171,171,410,71010,177,-6,2018-03-11
Barun Hydropower Co. Ltd.,17,170,165,165,2483,414824,171,-6,2018-03-12
Barun Hydropower Co. Ltd.,12,174,162,171,570,97780,165,6,2018-03-13
Barun Hydropower Co. Ltd.,3,177,174,177,110,19290,171,6,2018-03-14
Barun Hydropower Co. Ltd.,13,184,180,184,530,96740,177,7,2018-03-15
Barun Hydropower Co. Ltd.,12,190,184,189,1327,248931,184,5,2018-03-19
Barun Hydropower Co. Ltd.,12,192,186,190,614,117166,189,1,2018-03-20
Barun Hydropower Co. Ltd.,7,189,184,186,832,155742,190,-4,2018-03-21
Barun Hydropower Co. Ltd.,8,187,183,187,274,50566,186,1,2018-03-22
Barun Hydropower Co. Ltd.,10,188,184,187,1214,224596,187,0,2018-03-26
Barun Hydropower Co. Ltd.,6,184,181,184,2296,422434,187,-3,2018-03-27
Barun Hydropower Co. Ltd.,12,193,184,191,1280,239498,184,7,2018-03-28
Barun Hydropower Co. Ltd.,7,197,194,194,820,159660,191,3,2018-03-29
Barun Hydropower Co. Ltd.,9,193,188,191,260,49660,194,-3,2018-04-01
Barun Hydropower Co. Ltd.,1,194,194,194,126,24444,191,3,2018-04-02
Barun Hydropower Co. Ltd.,10,191,182,183,1270,237362,194,-11,2018-04-03
Barun Hydropower Co. Ltd.,3,183,182,182,30,5470,183,-1,2018-04-04
Barun Hydropower Co. Ltd.,3,185,182,182,70,12890,182,0,2018-04-05
Barun Hydropower Co. Ltd.,4,183,180,183,419,76057,182,1,2018-04-08
Barun Hydropower Co. Ltd.,5,186,184,184,110,20440,183,1,2018-04-09
Barun Hydropower Co. Ltd.,7,183,179,179,70,12650,184,-5,2018-04-10
Barun Hydropower Co. Ltd.,2,176,175,175,20,3510,179,-4,2018-04-11
Barun Hydropower Co. Ltd.,20,176,171,171,1702,293606,175,-4,2018-04-12
Barun Hydropower Co. Ltd.,3,177,174,177,90,15840,171,6,2018-04-15
Barun Hydropower Co. Ltd.,11,178,171,178,234,40428,177,1,2018-04-16
Barun Hydropower Co. Ltd.,4,187,181,187,80,14630,178,9,2018-04-18
Barun Hydropower Co. Ltd.,22,193,184,193,930,173268,187,6,2018-04-19
Barun Hydropower Co. Ltd.,19,196,188,196,1330,254850,193,3,2018-04-22
Barun Hydropower Co. Ltd.,6,193,187,187,380,73130,196,-9,2018-04-23
Barun Hydropower Co. Ltd.,12,187,184,185,169,31363,187,-2,2018-04-24
Barun Hydropower Co. Ltd.,21,185,180,181,428,77420,185,-4,2018-04-25
Barun Hydropower Co. Ltd.,11,183,178,180,888,160916,181,-1,2018-04-26
Barun Hydropower Co. Ltd.,12,177,166,166,2290,384640,180,-14,2018-04-29
Barun Hydropower Co. Ltd.,12,173,166,171,128,21774,166,5,2018-05-02
Barun Hydropower Co. Ltd.,26,175,166,167,4059,683349,171,-4,2018-05-03
Barun Hydropower Co. Ltd.,34,169,157,169,5155,841321,167,2,2018-05-06
Barun Hydropower Co. Ltd.,31,174,165,170,5010,840780,169,1,2018-05-07
Barun Hydropower Co. Ltd.,28,173,165,169,4974,831661,170,-1,2018-05-08
Barun Hydropower Co. Ltd.,17,170,163,163,1260,207525,169,-6,2018-05-09
Barun Hydropower Co. Ltd.,21,169,164,167,3495,581810,163,4,2018-05-10
Barun Hydropower Co. Ltd.,10,167,165,165,580,96710,167,-2,2018-05-14
Barun Hydropower Co. Ltd.,2,165,165,165,20,3300,165,0,2018-05-15
Barun Hydropower Co. Ltd.,7,166,162,164,70,11520,165,-1,2018-05-16
Barun Hydropower Co. Ltd.,3,166,164,165,67,11085,164,1,2018-05-17
Barun Hydropower Co. Ltd.,6,166,163,163,1000,165050,165,-2,2018-05-20
Barun Hydropower Co. Ltd.,10,163,159,162,1561,250912,163,-1,2018-05-21
Barun Hydropower Co. Ltd.,6,161,160,160,540,86430,162,-2,2018-05-22
Best Finance Co. Limited Promoter Share,11,75,75,75,51748,3881100,75,0,2016-06-06
Best Finance Co. Limited Promoter Share,1,101,101,101,54111,5465211,103,-2,2017-08-30
Best Finance Co. Limited Promoter Share,4,101,101,101,33316,3364916,101,0,2017-09-20
Best Finance Co. Limited Promoter Share,1,102,102,102,11952,1219104,103,-1,2017-11-23
Best Finance Company Ltd.,20,414,380,380,1250,486860,422,-42,2017-08-03
Best Finance Company Ltd.,2,430,430,430,60,25800,430,0,2017-07-31
Best Finance Company Ltd.,8,422,422,422,22746,1990680,430,-8,2017-08-02
Best Finance Company Ltd.,5,373,345,345,445,160665,380,-35,2017-08-06
Best Finance Company Ltd.,2,339,339,339,150,50850,345,-6,2017-08-07
Best Finance Company Ltd.,16,339,309,309,2080,671160,339,-30,2017-08-09
Best Finance Company Ltd.,2,190,190,190,120,22800,193,-3,2017-08-10
Best Finance Company Ltd.,1,189,189,189,50,9450,190,-1,2017-08-13
Best Finance Company Ltd.,3,186,183,183,18101,3366186,189,-6,2017-08-20
Best Finance Company Ltd.,9,180,165,165,30940,5424410,183,-18,2017-08-24
Best Finance Company Ltd.,16,162,149,149,1900,284850,165,-16,2017-08-27
Best Finance Company Ltd.,22,147,135,135,6614,893790,149,-14,2017-08-28
Best Finance Company Ltd.,36,134,122,134,17372,2166954,135,-1,2017-08-30
Best Finance Company Ltd.,5,140,136,140,4940,672140,134,6,2017-08-31
Best Finance Company Ltd.,3,140,138,140,500,69800,140,0,2017-09-04
Best Finance Company Ltd.,8,142,136,138,1660,229240,140,-2,2017-09-06
Best Finance Company Ltd.,6,140,136,136,3320,461720,138,-2,2017-09-07
Best Finance Company Ltd.,16,134,123,125,2960,369100,136,-11,2017-09-10
Best Finance Company Ltd.,4,123,119,119,166,19854,125,-6,2017-09-11
Best Finance Company Ltd.,2,117,115,115,40,4660,119,-4,2017-09-12
Best Finance Company Ltd.,10,118,110,118,5350,611910,115,3,2017-09-13
Best Finance Company Ltd.,7,126,120,123,1000,123100,118,5,2017-09-14
Best Finance Company Ltd.,2,126,124,126,146,18304,123,3,2017-09-17
Best Finance Company Ltd.,7,132,128,130,2160,280800,126,4,2017-09-18
Best Finance Company Ltd.,3,134,132,134,154,20348,130,4,2017-09-20
Best Finance Company Ltd.,5,131,127,127,810,104790,133,-6,2017-10-09
Best Finance Company Ltd.,10,137,132,137,1890,253080,134,3,2017-09-24
Best Finance Company Ltd.,3,136,135,135,950,128290,137,-2,2017-09-25
Best Finance Company Ltd.,5,138,135,138,670,92050,135,3,2017-09-26
Best Finance Company Ltd.,1,138,138,138,50,6900,138,0,2017-10-03
Best Finance Company Ltd.,3,136,134,134,1150,155600,138,-4,2017-10-04
Best Finance Company Ltd.,5,133,131,133,780,103310,134,-1,2017-10-08
Best Finance Company Ltd.,19,127,120,122,6000,738800,127,-5,2017-10-11
Best Finance Company Ltd.,9,127,123,127,1728,213470,122,5,2017-10-12
Best Finance Company Ltd.,18,139,129,139,2700,372240,127,12,2017-10-15
Best Finance Company Ltd.,12,152,141,152,5075,766200,139,13,2017-10-16
Best Finance Company Ltd.,35,167,155,167,5990,998170,152,15,2017-10-17
Best Finance Company Ltd.,29,170,151,152,4140,652990,167,-15,2017-10-18
Best Finance Company Ltd.,3,149,147,149,1025,152705,152,-3,2017-10-23
Best Finance Company Ltd.,7,151,148,148,1476,220765,149,-1,2017-10-24
Best Finance Company Ltd.,10,149,145,145,1610,236060,148,-3,2017-10-25
Best Finance Company Ltd.,9,143,139,139,1780,249420,145,-6,2017-10-29
Best Finance Company Ltd.,6,139,135,139,1670,228090,139,0,2017-10-30
Best Finance Company Ltd.,2,141,141,141,31150,4392150,139,2,2017-10-31
Best Finance Company Ltd.,5,139,137,137,510,70010,141,-4,2017-11-01
Best Finance Company Ltd.,5,135,131,131,530,69970,137,-6,2017-11-05
Best Finance Company Ltd.,2,131,130,130,200,26100,131,-1,2017-11-06
Best Finance Company Ltd.,2,132,130,132,200,26200,130,2,2017-11-07
Best Finance Company Ltd.,3,131,128,128,210,27380,132,-4,2017-11-08
Best Finance Company Ltd.,4,136,130,136,350,46600,128,8,2017-11-12
Best Finance Company Ltd.,4,138,136,136,800,109200,136,0,2017-11-13
Best Finance Company Ltd.,8,138,136,136,1900,261400,136,0,2017-11-15
Best Finance Company Ltd.,2,136,135,135,700,95000,136,-1,2017-11-19
Best Finance Company Ltd.,3,133,131,131,300,39500,135,-4,2017-11-20
Best Finance Company Ltd.,6,135,132,133,1601,211978,131,2,2017-11-21
Best Finance Company Ltd.,3,133,131,133,650,85350,133,0,2017-11-22
Best Finance Company Ltd.,6,134,131,132,31816,4230556,133,-1,2017-11-23
Best Finance Company Ltd.,8,134,130,132,1345,175536,132,0,2017-11-27
Best Finance Company Ltd.,9,134,130,134,15741,2047242,132,2,2017-11-28
Best Finance Company Ltd.,2,136,134,136,240,32240,134,2,2017-11-29
Best Finance Company Ltd.,2,138,136,136,170,23320,136,0,2017-11-30
Best Finance Company Ltd.,3,134,132,134,400,53400,136,-2,2017-12-04
Best Finance Company Ltd.,1,133,133,133,100,13300,134,-1,2017-12-05
Best Finance Company Ltd.,1,135,135,135,50,6750,133,2,2017-12-06
Best Finance Company Ltd.,2,135,133,133,750,99950,135,-2,2017-12-10
Best Finance Company Ltd.,5,133,131,132,16550,2184600,133,-1,2017-12-13
Best Finance Company Ltd.,8,139,134,139,2546,344874,132,7,2017-12-14
Best Finance Company Ltd.,3,140,139,140,500,69700,139,1,2017-12-17
Best Finance Company Ltd.,4,144,142,142,900,128900,140,2,2017-12-18
Best Finance Company Ltd.,3,142,138,138,196,27540,142,-4,2017-12-21
Best Finance Company Ltd.,3,138,134,134,16310,2249560,138,-4,2017-12-24
Best Finance Company Ltd.,7,132,130,130,1555,202230,134,-4,2017-12-26
Best Finance Company Ltd.,1,128,128,128,50,6400,130,-2,2017-12-31
Best Finance Company Ltd.,1,128,128,128,100,12800,128,0,2018-01-02
Best Finance Company Ltd.,2,127,126,127,550,69800,128,-1,2018-01-03
Best Finance Company Ltd.,3,131,129,131,680,87940,127,4,2018-01-04
Best Finance Company Ltd.,2,133,131,131,160,21160,131,0,2018-01-07
Best Finance Company Ltd.,4,139,133,139,50,6830,131,8,2018-01-09
Best Finance Company Ltd.,4,137,133,133,895,121155,139,-6,2018-01-22
Best Finance Company Ltd.,9,131,129,129,1033,133452,133,-4,2018-01-23
Best Finance Company Ltd.,5,127,125,127,480,60160,129,-2,2018-01-24
Best Finance Company Ltd.,4,129,127,129,600,76940,127,2,2018-01-25
Best Finance Company Ltd.,5,129,127,129,416,53644,129,0,2018-01-28
Best Finance Company Ltd.,1,129,129,129,200,25800,129,0,2018-02-04
Best Finance Company Ltd.,5,129,125,125,470,58810,129,-4,2018-02-06
Best Finance Company Ltd.,1,123,123,123,100,12300,125,-2,2018-02-11
Best Finance Company Ltd.,1,121,121,121,50,6050,123,-2,2018-02-12
Best Finance Company Ltd.,11,125,119,123,4990,604640,121,2,2018-02-15
Best Finance Company Ltd.,10,123,121,121,2910,354250,123,-2,2018-02-18
Best Finance Company Ltd.,6,123,120,121,2300,280000,121,0,2018-02-20
Best Finance Company Ltd.,1,123,123,123,10,1230,121,2,2018-02-26
Best Finance Company Ltd.,2,123,122,123,200,24550,123,0,2018-02-27
Best Finance Company Ltd.,2,121,121,121,1000,121000,123,-2,2018-02-28
Best Finance Company Ltd.,4,121,121,121,678,82038,121,0,2018-03-04
Best Finance Company Ltd.,1,119,119,119,500,59500,121,-2,2018-03-05
Best Finance Company Ltd.,5,119,117,117,1700,199300,119,-2,2018-03-06
Best Finance Company Ltd.,2,121,119,121,20,2400,117,4,2018-03-07
Best Finance Company Ltd.,4,123,121,123,310,38110,121,2,2018-03-11
Best Finance Company Ltd.,6,124,122,124,1347,166028,123,1,2018-03-12
Best Finance Company Ltd.,1,124,124,124,100,12400,124,0,2018-03-13
Best Finance Company Ltd.,1,122,122,122,45,5490,124,-2,2018-03-15
Best Finance Company Ltd.,2,126,124,126,50,6220,122,4,2018-03-18
Best Finance Company Ltd.,3,125,124,125,135,16775,126,-1,2018-03-19
Best Finance Company Ltd.,2,123,123,123,100,12300,125,-2,2018-03-20
Best Finance Company Ltd.,6,121,119,119,15970,1929430,123,-4,2018-03-21
Best Finance Company Ltd.,1,118,118,118,50,5900,119,-1,2018-04-01
Best Finance Company Ltd.,1,116,116,116,220,25520,118,-2,2018-04-05
Best Finance Company Ltd.,5,120,116,116,14000,1650200,116,0,2018-04-08
Best Finance Company Ltd.,2,120,118,120,400,47600,116,4,2018-04-09
Best Finance Company Ltd.,8,122,118,118,2220,263760,120,-2,2018-04-10
Best Finance Company Ltd.,1,118,118,118,100,11800,118,0,2018-04-11
Best Finance Company Ltd.,1,120,120,120,100,12000,118,2,2018-04-12
Best Finance Company Ltd.,2,122,120,120,210,25220,120,0,2018-04-15
Best Finance Company Ltd.,3,121,120,121,232,27982,120,1,2018-04-16
Best Finance Company Ltd.,2,125,123,125,100,12400,121,4,2018-04-17
Best Finance Company Ltd.,1,127,127,127,200,25400,125,2,2018-04-18
Best Finance Company Ltd.,7,127,125,125,820,103300,127,-2,2018-04-19
Best Finance Company Ltd.,2,129,127,129,200,25780,125,4,2018-04-22
Best Finance Company Ltd.,9,130,127,127,1900,242300,129,-2,2018-04-23
Best Finance Company Ltd.,2,127,126,127,320,40440,127,0,2018-04-24
Best Finance Company Ltd.,1,126,126,126,100,12600,127,-1,2018-05-17
Bhargav Bikash Bank Ltd.,14,394,390,390,2660,1044120,385,5,2016-05-23
Bhargav Bikash Bank Ltd.,12,395,388,395,3180,1254050,390,5,2016-05-24
Bhargav Bikash Bank Ltd.,13,409,399,404,4081,1643874,395,9,2016-05-25
Bhargav Bikash Bank Ltd.,22,428,400,428,7820,3177270,404,24,2016-05-26
Bhargav Bikash Bank Ltd.,11,444,429,442,2510,1101960,428,14,2016-05-29
Bhargav Bikash Bank Ltd.,9,445,436,436,2490,1101310,442,-6,2016-05-30
Bhargav Bikash Bank Ltd.,9,430,426,426,2250,964000,436,-10,2016-05-31
Bhargav Bikash Bank Ltd.,13,435,430,432,5000,2162900,426,6,2016-06-01
Bhargav Bikash Bank Ltd.,6,431,430,430,1100,473600,432,-2,2016-06-02
Bhargav Bikash Bank Ltd.,8,434,420,420,1590,678120,430,-10,2016-06-05
Bhargav Bikash Bank Ltd.,5,428,420,420,1570,664110,420,0,2016-06-06
Bhargav Bikash Bank Ltd.,3,423,415,423,890,370950,420,3,2016-06-07
Bhargav Bikash Bank Ltd.,23,600,570,580,3268,1912590,590,-10,2016-06-23
Bhargav Bikash Bank Ltd.,3,422,417,422,800,335700,423,-1,2016-06-08
Bhargav Bikash Bank Ltd.,9,431,426,426,3290,1405700,422,4,2016-06-09
Bhargav Bikash Bank Ltd.,2,421,418,418,380,159320,426,-8,2016-06-12
Bhargav Bikash Bank Ltd.,20,445,426,440,12153,5300215,418,22,2016-06-13
Bhargav Bikash Bank Ltd.,25,484,448,484,6571,3157164,440,44,2016-06-14
Bhargav Bikash Bank Ltd.,40,522,493,506,7710,3925880,484,22,2016-06-15
Bhargav Bikash Bank Ltd.,14,556,516,556,3640,1997640,506,50,2016-06-16
Bhargav Bikash Bank Ltd.,61,611,567,597,17060,10165570,556,41,2016-06-19
Bhargav Bikash Bank Ltd.,74,625,601,616,16046,9921610,597,19,2016-06-20
Bhargav Bikash Bank Ltd.,27,616,598,600,5741,3464748,616,-16,2016-06-21
Bhargav Bikash Bank Ltd.,21,607,585,590,4261,2526790,600,-10,2016-06-22
Bhargav Bikash Bank Ltd.,18,585,565,570,2990,1707400,580,-10,2016-06-26
Bhargav Bikash Bank Ltd.,13,560,545,550,2491,1368687,570,-20,2016-06-27
Bhargav Bikash Bank Ltd.,37,601,560,601,7680,4498810,550,51,2016-06-28
Bhargav Bikash Bank Ltd.,12,550,511,529,2270,1217520,501,28,2016-06-29
Bhargav Bikash Bank Ltd.,1,520,520,520,300,156000,529,-9,2016-06-30
Bhargav Bikash Bank Ltd.,3,515,500,500,420,212800,520,-20,2016-07-03
Bhargav Bikash Bank Ltd.,9,530,500,528,1665,852375,500,28,2016-07-04
Bhargav Bikash Bank Ltd.,14,535,530,532,2200,1169700,528,4,2016-07-05
Bhargav Bikash Bank Ltd.,7,550,535,550,1800,972960,532,18,2016-07-06
Bhargav Bikash Bank Ltd.,2,561,560,561,500,280400,550,11,2016-07-10
Bhargav Bikash Bank Ltd.,3,565,561,565,1100,617500,561,4,2016-07-11
Bhargav Bikash Bank Ltd.,12,580,555,560,1830,1026390,565,-5,2016-07-12
Bhargav Bikash Bank Ltd.,3,561,550,550,220,122650,560,-10,2016-07-13
Bhargav Bikash Bank Ltd.,2,555,550,555,820,454600,550,5,2016-07-14
Bhargav Bikash Bank Ltd.,4,550,544,550,850,465400,555,-5,2016-07-17
Bhargav Bikash Bank Ltd.,8,576,560,576,903,508220,550,26,2016-07-18
Bhargav Bikash Bank Ltd.,3,585,576,585,400,233100,576,9,2016-07-19
Bhargav Bikash Bank Ltd.,2,590,590,590,300,177000,585,5,2016-07-20
Bhargav Bikash Bank Ltd.,5,590,589,590,1020,601780,590,0,2016-07-21
Bhargav Bikash Bank Ltd.,13,600,586,599,2880,1722730,590,9,2016-07-25
Bhargav Bikash Bank Ltd.,12,624,600,615,1488,905950,599,16,2016-07-26
Bhargav Bikash Bank Ltd.,21,603,580,589,7120,4193820,615,-26,2016-07-27
Bhargav Bikash Bank Ltd.,12,600,588,589,1350,795280,589,0,2016-07-28
Bhargav Bikash Bank Ltd.,8,600,590,594,2350,1397800,589,5,2016-07-31
Bhargav Bikash Bank Ltd.,18,602,590,601,2800,1673600,594,7,2016-08-01
Bhargav Bikash Bank Ltd.,3,600,589,589,580,347120,601,-12,2016-08-02
Bhargav Bikash Bank Ltd.,11,590,581,586,1400,823300,589,-3,2016-08-03
Bhargav Bikash Bank Ltd.,4,576,576,576,900,518400,586,-10,2016-08-04
Bhargav Bikash Bank Ltd.,3,570,560,560,600,339250,576,-16,2016-08-07
Bhargav Bikash Bank Ltd.,2,551,550,550,300,165100,560,-10,2016-08-08
Bhargav Bikash Bank Ltd.,9,590,560,571,550,313460,550,21,2016-08-10
Bhargav Bikash Bank Ltd.,5,575,564,565,570,321910,571,-6,2016-08-11
Bhargav Bikash Bank Ltd.,2,570,560,560,200,112500,568,-8,2016-08-31
Bhargav Bikash Bank Ltd.,1,554,554,554,200,110800,565,-11,2016-08-16
Bhargav Bikash Bank Ltd.,1,554,554,554,60,33240,554,0,2016-08-17
Bhargav Bikash Bank Ltd.,2,543,533,533,220,118260,554,-21,2016-08-22
Bhargav Bikash Bank Ltd.,2,523,523,523,326,170498,533,-10,2016-08-23
Bhargav Bikash Bank Ltd.,2,523,515,515,730,376750,523,-8,2016-08-24
Bhargav Bikash Bank Ltd.,3,545,525,545,70,37850,515,30,2016-08-28
Bhargav Bikash Bank Ltd.,3,566,555,566,30,16760,545,21,2016-08-29
Bhargav Bikash Bank Ltd.,1,568,568,568,50,28400,566,2,2016-08-30
Bhargav Bikash Bank Ltd.,2,550,550,550,600,330000,560,-10,2016-09-01
Bhargav Bikash Bank Ltd.,2,550,550,550,520,286000,550,0,2016-09-04
Bhargav Bikash Bank Ltd.,2,555,550,555,200,110500,550,5,2016-09-05
Bhargav Bikash Bank Ltd.,1,551,551,551,200,110200,555,-4,2016-09-07
Bhargav Bikash Bank Ltd.,9,560,545,560,3268,1815230,551,9,2016-09-08
Bhargav Bikash Bank Ltd.,2,575,570,575,300,172000,560,15,2016-09-11
Bhargav Bikash Bank Ltd.,7,575,575,575,830,477250,575,0,2016-09-14
Bhargav Bikash Bank Ltd.,4,585,575,575,640,370000,575,0,2016-09-18
Bhargav Bikash Bank Ltd.,8,575,564,566,1760,996300,575,-9,2016-09-20
Bhargav Bikash Bank Ltd.,2,560,560,560,1500,840000,566,-6,2016-09-21
Bhargav Bikash Bank Ltd.,5,560,555,560,560,311500,560,0,2016-09-22
Bhargav Bikash Bank Ltd.,2,551,550,551,500,275330,560,-9,2016-09-25
Bhargav Bikash Bank Ltd.,2,545,545,545,1000,545000,551,-6,2016-09-27
Bhargav Bikash Bank Ltd.,2,540,540,540,150,81000,545,-5,2016-09-29
Bhargav Bikash Bank Ltd.,1,531,531,531,500,265500,540,-9,2016-10-02
Bhargav Bikash Bank Ltd.,2,535,525,535,500,266500,531,4,2016-10-04
Bhargav Bikash Bank Ltd.,3,545,540,540,500,271300,535,5,2016-10-16
Bhargav Bikash Bank Ltd.,4,535,530,533,1123,598805,540,-7,2016-10-17
Bhargav Bikash Bank Ltd.,1,525,525,525,60,31500,533,-8,2016-10-20
Bhargav Bikash Bank Ltd.,1,525,525,525,130,68250,525,0,2016-10-25
Bhargav Bikash Bank Ltd.,1,515,515,515,500,257500,525,-10,2016-10-26
Bhargav Bikash Bank Ltd.,1,525,525,525,20,10500,515,10,2016-11-03
Bhargav Bikash Bank Ltd.,2,535,525,535,200,106000,525,10,2016-11-08
Bhargav Bikash Bank Ltd.,2,535,535,535,500,267500,535,0,2016-11-09
Bhargav Bikash Bank Ltd.,4,545,535,535,650,348250,535,0,2016-11-13
Bhargav Bikash Bank Ltd.,2,545,535,545,120,65200,535,10,2016-11-14
Bhargav Bikash Bank Ltd.,1,545,545,545,100,54500,545,0,2016-11-15
Bhargav Bikash Bank Ltd.,2,540,530,530,150,80500,545,-15,2016-11-20
Bhargav Bikash Bank Ltd.,7,520,508,510,1700,869200,530,-20,2016-11-22
Bhargav Bikash Bank Ltd.,5,502,473,473,1268,624338,510,-37,2016-11-23
Bhargav Bikash Bank Ltd.,8,467,447,447,1200,547500,473,-26,2016-11-24
Bhargav Bikash Bank Ltd.,1,455,455,455,10,4550,447,8,2016-11-30
Bhargav Bikash Bank Ltd.,4,466,464,465,580,269750,455,10,2016-12-01
Bhargav Bikash Bank Ltd.,5,456,455,456,1690,770060,465,-9,2016-12-04
Bhargav Bikash Bank Ltd.,4,450,447,447,500,224090,456,-9,2016-12-05
Bhargav Bikash Bank Ltd.,1,440,440,440,100,44000,447,-7,2016-12-08
Bhargav Bikash Bank Ltd.,4,434,433,433,2400,1040400,440,-7,2016-12-11
Bhargav Bikash Bank Ltd.,1,425,425,425,500,212500,433,-8,2016-12-12
Bhargav Bikash Bank Ltd.,2,417,417,417,1170,487890,425,-8,2016-12-14
Bhargav Bikash Bank Ltd.,6,410,409,409,1800,736700,417,-8,2016-12-15
Bhargav Bikash Bank Ltd.,2,410,410,410,20,8200,409,1,2016-12-18
Bhargav Bikash Bank Ltd.,1,418,418,418,10,4180,410,8,2016-12-20
Bhargav Bikash Bank Ltd.,3,436,420,436,140,59760,418,18,2016-12-22
Bhargav Bikash Bank Ltd.,2,356,355,355,268,95388,363,-8,2016-12-26
Bhargav Bikash Bank Ltd.,2,349,348,348,500,174400,355,-7,2016-12-27
Bhargav Bikash Bank Ltd.,4,348,336,336,594,203244,348,-12,2016-12-28
Bhargav Bikash Bank Ltd.,5,342,333,333,580,196260,336,-3,2016-12-29
Bhargav Bikash Bank Ltd.,7,347,339,345,610,208540,333,12,2017-01-01
Bhargav Bikash Bank Ltd.,2,339,336,336,550,186300,345,-9,2017-01-02
Bhargav Bikash Bank Ltd.,5,336,330,336,562,187140,336,0,2017-01-03
Bhargav Bikash Bank Ltd.,5,339,332,334,850,286250,336,-2,2017-01-04
Bhargav Bikash Bank Ltd.,4,346,340,342,188,64320,334,8,2017-01-05
Bhargav Bikash Bank Ltd.,5,365,348,365,562,197722,342,23,2017-01-08
Bhargav Bikash Bank Ltd.,5,386,372,386,230,87910,365,21,2017-01-09
Bhargav Bikash Bank Ltd.,3,393,393,393,120,47160,386,7,2017-01-10
Bhargav Bikash Bank Ltd.,3,390,376,376,150,57450,393,-17,2017-01-11
Bhargav Bikash Bank Ltd.,3,375,371,371,241,89615,376,-5,2017-01-12
Bhargav Bikash Bank Ltd.,11,408,378,392,422,169032,371,21,2017-01-15
Bhargav Bikash Bank Ltd.,5,406,391,391,342,134606,392,-1,2017-01-16
Bhargav Bikash Bank Ltd.,5,391,377,377,350,133850,391,-14,2017-01-17
Bhargav Bikash Bank Ltd.,1,375,375,375,20,7500,377,-2,2017-01-18
Bhargav Bikash Bank Ltd.,1,382,382,382,100,38200,375,7,2017-01-19
Bhargav Bikash Bank Ltd.,1,389,389,389,20,7780,382,7,2017-01-23
Bhargav Bikash Bank Ltd.,4,390,384,385,382,147930,389,-4,2017-01-24
Bhargav Bikash Bank Ltd.,7,378,359,359,600,221600,385,-26,2017-01-25
Bhargav Bikash Bank Ltd.,11,352,339,339,854,290780,359,-20,2017-01-26
Bhargav Bikash Bank Ltd.,2,333,333,333,110,36630,339,-6,2017-01-31
Bhargav Bikash Bank Ltd.,3,351,339,351,500,171900,333,18,2017-02-01
Bhargav Bikash Bank Ltd.,5,344,344,344,520,178880,351,-7,2017-02-02
Bhargav Bikash Bank Ltd.,3,338,326,326,470,154852,344,-18,2017-02-06
Bhargav Bikash Bank Ltd.,1,325,325,325,200,65000,326,-1,2017-02-08
Bhargav Bikash Bank Ltd.,5,321,320,320,352,112660,325,-5,2017-02-09
Bhargav Bikash Bank Ltd.,10,314,300,300,1170,358600,320,-20,2017-02-13
Bhargav Bikash Bank Ltd.,2,312,306,312,400,123600,300,12,2017-02-14
Bhargav Bikash Bank Ltd.,19,343,318,343,2056,687880,312,31,2017-02-15
Bhargav Bikash Bank Ltd.,32,377,349,377,3176,1179286,343,34,2017-02-16
Bhargav Bikash Bank Ltd.,29,409,380,390,1847,724220,377,13,2017-02-19
Bhargav Bikash Bank Ltd.,30,397,369,369,4838,1803118,390,-21,2017-02-20
Bhargav Bikash Bank Ltd.,26,383,369,369,2980,1116280,369,0,2017-02-21
Bhargav Bikash Bank Ltd.,96,378,362,373,8391,3110620,369,4,2017-02-22
Bhargav Bikash Bank Ltd.,3,245,241,241,70,16990,249,-8,2017-02-26
Bhargav Bikash Bank Ltd.,1,240,240,240,20,4800,241,-1,2017-02-28
Bhargav Bikash Bank Ltd.,4,236,232,232,350,81800,240,-8,2017-03-06
Bhargav Bikash Bank Ltd.,3,232,228,232,200,46050,232,0,2017-03-07
Bhargav Bikash Bank Ltd.,3,231,230,230,220,50620,232,-2,2017-03-13
Bhargav Bikash Bank Ltd.,11,230,224,224,1302,292168,230,-6,2017-03-14
Bhargav Bikash Bank Ltd.,4,224,220,220,540,119060,224,-4,2017-03-15
Bhargav Bikash Bank Ltd.,1,218,218,218,50,10900,220,-2,2017-03-16
Bhargav Bikash Bank Ltd.,2,226,222,226,20,4480,218,8,2017-03-22
Bhargav Bikash Bank Ltd.,15,248,230,248,3040,753340,226,22,2017-03-23
Bhargav Bikash Bank Ltd.,9,272,252,272,320,86540,248,24,2017-03-26
Bhargav Bikash Bank Ltd.,11,297,277,297,561,160180,272,25,2017-03-28
Bhargav Bikash Bank Ltd.,9,314,302,314,664,201968,297,17,2017-03-29
Bhargav Bikash Bank Ltd.,9,320,302,302,580,179720,314,-12,2017-03-30
Bhargav Bikash Bank Ltd.,5,310,300,310,2100,642800,302,8,2017-04-02
Bhargav Bikash Bank Ltd.,7,310,299,299,1450,445700,310,-11,2017-04-03
Bhargav Bikash Bank Ltd.,3,304,304,304,196,59584,299,5,2017-04-04
Bhargav Bikash Bank Ltd.,2,300,300,300,350,105000,304,-4,2017-04-06
Bhargav Bikash Bank Ltd.,4,302,300,300,235,70720,300,0,2017-04-09
Bhargav Bikash Bank Ltd.,9,307,300,307,850,260070,300,7,2017-04-10
Bhargav Bikash Bank Ltd.,19,311,305,311,3460,1069700,307,4,2017-04-12
Bhargav Bikash Bank Ltd.,7,305,299,299,604,182690,311,-12,2017-04-13
Bhargav Bikash Bank Ltd.,1,296,296,296,70,20720,299,-3,2017-04-16
Bhargav Bikash Bank Ltd.,1,291,291,291,300,87300,296,-5,2017-04-19
Bhargav Bikash Bank Ltd.,2,300,296,300,250,74200,291,9,2017-04-23
Bhargav Bikash Bank Ltd.,1,294,294,294,200,58800,300,-6,2017-04-24
Bhargav Bikash Bank Ltd.,13,299,285,285,1260,368940,294,-9,2017-04-25
Bhargav Bikash Bank Ltd.,4,300,290,294,740,217700,285,9,2017-04-26
Bhargav Bikash Bank Ltd.,5,306,295,306,954,283812,294,12,2017-04-27
Bhargav Bikash Bank Ltd.,7,312,300,312,1020,311120,306,6,2017-04-30
Bhargav Bikash Bank Ltd.,7,312,300,300,650,197640,312,-12,2017-05-02
Bhargav Bikash Bank Ltd.,35,330,300,330,5272,1725904,300,30,2017-05-03
Bhargav Bikash Bank Ltd.,13,363,336,363,2420,876980,330,33,2017-05-04
Bhargav Bikash Bank Ltd.,43,384,362,366,4830,1813360,363,3,2017-05-07
Bhargav Bikash Bank Ltd.,14,375,363,363,1862,689746,366,-3,2017-05-08
Bhargav Bikash Bank Ltd.,38,370,360,365,4440,1619489,363,2,2017-05-09
Bhargav Bikash Bank Ltd.,5,365,358,358,920,334000,365,-7,2017-05-11
Bhargav Bikash Bank Ltd.,1,355,355,355,30,10650,358,-3,2017-05-16
Bhargav Bikash Bank Ltd.,4,348,342,342,600,205500,355,-13,2017-05-17
Bhargav Bikash Bank Ltd.,2,340,340,340,1200,408000,342,-2,2017-05-18
Bhargav Bikash Bank Ltd.,5,334,324,324,850,277700,340,-16,2017-05-21
Bhargav Bikash Bank Ltd.,2,318,318,318,550,174900,324,-6,2017-05-22
Bhargav Bikash Bank Ltd.,6,315,310,315,820,256150,318,-3,2017-05-23
Bhargav Bikash Bank Ltd.,10,312,309,311,2450,762120,315,-4,2017-05-24
Bhargav Bikash Bank Ltd.,6,307,301,301,985,298560,311,-10,2017-05-28
Bhargav Bikash Bank Ltd.,15,300,290,290,2590,758500,301,-11,2017-05-30
Bhargav Bikash Bank Ltd.,11,312,294,312,3300,990960,290,22,2017-05-31
Bhargav Bikash Bank Ltd.,19,320,302,305,2696,839370,312,-7,2017-06-01
Bhargav Bikash Bank Ltd.,6,300,294,300,1700,508100,305,-5,2017-06-04
Bhargav Bikash Bank Ltd.,11,305,300,305,2360,711550,300,5,2017-06-05
Bhargav Bikash Bank Ltd.,10,319,302,319,2245,688840,305,14,2017-06-06
Bhargav Bikash Bank Ltd.,11,319,313,318,1180,370070,319,-1,2017-06-07
Bhargav Bikash Bank Ltd.,10,313,307,313,2100,646940,318,-5,2017-06-08
Bhargav Bikash Bank Ltd.,2,307,301,301,600,183600,313,-12,2017-06-11
Bhargav Bikash Bank Ltd.,2,302,302,302,450,135900,301,1,2017-06-12
Bhargav Bikash Bank Ltd.,2,308,305,308,990,302820,302,6,2017-06-13
Bhargav Bikash Bank Ltd.,4,308,302,302,260,79300,308,-6,2017-06-14
Bhargav Bikash Bank Ltd.,2,308,308,308,140,43120,302,6,2017-06-15
Bhargav Bikash Bank Ltd.,3,310,304,304,600,185400,308,-4,2017-06-18
Bhargav Bikash Bank Ltd.,1,304,304,304,100,30400,304,0,2017-06-19
Bhargav Bikash Bank Ltd.,1,298,298,298,200,59600,304,-6,2017-06-20
Bhargav Bikash Bank Ltd.,7,295,293,293,720,212200,298,-5,2017-06-21
Bhargav Bikash Bank Ltd.,2,292,290,292,200,58200,293,-1,2017-06-22
Bhargav Bikash Bank Ltd.,10,307,297,303,2220,672940,292,11,2017-06-25
Bhargav Bikash Bank Ltd.,5,304,303,303,2525,765500,303,0,2017-06-27
Bhargav Bikash Bank Ltd.,1,297,297,297,500,148500,303,-6,2017-07-02
Bhargav Bikash Bank Ltd.,5,300,292,292,1300,382000,297,-5,2017-07-03
Bhargav Bikash Bank Ltd.,1,292,292,292,100,29200,292,0,2017-07-04
Bhargav Bikash Bank Ltd.,1,287,287,287,300,86100,292,-5,2017-07-05
Bhargav Bikash Bank Ltd.,10,302,292,295,920,273340,287,8,2017-07-06
Bhargav Bikash Bank Ltd.,3,290,285,287,83,23831,295,-8,2017-07-10
Bhargav Bikash Bank Ltd.,2,292,291,292,400,116600,287,5,2017-07-11
Bhargav Bikash Bank Ltd.,3,297,295,297,610,179970,292,5,2017-07-16
Bhargav Bikash Bank Ltd.,22,305,299,303,3500,1061740,297,6,2017-07-17
Bhargav Bikash Bank Ltd.,18,309,302,305,2650,807500,303,2,2017-07-18
Bhargav Bikash Bank Ltd.,1,299,299,299,100,29900,299,0,2017-08-03
Bhargav Bikash Bank Ltd.,17,315,306,310,2922,905844,305,5,2017-07-19
Bhargav Bikash Bank Ltd.,4,314,304,304,472,147528,310,-6,2017-07-20
Bhargav Bikash Bank Ltd.,8,300,295,295,1459,434292,304,-9,2017-07-23
Bhargav Bikash Bank Ltd.,6,301,291,301,1060,313460,295,6,2017-07-24
Bhargav Bikash Bank Ltd.,10,304,299,299,902,271388,301,-2,2017-07-25
Bhargav Bikash Bank Ltd.,11,303,295,300,1110,333400,299,1,2017-07-26
Bhargav Bikash Bank Ltd.,4,305,300,302,395,119975,300,2,2017-07-27
Bhargav Bikash Bank Ltd.,6,305,297,297,1008,305068,302,-5,2017-07-30
Bhargav Bikash Bank Ltd.,6,300,298,300,440,131400,297,3,2017-07-31
Bhargav Bikash Bank Ltd.,3,297,294,296,112,33028,300,-4,2017-08-01
Bhargav Bikash Bank Ltd.,2,299,299,299,80,23920,296,3,2017-08-02
Bhargav Bikash Bank Ltd.,9,304,295,295,770,229070,299,-4,2017-08-06
Bhargav Bikash Bank Ltd.,6,290,285,285,360,104150,295,-10,2017-08-07
Bhargav Bikash Bank Ltd.,9,290,287,289,2682,773317,285,4,2017-08-09
Bhargav Bikash Bank Ltd.,14,286,284,286,1683,478363,289,-3,2017-08-10
Bhargav Bikash Bank Ltd.,8,281,278,281,948,265574,286,-5,2017-08-13
Bhargav Bikash Bank Ltd.,12,280,276,279,2330,649160,281,-2,2017-08-15
Bhargav Bikash Bank Ltd.,7,286,276,286,2250,631500,279,7,2017-08-16
Bhargav Bikash Bank Ltd.,3,281,280,280,730,205000,286,-6,2017-08-17
Bhargav Bikash Bank Ltd.,2,280,276,280,158,44088,280,0,2017-08-20
Bhargav Bikash Bank Ltd.,1,281,281,281,15,4215,280,1,2017-08-22
Bhargav Bikash Bank Ltd.,4,285,280,280,500,140600,281,-1,2017-08-23
Bhargav Bikash Bank Ltd.,19,285,275,275,1747,483500,280,-5,2017-08-27
Bhargav Bikash Bank Ltd.,17,292,270,280,2406,686156,275,5,2017-08-28
Bhargav Bikash Bank Ltd.,14,278,261,263,1651,438737,280,-17,2017-08-31
Bhargav Bikash Bank Ltd.,11,268,260,260,1322,347606,263,-3,2017-09-04
Bhargav Bikash Bank Ltd.,7,270,257,257,708,188354,260,-3,2017-09-06
Bhargav Bikash Bank Ltd.,3,258,256,256,620,158760,257,-1,2017-09-07
Bhargav Bikash Bank Ltd.,3,261,257,261,702,181474,256,5,2017-09-10
Bhargav Bikash Bank Ltd.,14,266,260,265,2350,617190,261,4,2017-09-11
Bhargav Bikash Bank Ltd.,9,265,258,263,536,139828,265,-2,2017-09-12
Bhargav Bikash Bank Ltd.,10,268,256,256,1340,349070,263,-7,2017-09-13
Bhargav Bikash Bank Ltd.,16,264,251,264,3050,780476,256,8,2017-09-14
Bhargav Bikash Bank Ltd.,16,268,262,263,3057,805513,264,-1,2017-09-17
Bhargav Bikash Bank Ltd.,5,265,260,265,420,109790,263,2,2017-09-18
Bhargav Bikash Bank Ltd.,14,280,266,270,2980,809150,265,5,2017-09-20
Bhargav Bikash Bank Ltd.,9,275,264,265,772,205930,270,-5,2017-10-09
Bhargav Bikash Bank Ltd.,7,275,271,271,1070,290390,270,1,2017-09-24
Bhargav Bikash Bank Ltd.,5,276,271,271,800,218800,271,0,2017-09-25
Bhargav Bikash Bank Ltd.,8,276,272,272,1080,295650,271,1,2017-09-26
Bhargav Bikash Bank Ltd.,2,277,275,275,511,140547,272,3,2017-10-03
Bhargav Bikash Bank Ltd.,4,280,275,275,359,99020,275,0,2017-10-04
Bhargav Bikash Bank Ltd.,3,270,270,270,500,135000,275,-5,2017-10-08
Bhargav Bikash Bank Ltd.,10,260,245,258,538,135308,265,-7,2017-10-10
Bhargav Bikash Bank Ltd.,1,260,260,260,220,57200,258,2,2017-10-12
Bhargav Bikash Bank Ltd.,4,260,255,260,713,181980,260,0,2017-10-15
Bhargav Bikash Bank Ltd.,6,270,260,270,620,162250,260,10,2017-10-16
Bhargav Bikash Bank Ltd.,4,270,264,270,473,126352,270,0,2017-10-17
Bhargav Bikash Bank Ltd.,2,279,275,279,70,19370,270,9,2017-10-18
Bhargav Bikash Bank Ltd.,7,284,279,279,400,111950,279,0,2017-10-22
Bhargav Bikash Bank Ltd.,11,285,280,282,1860,523840,279,3,2017-10-23
Bhargav Bikash Bank Ltd.,30,282,270,276,2721,754901,282,-6,2017-10-24
Bhargav Bikash Bank Ltd.,45,282,275,280,3270,911702,276,4,2017-10-25
Bhargav Bikash Bank Ltd.,37,282,275,280,5246,1458803,280,0,2017-10-29
Bhargav Bikash Bank Ltd.,42,280,270,275,8786,2409790,280,-5,2017-10-30
Bhargav Bikash Bank Ltd.,58,277,265,266,13183,3533444,275,-9,2017-10-31
Bhargav Bikash Bank Ltd.,12,190,178,178,801,144868,192,-14,2017-11-01
Bhargav Bikash Bank Ltd.,7,185,178,185,1230,222990,178,7,2017-11-02
Bhargav Bikash Bank Ltd.,11,191,186,191,1702,319906,185,6,2017-11-05
Bhargav Bikash Bank Ltd.,7,190,184,184,1608,301420,191,-7,2017-11-06
Bhargav Bikash Bank Ltd.,4,185,184,184,908,167122,184,0,2017-11-07
Bhargav Bikash Bank Ltd.,3,181,178,178,60,10710,184,-6,2017-11-08
Bhargav Bikash Bank Ltd.,14,178,169,169,1950,335576,178,-9,2017-11-09
Bhargav Bikash Bank Ltd.,8,171,166,171,542,90372,169,2,2017-11-12
Bhargav Bikash Bank Ltd.,10,177,170,177,2279,389753,171,6,2017-11-13
Bhargav Bikash Bank Ltd.,15,189,178,189,1891,349734,177,12,2017-11-14
Bhargav Bikash Bank Ltd.,7,186,181,183,686,125938,189,-6,2017-11-15
Bhargav Bikash Bank Ltd.,6,186,177,177,650,116850,183,-6,2017-11-16
Bhargav Bikash Bank Ltd.,10,180,175,175,2452,430404,177,-2,2017-11-19
Bhargav Bikash Bank Ltd.,6,178,175,175,1487,260961,175,0,2017-11-20
Bhargav Bikash Bank Ltd.,8,181,175,178,1010,179420,175,3,2017-11-21
Bhargav Bikash Bank Ltd.,7,180,175,175,1080,190700,178,-3,2017-11-22
Bhargav Bikash Bank Ltd.,4,180,178,178,1190,212936,175,3,2017-11-23
Bhargav Bikash Bank Ltd.,6,181,178,179,590,105475,178,1,2017-11-26
Bhargav Bikash Bank Ltd.,4,177,174,174,232,40763,179,-5,2017-11-27
Bhargav Bikash Bank Ltd.,1,175,175,175,52,9100,174,1,2017-11-28
Bhargav Bikash Bank Ltd.,6,180,175,180,1590,282950,175,5,2017-11-29
Bhargav Bikash Bank Ltd.,5,180,178,178,860,153680,180,-2,2017-11-30
Bhargav Bikash Bank Ltd.,7,176,172,173,362,63096,178,-5,2017-12-04
Bhargav Bikash Bank Ltd.,2,170,170,170,245,41650,173,-3,2017-12-20
Bhargav Bikash Bank Ltd.,9,172,169,169,519,88373,173,-4,2017-12-05
Bhargav Bikash Bank Ltd.,1,172,172,172,103,17716,169,3,2017-12-06
Bhargav Bikash Bank Ltd.,2,172,172,172,40,6880,172,0,2017-12-10
Bhargav Bikash Bank Ltd.,3,175,172,175,599,104225,172,3,2017-12-11
Bhargav Bikash Bank Ltd.,5,175,174,174,430,75020,175,-1,2017-12-12
Bhargav Bikash Bank Ltd.,17,176,173,173,1972,343898,174,-1,2017-12-13
Bhargav Bikash Bank Ltd.,1,176,176,176,200,35200,173,3,2017-12-14
Bhargav Bikash Bank Ltd.,1,173,173,173,100,17300,176,-3,2017-12-17
Bhargav Bikash Bank Ltd.,2,175,173,173,120,20960,173,0,2017-12-18
Bhargav Bikash Bank Ltd.,4,173,170,173,455,77650,173,0,2017-12-19
Bhargav Bikash Bank Ltd.,5,167,161,161,839,137146,170,-9,2017-12-26
Bhargav Bikash Bank Ltd.,4,166,162,162,640,104760,161,1,2017-12-27
Bhargav Bikash Bank Ltd.,4,165,161,165,424,68828,162,3,2017-12-28
Bhargav Bikash Bank Ltd.,4,164,162,164,245,39930,165,-1,2018-01-01
Bhargav Bikash Bank Ltd.,1,164,164,164,100,16400,164,0,2018-01-02
Bhargav Bikash Bank Ltd.,2,164,161,161,36,5856,164,-3,2018-01-03
Bhargav Bikash Bank Ltd.,6,164,161,162,960,156160,161,1,2018-01-04
Bhargav Bikash Bank Ltd.,4,165,160,165,309,50240,162,3,2018-01-07
Bhargav Bikash Bank Ltd.,5,166,163,166,765,125445,165,1,2018-01-08
Bhargav Bikash Bank Ltd.,6,169,168,168,916,154372,166,2,2018-01-09
Bhargav Bikash Bank Ltd.,1,165,165,165,50,8250,168,-3,2018-01-16
Bhargav Bikash Bank Ltd.,4,162,159,159,104,16614,165,-6,2018-01-21
Bhargav Bikash Bank Ltd.,9,160,156,156,901,142777,159,-3,2018-01-22
Bhargav Bikash Bank Ltd.,4,155,153,154,1666,255198,156,-2,2018-01-23
Bhargav Bikash Bank Ltd.,2,155,152,155,67,10229,154,1,2018-01-24
Bhargav Bikash Bank Ltd.,3,156,153,156,162,25044,155,1,2018-01-25
Bhargav Bikash Bank Ltd.,6,162,159,159,278,44232,156,3,2018-01-28
Bhargav Bikash Bank Ltd.,2,156,156,156,100,15600,159,-3,2018-01-31
Bhargav Bikash Bank Ltd.,2,159,156,156,150,23550,156,0,2018-02-01
Bhargav Bikash Bank Ltd.,3,156,155,155,840,130400,156,-1,2018-02-04
Bhargav Bikash Bank Ltd.,4,158,153,153,650,100720,155,-2,2018-02-05
Bhargav Bikash Bank Ltd.,4,151,150,150,1450,217950,153,-3,2018-02-06
Bhargav Bikash Bank Ltd.,3,153,148,153,659,99110,150,3,2018-02-07
Bhargav Bikash Bank Ltd.,9,156,151,151,1090,165810,153,-2,2018-02-08
Bhargav Bikash Bank Ltd.,1,164,164,164,10,1640,162,2,2018-02-25
Bhargav Bikash Bank Ltd.,1,154,154,154,78,12012,151,3,2018-02-11
Bhargav Bikash Bank Ltd.,3,157,156,157,400,62690,154,3,2018-02-14
Bhargav Bikash Bank Ltd.,9,158,156,157,2950,461850,157,0,2018-02-15
Bhargav Bikash Bank Ltd.,4,162,159,162,340,55030,157,5,2018-02-18
Bhargav Bikash Bank Ltd.,1,165,165,165,10,1650,162,3,2018-02-20
Bhargav Bikash Bank Ltd.,1,162,162,162,60,9720,165,-3,2018-02-21
Bhargav Bikash Bank Ltd.,2,167,164,164,206,33814,164,0,2018-02-26
Bhargav Bikash Bank Ltd.,1,165,165,165,150,24750,164,1,2018-02-28
Bhargav Bikash Bank Ltd.,6,162,158,158,975,156150,165,-7,2018-03-07
Bhargav Bikash Bank Ltd.,1,157,157,157,100,15700,158,-1,2018-03-12
Bhargav Bikash Bank Ltd.,1,154,154,154,100,15400,157,-3,2018-03-18
Bhargav Bikash Bank Ltd.,1,151,151,151,200,30200,154,-3,2018-03-22
Bhargav Bikash Bank Ltd.,8,148,140,140,712,101540,151,-11,2018-03-26
Bhargav Bikash Bank Ltd.,5,142,139,142,1020,142480,140,2,2018-03-27
Bhargav Bikash Bank Ltd.,2,142,140,142,400,56400,142,0,2018-03-29
Bhargav Bikash Bank Ltd.,5,140,136,136,1300,180000,142,-6,2018-04-02
Bhargav Bikash Bank Ltd.,2,136,135,135,200,27100,136,-1,2018-04-03
Bhargav Bikash Bank Ltd.,5,138,136,138,600,82500,135,3,2018-04-04
Bhargav Bikash Bank Ltd.,8,144,140,142,910,129730,138,4,2018-04-05
Bhargav Bikash Bank Ltd.,5,148,144,144,620,90120,142,2,2018-04-08
Bhargav Bikash Bank Ltd.,2,146,144,144,36,5204,144,0,2018-04-16
Bhargav Bikash Bank Ltd.,3,146,144,146,306,44564,144,2,2018-04-17
Bhargav Bikash Bank Ltd.,6,149,146,149,1650,244150,146,3,2018-04-18
Bhargav Bikash Bank Ltd.,2,151,148,148,96,14268,149,-1,2018-04-19
Bhargav Bikash Bank Ltd.,4,156,148,156,501,75283,148,8,2018-04-22
Bhargav Bikash Bank Ltd.,32,170,156,168,6602,1081740,156,12,2018-04-23
Bhargav Bikash Bank Ltd.,10,168,165,165,910,151140,168,-3,2018-04-24
Bhargav Bikash Bank Ltd.,7,162,162,162,900,145800,165,-3,2018-04-25
Bhargav Bikash Bank Ltd.,3,159,156,156,400,63300,162,-6,2018-04-26
Bhargav Bikash Bank Ltd.,2,159,156,156,110,17190,156,0,2018-05-03
Bhargav Bikash Bank Ltd.,2,159,159,159,40,6360,156,3,2018-05-06
Bhargav Bikash Bank Ltd.,3,156,153,153,450,69650,159,-6,2018-05-07
Bhargav Bikash Bank Ltd.,3,153,150,153,540,82000,153,0,2018-05-08
Bhargav Bikash Bank Ltd.,3,151,150,150,740,111300,153,-3,2018-05-09
Bhargav Bikash Bank Ltd.,2,153,152,153,110,16820,150,3,2018-05-10
Bhargav Bikash Bank Ltd.,3,150,145,145,900,131700,153,-8,2018-05-14
Bhargav Bikash Bank Ltd.,1,147,147,147,100,14700,145,2,2018-05-15
Bhargav Bikash Bank Ltd.,1,146,146,146,50,7300,147,-1,2018-05-16
Bhargav Bikash Bank Ltd.,2,144,142,142,200,28600,146,-4,2018-05-17
Bhargav Bikash Bank Ltd.,3,142,140,140,600,84800,142,-2,2018-05-20
Bhargav Bikash Bank Ltd. Promoter Share,13,290,266,266,99068,27040388,295,-29,2016-06-26
Bhargav Bikash Bank Ltd. Promoter Share,4,261,261,261,2000,522000,266,-5,2016-12-12
Bhargav Bikash Bank Ltd. Promoter Share,1,261,261,261,3600,939600,261,0,2016-12-22
Bhargav Bikash Bank Ltd. Promoter Share,7,163,163,163,8400,1369200,163,0,2017-10-30
Bhargav Bikash Bank Ltd. Promoter Share,1,163,163,163,200,32600,163,0,2017-12-28
Biratlaxmi Bikas Bank Limited,4,420,412,418,1657,690556,419,-1,2016-05-23
Biratlaxmi Bikas Bank Limited,11,429,415,425,5551,2339156,418,7,2016-05-24
Biratlaxmi Bikas Bank Limited,2,420,420,420,350,147000,425,-5,2016-05-25
Biratlaxmi Bikas Bank Limited,7,419,411,418,1806,748527,420,-2,2016-05-26
Biratlaxmi Bikas Bank Limited,16,422,410,411,6437,2660505,418,-7,2016-05-29
Biratlaxmi Bikas Bank Limited,17,419,403,412,3047,1247309,411,1,2016-05-30
Biratlaxmi Bikas Bank Limited,3,418,411,411,3000,1240000,412,-1,2016-05-31
Biratlaxmi Bikas Bank Limited,7,419,406,419,4028,1654684,411,8,2016-06-01
Biratlaxmi Bikas Bank Limited,12,419,413,413,4825,2003737,419,-6,2016-06-02
Biratlaxmi Bikas Bank Limited,14,415,401,401,5503,2240263,413,-12,2016-06-05
Biratlaxmi Bikas Bank Limited,15,408,400,400,6377,2573069,401,-1,2016-06-06
Bishal Bazar Company Limited,8,2233,2000,2233,4494,9029160,2030,203,2017-09-14
Bishal Bazar Company Limited,5,2456,2277,2456,50,118380,2233,223,2017-09-17
Bishal Bazar Company Limited,27,2701,2505,2701,1260,3398460,2456,245,2017-09-18
Bishal Bazar Company Limited,96,2971,2720,2971,6050,17227426,2701,270,2017-09-20
Bishal Bazar Company Limited,12,2194,2000,2115,264,545336,2151,-36,2017-10-09
Bishal Bazar Company Limited,19,3030,2790,2790,763,2208157,2971,-181,2017-09-24
Bishal Bazar Company Limited,20,2785,2511,2511,696,1825824,2790,-279,2017-09-25
Bishal Bazar Company Limited,53,2461,2260,2265,1903,4325525,2511,-246,2017-09-26
Bishal Bazar Company Limited,5,2310,2220,2310,70,159250,2265,45,2017-10-03
Bishal Bazar Company Limited,6,2265,2264,2264,130,294370,2310,-46,2017-10-04
Bishal Bazar Company Limited,33,2219,2038,2151,916,1883702,2264,-113,2017-10-08
Bishal Bazar Company Limited,13,2075,2034,2075,550,1137620,2115,-40,2017-10-10
Bishal Bazar Company Limited,8,2150,2100,2100,270,570160,2075,25,2017-10-11
Bishal Bazar Company Limited,8,2172,2103,2103,120,256140,2100,3,2017-10-12
Bishal Bazar Company Limited,9,2145,2111,2144,380,808110,2103,41,2017-10-15
Bishal Bazar Company Limited,12,2102,2040,2094,447,929731,2144,-50,2017-10-16
Bishal Bazar Company Limited,16,2175,2090,2125,510,1079570,2094,31,2017-10-17
Bishal Bazar Company Limited,23,2200,2002,2200,710,1462560,2125,75,2017-10-18
Bishal Bazar Company Limited,4,2198,2113,2198,40,86220,2200,-2,2017-10-22
Bishal Bazar Company Limited,3,2155,2100,2100,70,147770,2198,-98,2017-10-23
Bishal Bazar Company Limited,9,2140,2058,2061,267,559126,2100,-39,2017-10-24
Bishal Bazar Company Limited,26,2223,2099,2200,783,1706898,2061,139,2017-10-25
Bishal Bazar Company Limited,5,2170,2117,2170,105,225625,2200,-30,2017-10-29
Bishal Bazar Company Limited,2,2127,2100,2100,60,126270,2170,-70,2017-10-30
Bishal Bazar Company Limited,6,2140,2100,2100,150,317450,2100,0,2017-10-31
Bishal Bazar Company Limited,12,2178,2120,2178,616,1322250,2100,78,2017-11-02
Bishal Bazar Company Limited,5,2220,2205,2210,100,221200,2178,32,2017-11-05
Bishal Bazar Company Limited,4,2209,2165,2165,60,130810,2210,-45,2017-11-06
Bishal Bazar Company Limited,4,2208,2172,2172,66,144313,2165,7,2017-11-07
Bishal Bazar Company Limited,5,2135,2129,2129,100,213110,2172,-43,2017-11-08
Bishal Bazar Company Limited,8,2107,2060,2107,120,248790,2129,-22,2017-11-09
Bishal Bazar Company Limited,2,2070,2065,2070,60,123950,2107,-37,2017-11-12
Bishal Bazar Company Limited,3,2080,2029,2080,70,143270,2070,10,2017-11-14
Bishal Bazar Company Limited,6,2121,2041,2041,190,394470,2080,-39,2017-11-15
Bishal Bazar Company Limited,9,2042,2001,2022,210,427000,2041,-19,2017-11-16
Bishal Bazar Company Limited,45,1985,1885,1885,2140,4079951,2022,-137,2017-11-20
Bishal Bazar Company Limited,22,2073,1855,2070,1341,2557510,1885,185,2017-11-21
Bishal Bazar Company Limited,12,2090,1961,2070,801,1601161,2070,0,2017-11-22
Bishal Bazar Company Limited,6,2070,2029,2030,220,446810,2070,-40,2017-11-23
Bishal Bazar Company Limited,19,2000,1922,1935,669,1296167,2030,-95,2017-11-26
Bishal Bazar Company Limited,21,1960,1898,1898,870,1661080,1935,-37,2017-11-27
Bishal Bazar Company Limited,9,1935,1898,1898,330,632510,1898,0,2017-11-28
Bishal Bazar Company Limited,9,2000,1932,1932,400,781600,1898,34,2017-11-29
Bishal Bazar Company Limited,3,1915,1896,1915,150,284710,1932,-17,2017-12-04
Bishal Bazar Company Limited,8,1916,1886,1916,385,734400,1915,1,2017-12-05
Bishal Bazar Company Limited,4,1920,1887,1887,522,992670,1916,-29,2017-12-06
Bishal Bazar Company Limited,3,1890,1887,1887,138,260556,1887,0,2017-12-10
Bishal Bazar Company Limited,1,1860,1860,1860,60,111600,1887,-27,2017-12-11
Bishal Bazar Company Limited,10,1840,1821,1821,460,840970,1860,-39,2017-12-12
Bishal Bazar Company Limited,3,1850,1850,1850,33,61050,1821,29,2017-12-13
Bishal Bazar Company Limited,2,1887,1850,1887,20,37370,1850,37,2017-12-14
Bishal Bazar Company Limited,18,1850,1742,1776,815,1431880,1887,-111,2017-12-17
Bishal Bazar Company Limited,5,1847,1811,1847,330,609110,1776,71,2017-12-18
Bishal Bazar Company Limited,4,1873,1836,1836,90,166350,1847,-11,2017-12-19
Bishal Bazar Company Limited,2,1850,1813,1813,30,54760,1836,-23,2017-12-21
Bishal Bazar Company Limited,2,1781,1780,1781,130,231450,1813,-32,2017-12-24
Bishal Bazar Company Limited,11,1760,1725,1725,530,921840,1781,-56,2017-12-26
Bishal Bazar Company Limited,3,1782,1750,1782,51,89972,1725,57,2017-12-28
Bishal Bazar Company Limited,3,1747,1715,1730,56,97070,1782,-52,2017-12-31
Bishal Bazar Company Limited,1,1764,1764,1764,10,17640,1730,34,2018-01-01
Bishal Bazar Company Limited,4,1765,1731,1765,70,121890,1764,1,2018-01-02
Bishal Bazar Company Limited,21,1749,1696,1749,3834,6517582,1765,-16,2018-01-03
Bishal Bazar Company Limited,5,1720,1715,1715,590,1012000,1749,-34,2018-01-04
Bishal Bazar Company Limited,7,1748,1702,1715,526,905612,1715,0,2018-01-07
Bishal Bazar Company Limited,17,1730,1728,1730,1200,2075050,1715,15,2018-01-08
Bishal Bazar Company Limited,5,1745,1730,1745,240,417050,1730,15,2018-01-09
Bishal Bazar Company Limited,3,1735,1720,1735,140,242300,1745,-10,2018-01-10
Bishal Bazar Company Limited,2,1701,1701,1701,100,170100,1735,-34,2018-01-16
Bishal Bazar Company Limited,10,1760,1725,1725,310,541660,1701,24,2018-01-21
Bishal Bazar Company Limited,30,1846,1739,1846,3640,6539560,1725,121,2018-01-22
Bishal Bazar Company Limited,15,1840,1790,1840,745,1354520,1846,-6,2018-01-23
Bishal Bazar Company Limited,6,1890,1870,1890,250,470090,1840,50,2018-01-24
Bishal Bazar Company Limited,28,2020,1927,1988,1942,3817316,1890,98,2018-01-25
Bishal Bazar Company Limited,7,2020,1865,1865,320,608640,1988,-123,2018-01-28
Bishal Bazar Company Limited,7,1940,1885,1940,357,686050,1865,75,2018-01-29
Bishal Bazar Company Limited,9,1990,1941,1990,260,512400,1940,50,2018-01-31
Bishal Bazar Company Limited,9,2010,2000,2010,550,1103250,1990,20,2018-02-01
Bishal Bazar Company Limited,13,2050,1970,1970,707,1415220,2010,-40,2018-02-04
Bishal Bazar Company Limited,3,1969,1931,1969,70,135590,1970,-1,2018-02-05
Bishal Bazar Company Limited,2,1930,1900,1900,110,212000,1969,-69,2018-02-06
Bishal Bazar Company Limited,1,1938,1938,1938,10,19380,1900,38,2018-02-07
Bishal Bazar Company Limited,2,1976,1937,1937,20,39130,1938,-1,2018-02-08
Bishal Bazar Company Limited,1,0,0,0,5,9500,1937,-1937,2018-02-11
Bishal Bazar Company Limited,3,1937,1900,1937,90,171380,1937,0,2018-02-12
Bishal Bazar Company Limited,1,1940,1940,1940,10,19400,1937,3,2018-02-14
Bishal Bazar Company Limited,8,2011,1960,2011,930,1856920,1940,71,2018-02-15
Bishal Bazar Company Limited,3,1975,1975,1975,200,395000,2011,-36,2018-02-20
Bishal Bazar Company Limited,1,1950,1950,1950,20,39000,1975,-25,2018-02-26
Bishal Bazar Company Limited,2,1912,1874,1874,20,37860,1950,-76,2018-02-28
Bishal Bazar Company Limited,8,1874,1687,1687,120,212080,1874,-187,2018-03-04
Bishal Bazar Company Limited,7,1768,1700,1768,110,188760,1687,81,2018-03-05
Bishal Bazar Company Limited,1,1803,1803,1803,10,18030,1768,35,2018-03-06
Bishal Bazar Company Limited,1,1839,1839,1839,30,55170,1803,36,2018-03-07
Bishal Bazar Company Limited,1,1855,1855,1855,200,371000,1839,16,2018-03-19
Bishal Bazar Company Limited,1,1818,1818,1818,10,18180,1855,-37,2018-03-27
Bishal Bazar Company Limited,2,1800,1764,1764,60,107640,1818,-54,2018-03-28
Bishal Bazar Company Limited,4,1798,1728,1728,1219,2188612,1764,-36,2018-03-29
Bishal Bazar Company Limited,3,1760,1725,1760,165,286695,1728,32,2018-04-03
Bishal Bazar Company Limited,1,1760,1760,1760,910,1601600,1760,0,2018-04-04
Bishal Bazar Company Limited,2,1795,1760,1760,100,177750,1760,0,2018-04-05
Bishal Bazar Company Limited,6,1850,1794,1850,150,272180,1760,90,2018-04-08
Bishal Bazar Company Limited,1,1850,1850,1850,10,18500,1850,0,2018-04-09
Bishal Bazar Company Limited,15,1820,1742,1784,797,1429860,1850,-66,2018-04-17
Bishal Bazar Company Limited,4,1836,1800,1836,176,321050,1784,52,2018-04-18
Bishal Bazar Company Limited,3,1810,1800,1810,150,271130,1836,-26,2018-04-19
Bishal Bazar Company Limited,5,1774,1739,1739,130,227370,1810,-71,2018-04-23
Bishal Bazar Company Limited,1,1773,1773,1773,10,17730,1739,34,2018-04-24
Bishal Bazar Company Limited,3,1807,1771,1771,310,556370,1773,-2,2018-04-25
Bishal Bazar Company Limited,1,1780,1780,1780,10,17800,1771,9,2018-04-29
Bishal Bazar Company Limited,2,1745,1711,1711,50,86910,1780,-69,2018-05-10
Bishal Bazar Company Limited,3,1685,1680,1680,200,336300,1711,-31,2018-05-14
Bishal Bazar Company Limited,3,1745,1712,1745,40,69470,1680,65,2018-05-15
Bishal Bazar Company Limited,2,1814,1779,1814,47,84908,1745,69,2018-05-16
Bishal Bazar Company Limited,9,1779,1745,1755,350,614850,1814,-59,2018-05-17
Bottlers Nepal (Balaju) Limited,1,1660,1660,1660,100,166000,1660,0,2016-11-15
Bottlers Nepal (Balaju) Limited,1,1693,1693,1693,100,169300,1660,33,2018-02-27
Bottlers Nepal (Terai) Limited,3,2415,2400,2400,1131,2715900,2353,47,2016-05-23
Bottlers Nepal (Terai) Limited,2,3204,3142,3204,20,63460,3081,123,2016-06-23
Bottlers Nepal (Terai) Limited,5,2640,2448,2640,140,364840,2400,240,2016-06-14
Bottlers Nepal (Terai) Limited,6,2904,2692,2904,150,430340,2640,264,2016-06-15
Bottlers Nepal (Terai) Limited,2,3021,2962,3021,600,1783100,2904,117,2016-06-16
Bottlers Nepal (Terai) Limited,1,3081,3081,3081,10,30810,3021,60,2016-06-19
Bottlers Nepal (Terai) Limited,1,3268,3268,3268,10,32680,3204,64,2016-06-27
Bottlers Nepal (Terai) Limited,1,3333,3333,3333,10,33330,3268,65,2016-06-28
Bottlers Nepal (Terai) Limited,1,3398,3398,3398,1000,3398000,3333,65,2016-06-29
Bottlers Nepal (Terai) Limited,5,3737,3465,3737,90,321520,3398,339,2016-07-05
Bottlers Nepal (Terai) Limited,4,4043,3811,4043,50,195920,3737,306,2016-07-06
Bottlers Nepal (Terai) Limited,1,4123,4123,4123,500,2061500,4043,80,2016-07-10
Bottlers Nepal (Terai) Limited,5,4535,4205,4535,50,218640,4123,412,2016-07-11
Bottlers Nepal (Terai) Limited,13,4988,4625,4988,1490,7415910,4535,453,2016-07-12
Bottlers Nepal (Terai) Limited,5,5486,5087,5486,90,467960,4988,498,2016-07-13
Bottlers Nepal (Terai) Limited,4,5936,5595,5936,40,230570,5486,450,2016-07-14
Bottlers Nepal (Terai) Limited,10,6529,6054,6529,1010,6582630,5936,593,2016-07-17
Bottlers Nepal (Terai) Limited,5,7181,6659,7181,50,346240,6529,652,2016-07-18
Bottlers Nepal (Terai) Limited,4,7771,7324,7771,40,301840,7181,590,2016-07-19
Bottlers Nepal (Terai) Limited,6,8548,7926,8548,95,796780,7771,777,2016-07-20
Bottlers Nepal (Terai) Limited,37,9402,8718,9402,930,8727030,8548,854,2016-07-21
Bottlers Nepal (Terai) Limited,19,9999,9400,9449,340,3336840,9402,47,2016-07-25
Bottlers Nepal (Terai) Limited,7,9261,8505,8505,70,615040,9449,-944,2016-07-26
Bottlers Nepal (Terai) Limited,3,8848,8675,8848,60,527260,8505,343,2016-07-27
Bottlers Nepal (Terai) Limited,10,8672,7964,7964,130,1053790,8848,-884,2016-07-28
Bottlers Nepal (Terai) Limited,14,7948,7202,7948,260,1954130,7964,-16,2016-07-31
Bottlers Nepal (Terai) Limited,5,7790,7351,7351,250,1880760,7948,-597,2016-08-01
Bottlers Nepal (Terai) Limited,7,7850,7498,7850,150,1152940,7351,499,2016-08-02
Bottlers Nepal (Terai) Limited,6,7693,7243,7243,80,594260,7850,-607,2016-08-03
Bottlers Nepal (Terai) Limited,9,7099,6958,7001,110,772290,7243,-242,2016-08-04
Bottlers Nepal (Terai) Limited,13,7141,6301,6301,210,1397710,7001,-700,2016-08-07
Bottlers Nepal (Terai) Limited,6,6200,5931,5931,200,1197890,6301,-370,2016-08-08
Bottlers Nepal (Terai) Limited,4,6292,6049,6292,40,248020,5931,361,2016-08-10
Bottlers Nepal (Terai) Limited,11,6550,6200,6200,450,2872690,6292,-92,2016-08-11
Bottlers Nepal (Terai) Limited,4,6650,6510,6650,40,264300,6384,266,2016-08-31
Bottlers Nepal (Terai) Limited,1,6324,6324,6324,10,63240,6200,124,2016-08-16
Bottlers Nepal (Terai) Limited,1,6198,6198,6198,10,61980,6324,-126,2016-08-17
Bottlers Nepal (Terai) Limited,8,6078,5720,5720,120,706520,6198,-478,2016-08-21
Bottlers Nepal (Terai) Limited,8,5608,5292,5292,733,3942316,5720,-428,2016-08-22
Bottlers Nepal (Terai) Limited,11,5188,4983,5082,190,963100,5292,-210,2016-08-23
Bottlers Nepal (Terai) Limited,1,5182,5182,5182,30,155460,5082,100,2016-08-24
Bottlers Nepal (Terai) Limited,6,5390,5285,5300,2070,10975220,5182,118,2016-08-28
Bottlers Nepal (Terai) Limited,11,5830,5406,5830,170,971690,5300,530,2016-08-29
Bottlers Nepal (Terai) Limited,6,6412,5946,6384,130,819790,5830,554,2016-08-30
Bottlers Nepal (Terai) Limited,3,6655,6520,6520,60,396450,6650,-130,2016-09-01
Bottlers Nepal (Terai) Limited,1,6390,6390,6390,30,191700,6520,-130,2016-09-04
Bottlers Nepal (Terai) Limited,4,6263,5896,5896,70,423630,6390,-494,2016-09-05
Bottlers Nepal (Terai) Limited,3,5779,5664,5664,50,284350,5896,-232,2016-09-06
Bottlers Nepal (Terai) Limited,2,5551,5551,5551,40,222040,5664,-113,2016-09-07
Bottlers Nepal (Terai) Limited,1,5662,5662,5662,50,283100,5551,111,2016-09-14
Bottlers Nepal (Terai) Limited,1,5555,5555,5555,10,55550,5662,-107,2016-09-25
Bottlers Nepal (Terai) Limited,4,5444,5126,5126,60,314920,5555,-429,2016-09-27
Bottlers Nepal (Terai) Limited,5,5024,4831,4831,80,394820,5126,-295,2016-09-28
Bottlers Nepal (Terai) Limited,4,5097,4831,5097,140,682050,4831,266,2016-09-29
Bottlers Nepal (Terai) Limited,3,5200,5150,5200,60,310960,5097,103,2016-10-03
Bottlers Nepal (Terai) Limited,1,5300,5300,5300,10,53000,5200,100,2016-10-05
Bottlers Nepal (Terai) Limited,1,5200,5200,5200,20,104000,5300,-100,2016-10-19
Bottlers Nepal (Terai) Limited,1,5096,5096,5096,20,101920,5200,-104,2016-10-20
Bottlers Nepal (Terai) Limited,4,5280,5197,5280,150,782050,5096,184,2016-11-14
Bottlers Nepal (Terai) Limited,4,5175,5000,5000,150,754910,5280,-280,2016-11-15
Bottlers Nepal (Terai) Limited,4,4900,4700,4700,41,195800,5000,-300,2016-11-20
Bottlers Nepal (Terai) Limited,3,4606,4514,4514,50,229380,4700,-186,2016-11-23
Bottlers Nepal (Terai) Limited,2,4500,4425,4500,80,356250,4514,-14,2016-11-24
Bottlers Nepal (Terai) Limited,2,4410,4322,4322,20,87320,4500,-178,2016-11-28
Bottlers Nepal (Terai) Limited,10,4325,4000,4010,340,1427950,4322,-312,2016-11-29
Bottlers Nepal (Terai) Limited,2,4010,4010,4010,37,148370,4010,0,2016-12-01
Bottlers Nepal (Terai) Limited,1,4090,4090,4090,20,81800,4010,80,2016-12-04
Bottlers Nepal (Terai) Limited,1,4149,4149,4149,60,248940,4090,59,2016-12-11
Bottlers Nepal (Terai) Limited,1,4231,4231,4231,50,211550,4149,82,2016-12-15
Bottlers Nepal (Terai) Limited,2,4147,4065,4065,20,82120,4231,-166,2017-01-01
Bottlers Nepal (Terai) Limited,4,4228,4144,4144,60,252020,4065,79,2017-01-02
Bottlers Nepal (Terai) Limited,3,4062,3902,3902,30,119450,4144,-242,2017-01-25
Bottlers Nepal (Terai) Limited,2,3824,3819,3819,110,420140,3902,-83,2017-02-15
Bottlers Nepal (Terai) Limited,2,3750,3743,3743,30,112430,3819,-76,2017-02-16
Bottlers Nepal (Terai) Limited,1,3669,3669,3669,10,36690,3743,-74,2017-02-23
Bottlers Nepal (Terai) Limited,3,3650,3596,3650,50,181960,3669,-19,2017-02-26
Bottlers Nepal (Terai) Limited,2,3645,3610,3610,25,90600,3650,-40,2017-03-02
Bottlers Nepal (Terai) Limited,3,3538,3500,3500,30,105380,3610,-110,2017-03-06
Bottlers Nepal (Terai) Limited,4,3510,3510,3510,80,280800,3500,10,2017-03-15
Bottlers Nepal (Terai) Limited,1,3510,3510,3510,350,1228500,3510,0,2017-03-28
Bottlers Nepal (Terai) Limited,4,3450,3440,3450,530,1828200,3510,-60,2017-03-29
Bottlers Nepal (Terai) Limited,1,3450,3450,3450,12,41400,3450,0,2017-04-06
Bottlers Nepal (Terai) Limited,1,3382,3382,3382,100,338200,3450,-68,2017-04-09
Bottlers Nepal (Terai) Limited,1,3449,3449,3449,10,34490,3382,67,2017-04-10
Bottlers Nepal (Terai) Limited,5,3793,3517,3793,50,182860,3449,344,2017-04-11
Bottlers Nepal (Terai) Limited,21,4172,3868,4088,720,2953310,3793,295,2017-04-12
Bottlers Nepal (Terai) Limited,1,4010,4010,4010,30,120300,4088,-78,2017-04-13
Bottlers Nepal (Terai) Limited,1,3930,3930,3930,20,78600,4010,-80,2017-04-18
Bottlers Nepal (Terai) Limited,1,4000,4000,4000,10,40000,3930,70,2017-04-19
Bottlers Nepal (Terai) Limited,2,3920,3920,3920,40,156800,4000,-80,2017-04-20
Bottlers Nepal (Terai) Limited,1,3998,3998,3998,50,199900,3920,78,2017-04-23
Bottlers Nepal (Terai) Limited,1,4000,4000,4000,10,40000,3998,2,2017-04-25
Bottlers Nepal (Terai) Limited,1,4000,4000,4000,20,80000,4000,0,2017-04-27
Bottlers Nepal (Terai) Limited,1,3920,3920,3920,12,47040,4000,-80,2017-05-02
Bottlers Nepal (Terai) Limited,13,3995,3890,3890,3671,14352315,3920,-30,2017-05-03
Bottlers Nepal (Terai) Limited,2,3891,3891,3891,1000,3891000,3890,1,2017-05-04
Bottlers Nepal (Terai) Limited,1,3968,3968,3968,10,39680,3891,77,2017-05-07
Bottlers Nepal (Terai) Limited,10,4211,3970,4127,1280,5240200,3968,159,2017-05-11
Bottlers Nepal (Terai) Limited,6,4539,4200,4539,565,2389955,4127,412,2017-05-15
Bottlers Nepal (Terai) Limited,8,4992,4629,4992,210,1000600,4539,453,2017-05-16
Bottlers Nepal (Terai) Limited,6,5491,5091,5491,60,319600,4992,499,2017-05-17
Bottlers Nepal (Terai) Limited,6,6040,5600,6040,75,442200,5491,549,2017-05-18
Bottlers Nepal (Terai) Limited,5,6644,6160,6644,50,320310,6040,604,2017-05-21
Bottlers Nepal (Terai) Limited,1,6776,6776,6776,10,67760,6644,132,2017-05-22
Bottlers Nepal (Terai) Limited,55,7453,6800,7354,1562,11314871,6776,578,2017-05-23
Bottlers Nepal (Terai) Limited,33,7350,6999,7205,2690,19321840,7354,-149,2017-05-24
Bottlers Nepal (Terai) Limited,17,7349,6792,6800,670,4603500,7205,-405,2017-05-28
Bottlers Nepal (Terai) Limited,17,6927,6691,6927,721,4895860,6800,127,2017-05-30
Bottlers Nepal (Terai) Limited,11,6800,6600,6600,1125,7470690,6927,-327,2017-05-31
Bottlers Nepal (Terai) Limited,5,6866,6724,6724,145,977940,6600,124,2017-06-01
Bottlers Nepal (Terai) Limited,3,6590,6590,6590,45,296550,6724,-134,2017-06-04
Bottlers Nepal (Terai) Limited,5,6590,6459,6459,160,1047610,6590,-131,2017-06-05
Bottlers Nepal (Terai) Limited,12,6447,6260,6270,250,1600270,6459,-189,2017-06-06
Bottlers Nepal (Terai) Limited,2,6395,6271,6395,20,126660,6270,125,2017-06-07
Bottlers Nepal (Terai) Limited,1,6300,6300,6300,10,63000,6395,-95,2017-06-08
Bottlers Nepal (Terai) Limited,3,6477,6350,6477,70,448270,6300,177,2017-06-11
Bottlers Nepal (Terai) Limited,2,6500,6370,6370,20,128700,6477,-107,2017-06-12
Bottlers Nepal (Terai) Limited,4,6497,6243,6497,190,1218770,6370,127,2017-06-13
Bottlers Nepal (Terai) Limited,2,6450,6440,6450,390,2511800,6497,-47,2017-06-14
Bottlers Nepal (Terai) Limited,5,6570,6432,6570,135,876280,6450,120,2017-06-15
Bottlers Nepal (Terai) Limited,2,6445,6442,6442,700,4510000,6570,-128,2017-06-18
Bottlers Nepal (Terai) Limited,5,6314,6101,6101,80,494210,6442,-341,2017-06-19
Bottlers Nepal (Terai) Limited,3,6225,6111,6111,40,246700,6101,10,2017-06-20
Bottlers Nepal (Terai) Limited,1,6200,6200,6200,100,620000,6111,89,2017-06-21
Bottlers Nepal (Terai) Limited,1,6324,6324,6324,10,63240,6200,124,2017-06-25
Bottlers Nepal (Terai) Limited,3,6200,6198,6199,110,681950,6324,-125,2017-06-27
Bottlers Nepal (Terai) Limited,2,6200,6080,6200,130,802400,6199,1,2017-07-02
Bottlers Nepal (Terai) Limited,1,6300,6300,6300,90,567000,6200,100,2017-07-06
Bottlers Nepal (Terai) Limited,4,6174,6071,6071,70,427610,6300,-229,2017-07-09
Bottlers Nepal (Terai) Limited,2,6192,6075,6075,840,5200110,6071,4,2017-07-10
Bottlers Nepal (Terai) Limited,3,6085,6075,6085,870,5291400,6075,10,2017-07-11
Bottlers Nepal (Terai) Limited,1,6205,6205,6205,20,124100,6085,120,2017-07-17
Bottlers Nepal (Terai) Limited,1,6205,6205,6205,50,310250,6205,0,2017-07-18
Bottlers Nepal (Terai) Limited,1,7010,7010,7010,10,70100,7077,-67,2017-08-03
Bottlers Nepal (Terai) Limited,3,6420,6300,6400,110,698800,6205,195,2017-07-19
Bottlers Nepal (Terai) Limited,2,6528,6400,6400,20,129280,6400,0,2017-07-20
Bottlers Nepal (Terai) Limited,2,6528,6525,6525,20,130530,6400,125,2017-07-23
Bottlers Nepal (Terai) Limited,7,6850,6655,6750,150,1016500,6525,225,2017-07-24
Bottlers Nepal (Terai) Limited,15,7300,6885,7300,350,2463070,6750,550,2017-07-25
Bottlers Nepal (Terai) Limited,19,8000,7386,7386,390,3027890,7300,86,2017-07-26
Bottlers Nepal (Terai) Limited,1,7260,7260,7260,226,1640760,7386,-126,2017-07-27
Bottlers Nepal (Terai) Limited,6,7405,7200,7200,90,659220,7260,-60,2017-07-30
Bottlers Nepal (Terai) Limited,4,7343,7215,7215,100,730280,7200,15,2017-07-31
Bottlers Nepal (Terai) Limited,9,7222,7075,7222,350,2493590,7215,7,2017-08-01
Bottlers Nepal (Terai) Limited,7,7366,6939,7077,250,1751590,7222,-145,2017-08-02
Bottlers Nepal (Terai) Limited,1,7150,7150,7150,10,71500,7010,140,2017-08-06
Bottlers Nepal (Terai) Limited,4,7150,7010,7150,110,775300,7150,0,2017-08-10
Bottlers Nepal (Terai) Limited,4,7150,7007,7150,70,493350,7150,0,2017-08-13
Bottlers Nepal (Terai) Limited,6,7400,7007,7400,240,1713720,7150,250,2017-08-15
Bottlers Nepal (Terai) Limited,2,7252,7252,7252,20,145040,7400,-148,2017-08-16
Bottlers Nepal (Terai) Limited,6,7107,6965,6965,80,560220,7252,-287,2017-08-17
Bottlers Nepal (Terai) Limited,5,7104,7000,7100,540,3833080,6965,135,2017-08-20
Bottlers Nepal (Terai) Limited,4,7100,7100,7100,200,1420000,7100,0,2017-08-23
Bottlers Nepal (Terai) Limited,6,7250,7150,7250,210,1515720,7100,150,2017-08-24
Bottlers Nepal (Terai) Limited,1,7106,7106,7106,60,426360,7250,-144,2017-08-28
Bottlers Nepal (Terai) Limited,4,7000,6970,7000,201,1403000,7106,-106,2017-08-31
Bottlers Nepal (Terai) Limited,1,6900,6900,6900,50,345000,7000,-100,2017-09-04
Bottlers Nepal (Terai) Limited,2,6762,6762,6762,100,676200,6900,-138,2017-09-06
Bottlers Nepal (Terai) Limited,2,6635,6630,6630,25,165800,6762,-132,2017-09-07
Bottlers Nepal (Terai) Limited,10,6800,6517,6517,290,1910070,6630,-113,2017-09-10
Bottlers Nepal (Terai) Limited,3,6778,6600,6778,140,942270,6517,261,2017-09-11
Bottlers Nepal (Terai) Limited,5,6899,6627,6627,60,404560,6778,-151,2017-09-13
Bottlers Nepal (Terai) Limited,2,6625,6600,6600,20,132250,6627,-27,2017-09-14
Bottlers Nepal (Terai) Limited,3,6866,6732,6866,30,204640,6600,266,2017-09-17
Bottlers Nepal (Terai) Limited,1,6866,6866,6866,135,926910,6866,0,2017-09-18
Bottlers Nepal (Terai) Limited,1,7000,7000,7000,10,70000,6866,134,2017-09-25
Bottlers Nepal (Terai) Limited,4,6860,6723,6723,155,1044805,7000,-277,2017-09-26
Bottlers Nepal (Terai) Limited,1,6857,6857,6857,10,68570,6723,134,2017-10-04
Bottlers Nepal (Terai) Limited,3,6720,6586,6586,147,981542,6857,-271,2017-10-08
Bottlers Nepal (Terai) Limited,2,6600,6550,6550,30,197000,6586,-36,2017-10-11
Bottlers Nepal (Terai) Limited,2,6681,6650,6681,70,467050,6550,131,2017-10-24
Bottlers Nepal (Terai) Limited,5,6549,6421,6549,230,1503540,6681,-132,2017-10-30
Bottlers Nepal (Terai) Limited,5,6600,6500,6600,220,1443600,6549,51,2017-10-31
Bottlers Nepal (Terai) Limited,2,6500,6371,6371,110,713710,6600,-229,2017-11-05
Bottlers Nepal (Terai) Limited,2,6498,6498,6498,50,324900,6371,127,2017-11-06
Bottlers Nepal (Terai) Limited,23,6369,5849,5849,700,4257810,6498,-649,2017-11-08
Bottlers Nepal (Terai) Limited,3,5880,5800,5805,110,639050,5849,-44,2017-11-09
Bottlers Nepal (Terai) Limited,3,5921,5900,5921,130,769520,5805,116,2017-11-13
Bottlers Nepal (Terai) Limited,1,5900,5900,5900,10,59000,5921,-21,2017-11-16
Bottlers Nepal (Terai) Limited,3,6138,6018,6020,120,734180,5900,120,2017-11-26
Bottlers Nepal (Terai) Limited,7,7900,7742,7742,290,2257970,7960,-218,2017-12-20
Bottlers Nepal (Terai) Limited,2,5900,5900,5900,220,1298000,6020,-120,2017-12-05
Bottlers Nepal (Terai) Limited,6,6490,6000,6490,60,375680,5900,590,2017-12-10
Bottlers Nepal (Terai) Limited,3,6488,6361,6488,220,1412900,6490,-2,2017-12-11
Bottlers Nepal (Terai) Limited,6,6735,6600,6735,600,3973550,6488,247,2017-12-12
Bottlers Nepal (Terai) Limited,22,7140,6732,7140,1020,6963570,6735,405,2017-12-13
Bottlers Nepal (Terai) Limited,4,7200,7000,7200,80,567460,7140,60,2017-12-14
Bottlers Nepal (Terai) Limited,27,7800,7340,7800,630,4825610,7200,600,2017-12-17
Bottlers Nepal (Terai) Limited,17,8287,7810,8115,291,2376915,7800,315,2017-12-18
Bottlers Nepal (Terai) Limited,13,8109,7795,7960,1920,15058210,8115,-155,2017-12-19
Bottlers Nepal (Terai) Limited,16,8160,7776,7886,860,6847320,7742,144,2017-12-21
Bottlers Nepal (Terai) Limited,11,8200,8000,8000,600,4850340,7886,114,2017-12-24
Bottlers Nepal (Terai) Limited,8,7841,7685,7705,405,3137900,8000,-295,2017-12-26
Bottlers Nepal (Terai) Limited,2,7845,7800,7845,20,156450,7705,140,2017-12-27
Bottlers Nepal (Terai) Limited,5,7700,7690,7700,190,1462150,7845,-145,2017-12-28
Bottlers Nepal (Terai) Limited,14,7546,7250,7252,240,1764170,7700,-448,2017-12-31
Bottlers Nepal (Terai) Limited,3,7544,7397,7544,39,292746,7252,292,2018-01-01
Bottlers Nepal (Terai) Limited,4,7550,7400,7400,110,816550,7544,-144,2018-01-02
Bottlers Nepal (Terai) Limited,13,7300,7151,7151,210,1515580,7400,-249,2018-01-03
Bottlers Nepal (Terai) Limited,3,7439,7291,7291,80,586390,7151,140,2018-01-04
Bottlers Nepal (Terai) Limited,4,7436,7250,7250,80,584460,7291,-41,2018-01-07
Bottlers Nepal (Terai) Limited,3,7250,7108,7250,60,427900,7250,0,2018-01-08
Bottlers Nepal (Terai) Limited,3,7225,7200,7225,60,432500,7250,-25,2018-01-09
Bottlers Nepal (Terai) Limited,7,7200,7081,7081,140,997570,7225,-144,2018-01-14
Bottlers Nepal (Terai) Limited,1,6950,6950,6950,20,139000,7081,-131,2018-01-16
Bottlers Nepal (Terai) Limited,1,7000,7000,7000,10,70000,6950,50,2018-01-17
Bottlers Nepal (Terai) Limited,6,7100,6950,6950,220,1537560,7000,-50,2018-01-21
Bottlers Nepal (Terai) Limited,1,7000,7000,7000,10,70000,6950,50,2018-01-22
Bottlers Nepal (Terai) Limited,1,6865,6865,6865,10,68650,7000,-135,2018-01-24
Bottlers Nepal (Terai) Limited,8,7151,7002,7151,120,852580,6865,286,2018-01-25
Bottlers Nepal (Terai) Limited,1,7250,7250,7250,10,72500,7151,99,2018-01-28
Bottlers Nepal (Terai) Limited,1,7200,7200,7200,10,72000,7250,-50,2018-01-31
Bottlers Nepal (Terai) Limited,3,7200,7100,7100,40,285010,7200,-100,2018-02-04
Bottlers Nepal (Terai) Limited,2,6958,6861,6861,25,172980,7100,-239,2018-02-07
Bottlers Nepal (Terai) Limited,2,7225,7081,7081,25,179185,7165,-84,2018-02-25
Bottlers Nepal (Terai) Limited,2,7137,6998,7137,20,141350,6861,276,2018-02-15
Bottlers Nepal (Terai) Limited,4,7424,7200,7424,283,2058907,7137,287,2018-02-18
Bottlers Nepal (Terai) Limited,12,7276,6890,7027,214,1502918,7424,-397,2018-02-20
Bottlers Nepal (Terai) Limited,1,6891,6891,6891,40,275640,7027,-136,2018-02-21
Bottlers Nepal (Terai) Limited,2,7165,7028,7165,20,141930,6891,274,2018-02-22
Bottlers Nepal (Terai) Limited,1,6940,6940,6940,10,69400,7081,-141,2018-02-27
Bottlers Nepal (Terai) Limited,5,6803,6666,6666,60,402690,6940,-274,2018-02-28
Bottlers Nepal (Terai) Limited,8,6533,6275,6275,130,836340,6666,-391,2018-03-04
Bottlers Nepal (Terai) Limited,30,6400,5935,5935,1550,9532160,6275,-340,2018-03-05
Bottlers Nepal (Terai) Limited,11,6150,6000,6100,280,1686970,5935,165,2018-03-06
Bottlers Nepal (Terai) Limited,5,6300,6174,6174,100,620480,6100,74,2018-03-07
Bottlers Nepal (Terai) Limited,8,6060,5823,5823,330,1939920,6174,-351,2018-03-11
Bottlers Nepal (Terai) Limited,13,6300,5938,6054,560,3393910,5823,231,2018-03-12
Bottlers Nepal (Terai) Limited,1,6100,6100,6100,10,61000,6054,46,2018-03-13
Bottlers Nepal (Terai) Limited,4,6100,5900,6000,250,1482780,6100,-100,2018-03-14
Bottlers Nepal (Terai) Limited,4,6100,5901,6019,50,301390,6000,19,2018-03-15
Bottlers Nepal (Terai) Limited,1,6100,6100,6100,60,366000,6019,81,2018-03-19
Bottlers Nepal (Terai) Limited,7,6060,5861,5939,90,535020,6100,-161,2018-03-20
Bottlers Nepal (Terai) Limited,7,5825,5709,5709,260,1496410,5939,-230,2018-03-21
Bottlers Nepal (Terai) Limited,7,5900,5595,5668,260,1500690,5709,-41,2018-03-22
Bottlers Nepal (Terai) Limited,4,5600,5555,5555,40,222700,5668,-113,2018-03-26
Bottlers Nepal (Terai) Limited,13,5710,5336,5710,389,2162558,5555,155,2018-03-27
Bottlers Nepal (Terai) Limited,18,5824,5480,5550,420,2324120,5710,-160,2018-03-28
Bottlers Nepal (Terai) Limited,8,5700,5439,5700,150,841280,5550,150,2018-03-29
Bottlers Nepal (Terai) Limited,5,5586,5475,5475,60,329880,5700,-225,2018-04-01
Bottlers Nepal (Terai) Limited,5,5584,5366,5366,180,992440,5475,-109,2018-04-02
Bottlers Nepal (Terai) Limited,1,5473,5473,5473,10,54730,5366,107,2018-04-03
Bottlers Nepal (Terai) Limited,5,5580,5371,5500,110,604200,5473,27,2018-04-04
Bottlers Nepal (Terai) Limited,5,5836,5610,5720,50,287240,5500,220,2018-04-05
Bottlers Nepal (Terai) Limited,25,6292,5800,6167,653,3980152,5720,447,2018-04-08
Bottlers Nepal (Terai) Limited,12,6415,5932,5932,300,1881020,6167,-235,2018-04-09
Bottlers Nepal (Terai) Limited,10,6050,5929,5929,200,1190100,5932,-3,2018-04-10
Bottlers Nepal (Terai) Limited,1,6046,6046,6046,20,120920,5929,117,2018-04-12
Bottlers Nepal (Terai) Limited,7,5926,5808,5924,120,704180,6046,-122,2018-04-15
Bottlers Nepal (Terai) Limited,1,6000,6000,6000,10,60000,5924,76,2018-04-16
Bottlers Nepal (Terai) Limited,6,6242,6100,6190,140,864720,6000,190,2018-04-17
Bottlers Nepal (Terai) Limited,6,6435,6067,6435,140,876030,6190,245,2018-04-18
Bottlers Nepal (Terai) Limited,8,6552,6435,6552,210,1372610,6435,117,2018-04-19
Bottlers Nepal (Terai) Limited,4,6813,6680,6813,40,269860,6552,261,2018-04-22
Bottlers Nepal (Terai) Limited,6,6813,6547,6547,130,871870,6813,-266,2018-04-23
Bottlers Nepal (Terai) Limited,4,6600,6470,6470,40,262690,6547,-77,2018-04-24
Bottlers Nepal (Terai) Limited,7,6341,6000,6000,80,493130,6470,-470,2018-04-26
Bottlers Nepal (Terai) Limited,1,6120,6120,6120,10,61200,6000,120,2018-04-29
Bottlers Nepal (Terai) Limited,2,6121,6001,6121,60,361260,6120,1,2018-05-02
Bottlers Nepal (Terai) Limited,7,6367,6243,6350,120,762030,6121,229,2018-05-03
Bottlers Nepal (Terai) Limited,1,6223,6223,6223,10,62230,6350,-127,2018-05-06
Bottlers Nepal (Terai) Limited,2,6347,6300,6300,20,126470,6223,77,2018-05-08
Bottlers Nepal (Terai) Limited,4,6303,6180,6300,60,373230,6300,0,2018-05-14
Bottlers Nepal (Terai) Limited,3,6426,6298,6298,220,1387240,6300,-2,2018-05-16
Bottlers Nepal (Terai) Limited,1,6180,6180,6180,20,123600,6298,-118,2018-05-17
Bottlers Nepal (Terai) Limited,3,6303,6100,6303,70,430250,6180,123,2018-05-21
Bottlers Nepal (Terai) Limited,4,6300,6300,6300,210,1323000,6303,-3,2018-05-22
Butwal Power Company Limited,21,620,608,608,10149,6225077,612,-4,2016-05-23
Butwal Power Company Limited,11,610,607,610,3131,1905610,608,2,2016-05-24
Butwal Power Company Limited,22,620,612,620,6166,3799218,610,10,2016-05-25
Butwal Power Company Limited,17,618,608,618,5067,3105712,620,-2,2016-05-26
Butwal Power Company Limited,34,640,622,635,13228,8386588,618,17,2016-05-29
Butwal Power Company Limited,132,685,640,683,54576,35727774,635,48,2016-05-30
Butwal Power Company Limited,231,739,693,738,79830,57716720,683,55,2016-05-31
Butwal Power Company Limited,240,811,735,760,63264,48970931,738,22,2016-06-01
Butwal Power Company Limited,81,752,728,748,18582,13763434,760,-12,2016-06-02
Butwal Power Company Limited,59,735,680,685,9944,6982070,748,-63,2016-06-05
Butwal Power Company Limited,44,711,685,708,11555,8120960,685,23,2016-06-06
Butwal Power Company Limited,29,740,700,700,4305,3101046,708,-8,2016-06-07
Butwal Power Company Limited,110,915,880,885,29770,26513658,872,13,2016-06-23
Butwal Power Company Limited,35,719,686,704,10585,7478894,700,4,2016-06-08
Butwal Power Company Limited,28,710,696,700,10259,7184857,704,-4,2016-06-09
Butwal Power Company Limited,22,734,707,709,6642,4779037,700,9,2016-06-12
Butwal Power Company Limited,14,710,700,703,3346,2354736,709,-6,2016-06-13
Butwal Power Company Limited,16,773,715,773,4135,3088191,703,70,2016-06-14
Butwal Power Company Limited,14,850,788,850,4650,3847060,773,77,2016-06-15
Butwal Power Company Limited,288,935,839,849,66287,57981596,850,-1,2016-06-16
Butwal Power Company Limited,110,850,800,837,27590,23111495,849,-12,2016-06-19
Butwal Power Company Limited,64,845,800,824,24524,20257865,837,-13,2016-06-20
Butwal Power Company Limited,68,846,827,845,20894,17532301,824,21,2016-06-21
Butwal Power Company Limited,85,889,845,872,27209,23494061,845,27,2016-06-22
Butwal Power Company Limited,162,925,895,924,51241,46725264,885,39,2016-06-26
Butwal Power Company Limited,52,944,912,920,15972,14801317,924,-4,2016-06-27
Butwal Power Company Limited,82,928,900,925,28411,25871631,920,5,2016-06-28
Butwal Power Company Limited,69,930,912,930,18162,16715996,925,5,2016-06-29
Butwal Power Company Limited,49,929,909,929,9305,8561772,930,-1,2016-06-30
Butwal Power Company Limited,50,930,910,920,9163,8431143,929,-9,2016-07-03
Butwal Power Company Limited,27,940,910,910,6616,6144496,920,-10,2016-07-04
Butwal Power Company Limited,22,925,900,919,8513,7770324,910,9,2016-07-05
Butwal Power Company Limited,45,929,915,924,12033,11103765,919,5,2016-07-06
Butwal Power Company Limited,18,924,910,910,3868,3529290,924,-14,2016-07-10
Butwal Power Company Limited,17,914,896,906,3463,3127870,910,-4,2016-07-11
Butwal Power Company Limited,31,900,855,885,8765,7799350,906,-21,2016-07-12
Butwal Power Company Limited,16,895,880,885,2421,2154801,885,0,2016-07-13
Butwal Power Company Limited,25,900,885,894,8633,7699005,885,9,2016-07-14
Butwal Power Company Limited,15,890,871,875,1949,1709098,894,-19,2016-07-17
Butwal Power Company Limited,24,920,870,920,7334,6533028,875,45,2016-07-18
Butwal Power Company Limited,21,926,895,895,7215,6528575,920,-25,2016-07-19
Butwal Power Company Limited,25,904,881,904,6108,5448657,895,9,2016-07-20
Butwal Power Company Limited,19,900,891,898,3423,3067295,904,-6,2016-07-21
Butwal Power Company Limited,22,900,875,875,5446,4844416,898,-23,2016-07-25
Butwal Power Company Limited,50,907,880,892,15696,14048683,875,17,2016-07-26
Butwal Power Company Limited,72,939,901,921,21438,19710341,892,29,2016-07-27
Butwal Power Company Limited,109,939,920,938,40420,37708693,921,17,2016-07-28
Butwal Power Company Limited,114,1008,920,995,49779,48117990,938,57,2016-07-31
Butwal Power Company Limited,43,1030,960,970,15050,14740400,995,-25,2016-08-01
Butwal Power Company Limited,44,960,930,949,15360,14507837,970,-21,2016-08-02
Butwal Power Company Limited,53,960,920,940,9552,9029068,949,-9,2016-08-03
Butwal Power Company Limited,80,941,900,908,16312,14957615,940,-32,2016-08-04
Butwal Power Company Limited,55,944,910,915,12421,11509369,908,7,2016-08-07
Butwal Power Company Limited,17,915,870,870,3283,2896355,915,-45,2016-08-08
Butwal Power Company Limited,3,922,887,922,110,100170,870,52,2016-08-09
Butwal Power Company Limited,50,940,900,922,15496,14223066,922,0,2016-08-10
Butwal Power Company Limited,18,930,910,910,4200,3845860,922,-12,2016-08-11
Butwal Power Company Limited,25,910,880,882,7795,6973203,910,-28,2016-08-14
Butwal Power Company Limited,31,890,856,875,11093,9640541,882,-7,2016-08-15
Butwal Power Company Limited,43,860,813,839,13773,11586308,877,-38,2016-08-31
Butwal Power Company Limited,27,895,875,895,6031,5304500,875,20,2016-08-16
Butwal Power Company Limited,13,904,880,904,4700,4207850,895,9,2016-08-17
Butwal Power Company Limited,3,900,882,882,600,536400,904,-22,2016-08-21
Butwal Power Company Limited,6,870,840,840,1210,1031700,882,-42,2016-08-22
Butwal Power Company Limited,13,882,850,865,2525,2171100,840,25,2016-08-23
Butwal Power Company Limited,14,878,849,878,2630,2259700,865,13,2016-08-24
Butwal Power Company Limited,4,894,862,862,590,517530,878,-16,2016-08-28
Butwal Power Company Limited,2,879,862,862,378,328522,862,0,2016-08-29
Butwal Power Company Limited,15,877,850,877,2749,2360117,862,15,2016-08-30
Butwal Power Company Limited,23,854,824,841,3967,3333919,839,2,2016-09-01
Butwal Power Company Limited,6,850,837,845,1374,1159287,841,4,2016-09-04
Butwal Power Company Limited,16,852,840,840,3623,3060547,845,-5,2016-09-05
Butwal Power Company Limited,22,856,830,835,11024,9365936,840,-5,2016-09-06
Butwal Power Company Limited,9,845,825,840,2200,1839000,835,5,2016-09-07
Butwal Power Company Limited,12,850,833,833,2964,2483985,840,-7,2016-09-08
Butwal Power Company Limited,15,840,828,830,4717,3928510,833,-3,2016-09-11
Butwal Power Company Limited,4,829,823,829,800,660100,830,-1,2016-09-12
Butwal Power Company Limited,3,829,822,823,750,619750,829,-6,2016-09-14
Butwal Power Company Limited,2,825,823,825,223,183815,823,2,2016-09-18
Butwal Power Company Limited,2,830,829,829,800,663500,825,4,2016-09-20
Butwal Power Company Limited,8,830,821,825,1450,1196050,829,-4,2016-09-21
Butwal Power Company Limited,9,820,810,818,2177,1774720,825,-7,2016-09-22
Butwal Power Company Limited,13,805,790,790,2236,1782590,818,-28,2016-09-25
Butwal Power Company Limited,11,810,790,801,2320,1868100,790,11,2016-09-26
Butwal Power Company Limited,1,810,810,810,100,81000,801,9,2016-09-27
Butwal Power Company Limited,8,810,800,805,2280,1839650,810,-5,2016-09-28
Butwal Power Company Limited,11,810,804,804,1166,941100,805,-1,2016-09-29
Butwal Power Company Limited,1,810,810,810,100,81000,804,6,2016-10-03
Butwal Power Company Limited,12,820,795,806,5433,4385598,810,-4,2016-10-04
Butwal Power Company Limited,14,810,797,810,2050,1644550,806,4,2016-10-05
Butwal Power Company Limited,5,825,812,812,1540,1253080,810,2,2016-10-06
Butwal Power Company Limited,1,801,801,801,200,160200,812,-11,2016-10-16
Butwal Power Company Limited,12,817,804,817,1873,1518465,801,16,2016-10-17
Butwal Power Company Limited,4,820,807,820,2000,1631000,817,3,2016-10-18
Butwal Power Company Limited,10,818,810,810,708,574976,820,-10,2016-10-19
Butwal Power Company Limited,5,824,820,824,1033,849592,810,14,2016-10-20
Butwal Power Company Limited,7,820,810,815,2073,1694860,824,-9,2016-10-23
Butwal Power Company Limited,8,823,786,809,1330,1070400,815,-6,2016-10-24
Butwal Power Company Limited,2,810,810,810,100,81000,809,1,2016-10-25
Butwal Power Company Limited,12,800,785,795,2776,2200805,810,-15,2016-10-26
Butwal Power Company Limited,7,800,790,790,1080,857000,795,-5,2016-10-27
Butwal Power Company Limited,6,790,776,785,1300,1017300,790,-5,2016-11-03
Butwal Power Company Limited,45,850,778,778,8193,6566907,785,-7,2016-11-07
Butwal Power Company Limited,21,763,718,725,4020,2962715,778,-53,2016-11-08
Butwal Power Company Limited,4,725,711,711,364,260460,725,-14,2016-11-09
Butwal Power Company Limited,4,715,705,705,270,191600,711,-6,2016-11-10
Butwal Power Company Limited,4,718,706,718,884,628478,705,13,2016-11-13
Butwal Power Company Limited,7,715,683,683,2011,1420701,718,-35,2016-11-15
Butwal Power Company Limited,5,685,680,685,750,513133,683,2,2016-11-16
Butwal Power Company Limited,5,678,660,660,1085,720855,685,-25,2016-11-17
Butwal Power Company Limited,12,647,620,620,2450,1536600,660,-40,2016-11-20
Butwal Power Company Limited,11,620,602,620,1600,983460,620,0,2016-11-21
Butwal Power Company Limited,2,625,613,613,1000,619000,620,-7,2016-11-22
Butwal Power Company Limited,6,624,613,624,1540,946290,613,11,2016-11-23
Butwal Power Company Limited,18,636,591,600,4300,2609910,624,-24,2016-11-24
Butwal Power Company Limited,43,612,578,585,10915,6423392,600,-15,2016-11-27
Butwal Power Company Limited,26,580,560,580,5381,3062600,585,-5,2016-11-28
Butwal Power Company Limited,19,638,580,638,3625,2225492,580,58,2016-11-29
Butwal Power Company Limited,24,683,650,680,4260,2839145,638,42,2016-11-30
Butwal Power Company Limited,22,696,665,670,5510,3728500,680,-10,2016-12-01
Butwal Power Company Limited,20,670,645,655,3309,2158492,670,-15,2016-12-04
Butwal Power Company Limited,2,615,603,603,220,132900,612,-9,2016-12-05
Butwal Power Company Limited,8,591,575,577,2910,1692060,603,-26,2016-12-06
Butwal Power Company Limited,1,588,588,588,14,8232,577,11,2016-12-07
Butwal Power Company Limited,14,601,577,600,3440,2009170,588,12,2016-12-08
Butwal Power Company Limited,10,590,575,575,1235,715910,600,-25,2016-12-11
Butwal Power Company Limited,8,577,571,577,1280,733260,575,2,2016-12-12
Butwal Power Company Limited,2,580,572,580,450,260600,577,3,2016-12-14
Butwal Power Company Limited,4,607,575,607,540,311370,580,27,2016-12-15
Butwal Power Company Limited,1,619,619,619,10,6190,607,12,2016-12-18
Butwal Power Company Limited,4,607,595,595,290,174350,619,-24,2016-12-19
Butwal Power Company Limited,10,585,570,572,3200,1835000,595,-23,2016-12-20
Butwal Power Company Limited,3,571,560,571,710,398210,572,-1,2016-12-21
Butwal Power Company Limited,3,575,570,575,800,456500,571,4,2016-12-22
Butwal Power Company Limited,6,575,565,565,2450,1398500,575,-10,2016-12-26
Butwal Power Company Limited,11,570,545,560,1141,636720,565,-5,2016-12-27
Butwal Power Company Limited,8,569,550,560,1070,596320,560,0,2016-12-28
Butwal Power Company Limited,7,580,550,550,950,530550,560,-10,2016-12-29
Butwal Power Company Limited,15,562,550,559,9760,5444640,550,9,2017-01-01
Butwal Power Company Limited,17,562,559,559,5280,2958110,559,0,2017-01-02
Butwal Power Company Limited,13,560,548,550,7970,4416060,559,-9,2017-01-03
Butwal Power Company Limited,5,560,552,560,2970,1661540,550,10,2017-01-04
Butwal Power Company Limited,5,554,553,553,1502,831706,560,-7,2017-01-05
Butwal Power Company Limited,2,564,554,554,110,61040,553,1,2017-01-08
Butwal Power Company Limited,3,559,558,559,1290,720120,554,5,2017-01-09
Butwal Power Company Limited,11,560,555,555,1853,1035687,559,-4,2017-01-10
Butwal Power Company Limited,1,550,550,550,100,55000,555,-5,2017-01-11
Butwal Power Company Limited,2,560,560,560,120,67200,550,10,2017-01-12
Butwal Power Company Limited,3,559,559,559,300,167700,560,-1,2017-01-15
Butwal Power Company Limited,4,556,549,549,500,275120,559,-10,2017-01-16
Butwal Power Company Limited,1,544,544,544,203,110432,549,-5,2017-01-17
Butwal Power Company Limited,1,542,542,542,251,136042,544,-2,2017-01-22
Butwal Power Company Limited,9,550,536,550,2010,1089840,542,8,2017-01-23
Butwal Power Company Limited,4,549,538,538,130,70120,550,-12,2017-01-24
Butwal Power Company Limited,8,538,518,518,1050,549200,538,-20,2017-01-25
Butwal Power Company Limited,11,528,508,515,2150,1109600,518,-3,2017-01-26
Butwal Power Company Limited,13,510,500,500,1450,727350,515,-15,2017-01-30
Butwal Power Company Limited,22,512,485,512,28790,14172710,500,12,2017-01-31
Butwal Power Company Limited,13,532,500,532,30990,15513940,512,20,2017-02-01
Butwal Power Company Limited,13,542,520,530,11310,5992550,532,-2,2017-02-02
Butwal Power Company Limited,1,530,530,530,300,159000,530,0,2017-02-05
Butwal Power Company Limited,9,524,510,523,1483,761270,530,-7,2017-02-07
Butwal Power Company Limited,11,524,495,524,2020,1020430,523,1,2017-02-08
Butwal Power Company Limited,4,518,508,508,320,164080,524,-16,2017-02-09
Butwal Power Company Limited,13,502,484,490,2484,1226222,508,-18,2017-02-12
Butwal Power Company Limited,10,499,464,499,1960,942040,490,9,2017-02-13
Butwal Power Company Limited,24,490,470,481,5551,2638672,499,-18,2017-02-14
Butwal Power Company Limited,19,500,489,498,6292,3109464,481,17,2017-02-15
Butwal Power Company Limited,11,507,496,505,2410,1213090,498,7,2017-02-16
Butwal Power Company Limited,9,510,500,510,2266,1141330,505,5,2017-02-19
Butwal Power Company Limited,6,510,500,510,650,327600,510,0,2017-02-20
Butwal Power Company Limited,6,518,498,498,270,135580,510,-12,2017-02-21
Butwal Power Company Limited,1,490,490,490,7000,3430000,498,-8,2017-02-22
Butwal Power Company Limited,2,495,495,495,150,74250,490,5,2017-02-23
Butwal Power Company Limited,16,486,478,478,2092,1006170,495,-17,2017-02-26
Butwal Power Company Limited,2,490,487,490,350,171050,478,12,2017-02-28
Butwal Power Company Limited,6,482,475,475,1720,822120,490,-15,2017-03-01
Butwal Power Company Limited,4,512,484,512,40,19910,475,37,2017-03-02
Butwal Power Company Limited,12,509,499,500,2570,1292820,512,-12,2017-03-05
Butwal Power Company Limited,20,566,535,566,7030,3812315,540,26,2017-03-21
Butwal Power Company Limited,1,492,492,492,10,4920,500,-8,2017-03-06
Butwal Power Company Limited,2,500,500,500,330,165000,492,8,2017-03-07
Butwal Power Company Limited,11,501,492,501,5630,2806882,500,1,2017-03-09
Butwal Power Company Limited,8,505,496,496,1020,509500,501,-5,2017-03-13
Butwal Power Company Limited,5,500,491,491,1144,567680,496,-5,2017-03-14
Butwal Power Company Limited,8,520,492,520,2020,1017440,491,29,2017-03-15
Butwal Power Company Limited,5,530,515,520,250,129700,520,0,2017-03-16
Butwal Power Company Limited,8,523,510,523,1080,554470,520,3,2017-03-19
Butwal Power Company Limited,22,555,505,540,8112,4284076,523,17,2017-03-20
Butwal Power Company Limited,62,588,555,560,17055,9795661,566,-6,2017-03-22
Butwal Power Company Limited,41,580,555,575,11744,6690790,560,15,2017-03-23
Butwal Power Company Limited,45,630,585,630,14219,8667215,575,55,2017-03-26
Butwal Power Company Limited,103,693,642,693,30146,20788820,630,63,2017-03-28
Butwal Power Company Limited,138,748,682,682,29715,21124583,693,-11,2017-03-29
Butwal Power Company Limited,18,700,669,675,4800,3284000,682,-7,2017-03-30
Butwal Power Company Limited,10,705,670,705,790,545510,675,30,2017-04-02
Butwal Power Company Limited,33,733,686,686,8551,6055589,705,-19,2017-04-03
Butwal Power Company Limited,33,699,660,670,7140,4815180,686,-16,2017-04-04
Butwal Power Company Limited,19,670,656,656,3470,2303620,670,-14,2017-04-06
Butwal Power Company Limited,12,665,655,665,2230,1475100,656,9,2017-04-09
Butwal Power Company Limited,23,706,670,699,5047,3449355,665,34,2017-04-10
Butwal Power Company Limited,17,726,674,677,2877,1958675,699,-22,2017-04-11
Butwal Power Company Limited,27,703,679,679,7710,5303080,677,2,2017-04-12
Butwal Power Company Limited,11,692,666,678,1951,1329946,679,-1,2017-04-13
Butwal Power Company Limited,2,703,690,703,120,83060,678,25,2017-04-16
Butwal Power Company Limited,28,689,652,660,5110,3366740,703,-43,2017-04-18
Butwal Power Company Limited,17,699,665,689,1638,1102261,660,29,2017-04-19
Butwal Power Company Limited,32,690,675,685,10590,7221820,689,-4,2017-04-20
Butwal Power Company Limited,11,725,686,686,1675,1179200,685,1,2017-04-23
Butwal Power Company Limited,5,688,673,675,460,314125,686,-11,2017-04-24
Butwal Power Company Limited,9,688,662,688,3560,2407170,675,13,2017-04-25
Butwal Power Company Limited,2,675,670,670,1500,1010000,688,-18,2017-04-26
Butwal Power Company Limited,4,696,657,696,230,151890,670,26,2017-04-27
Butwal Power Company Limited,1,683,683,683,100,68300,696,-13,2017-04-30
Butwal Power Company Limited,2,690,689,690,200,137900,683,7,2017-05-02
Butwal Power Company Limited,20,680,667,679,3977,2671836,690,-11,2017-05-03
Butwal Power Company Limited,7,666,655,657,1000,658150,679,-22,2017-05-04
Butwal Power Company Limited,15,669,650,650,3052,1996388,657,-7,2017-05-07
Butwal Power Company Limited,2,650,638,638,400,258800,650,-12,2017-05-08
Butwal Power Company Limited,15,700,630,692,1493,978978,638,54,2017-05-09
Butwal Power Company Limited,16,687,655,666,1980,1327344,692,-26,2017-05-11
Butwal Power Company Limited,15,692,679,683,1223,838120,666,17,2017-05-15
Butwal Power Company Limited,4,680,669,669,4249,2848781,683,-14,2017-05-16
Butwal Power Company Limited,4,666,658,666,909,600944,669,-3,2017-05-17
Butwal Power Company Limited,6,679,662,679,1078,726241,666,13,2017-05-18
Butwal Power Company Limited,5,681,654,654,1343,884793,679,-25,2017-05-21
Butwal Power Company Limited,5,680,651,667,661,439137,654,13,2017-05-22
Butwal Power Company Limited,11,680,675,680,1939,1315197,667,13,2017-05-23
Butwal Power Company Limited,6,677,670,675,1760,1184850,680,-5,2017-05-24
Butwal Power Company Limited,5,670,665,667,1527,1017762,675,-8,2017-05-28
Butwal Power Company Limited,7,693,654,693,438,288472,667,26,2017-05-30
Butwal Power Company Limited,3,680,667,669,520,349880,693,-24,2017-06-01
Butwal Power Company Limited,16,660,641,648,2510,1624725,669,-21,2017-06-04
Butwal Power Company Limited,9,665,640,654,5825,3767682,648,6,2017-06-05
Butwal Power Company Limited,5,677,654,677,6038,4009252,654,23,2017-06-06
Butwal Power Company Limited,43,709,675,675,9682,6665421,677,-2,2017-06-07
Butwal Power Company Limited,6,686,680,685,340,232510,675,10,2017-06-08
Butwal Power Company Limited,20,672,659,666,10127,6700163,685,-19,2017-06-11
Butwal Power Company Limited,3,660,660,660,3000,1980000,666,-6,2017-06-12
Butwal Power Company Limited,13,665,654,654,3048,2007324,660,-6,2017-06-13
Butwal Power Company Limited,14,655,650,651,5535,3605345,654,-3,2017-06-14
Butwal Power Company Limited,13,670,655,670,2156,1419524,651,19,2017-06-15
Butwal Power Company Limited,5,657,650,650,300,195500,670,-20,2017-06-18
Butwal Power Company Limited,3,652,640,652,521,338922,650,2,2017-06-21
Butwal Power Company Limited,6,650,641,641,831,534371,652,-11,2017-06-22
Butwal Power Company Limited,2,645,640,640,124,79465,641,-1,2017-06-25
Butwal Power Company Limited,5,633,630,630,2350,1483150,640,-10,2017-06-27
Butwal Power Company Limited,7,642,635,640,2750,1758200,630,10,2017-06-28
Butwal Power Company Limited,14,628,616,621,2495,1549144,640,-19,2017-07-02
Butwal Power Company Limited,10,625,615,615,3090,1908770,621,-6,2017-07-03
Butwal Power Company Limited,5,615,611,611,1550,949870,615,-4,2017-07-04
Butwal Power Company Limited,2,615,615,615,495,304425,611,4,2017-07-05
Butwal Power Company Limited,19,632,620,630,1590,989862,615,15,2017-07-06
Butwal Power Company Limited,10,642,625,625,1500,949600,630,-5,2017-07-09
Butwal Power Company Limited,3,625,613,625,484,297292,625,0,2017-07-10
Butwal Power Company Limited,3,629,616,629,911,572226,625,4,2017-07-11
Butwal Power Company Limited,8,653,626,626,619,393031,629,-3,2017-07-12
Butwal Power Company Limited,5,626,620,620,2705,1691446,626,-6,2017-07-13
Butwal Power Company Limited,1,620,620,620,431,267220,620,0,2017-07-16
Butwal Power Company Limited,3,632,620,632,108,67482,620,12,2017-07-17
Butwal Power Company Limited,4,636,626,626,1377,871364,632,-6,2017-07-18
Butwal Power Company Limited,24,673,655,666,6293,4177326,668,-2,2017-08-03
Butwal Power Company Limited,8,640,625,640,1873,1183075,626,14,2017-07-19
Butwal Power Company Limited,7,635,630,630,1760,1116520,640,-10,2017-07-20
Butwal Power Company Limited,10,630,606,630,2457,1513402,630,0,2017-07-23
Butwal Power Company Limited,3,635,630,635,240,151400,630,5,2017-07-24
Butwal Power Company Limited,14,640,626,635,2851,1798005,635,0,2017-07-25
Butwal Power Company Limited,13,650,635,635,2582,1645715,635,0,2017-07-26
Butwal Power Company Limited,3,634,628,634,272,171248,635,-1,2017-07-27
Butwal Power Company Limited,5,655,646,650,1142,740839,634,16,2017-07-30
Butwal Power Company Limited,25,655,640,650,8725,5663830,650,0,2017-07-31
Butwal Power Company Limited,22,655,645,655,6799,4424005,650,5,2017-08-01
Butwal Power Company Limited,33,673,656,668,13643,9018897,655,13,2017-08-02
Butwal Power Company Limited,16,669,652,652,3607,2386196,666,-14,2017-08-06
Butwal Power Company Limited,8,654,648,654,12550,8156980,652,2,2017-08-07
Butwal Power Company Limited,19,660,645,650,8349,5398050,654,-4,2017-08-09
Butwal Power Company Limited,20,653,641,653,3605,2325945,650,3,2017-08-10
Butwal Power Company Limited,8,660,645,645,849,554600,653,-8,2017-08-13
Butwal Power Company Limited,9,645,640,642,1984,1275177,645,-3,2017-08-15
Butwal Power Company Limited,6,646,637,640,1002,640959,642,-2,2017-08-16
Butwal Power Company Limited,2,640,636,636,79,50284,640,-4,2017-08-17
Butwal Power Company Limited,14,640,632,632,2141,1360705,636,-4,2017-08-20
Butwal Power Company Limited,4,635,623,623,1200,757800,632,-9,2017-08-21
Butwal Power Company Limited,10,636,630,635,3255,2063511,623,12,2017-08-22
Butwal Power Company Limited,5,635,626,626,472,296258,635,-9,2017-08-23
Butwal Power Company Limited,8,638,630,636,973,618156,626,10,2017-08-24
Butwal Power Company Limited,1,635,635,635,500,317500,636,-1,2017-08-27
Butwal Power Company Limited,6,635,611,617,1216,759360,635,-18,2017-08-28
Butwal Power Company Limited,11,649,622,640,2153,1348885,617,23,2017-08-30
Butwal Power Company Limited,14,640,627,640,2108,1333836,640,0,2017-08-31
Butwal Power Company Limited,11,630,624,625,1871,1171750,640,-15,2017-09-04
Butwal Power Company Limited,6,630,625,630,657,411100,625,5,2017-09-06
Butwal Power Company Limited,4,640,632,634,533,340204,630,4,2017-09-07
Butwal Power Company Limited,11,625,611,616,1509,933759,634,-18,2017-09-10
Butwal Power Company Limited,10,620,616,616,1796,1109536,616,0,2017-09-11
Butwal Power Company Limited,4,616,607,607,3660,2254146,616,-9,2017-09-12
Butwal Power Company Limited,6,618,605,618,3477,2127629,607,11,2017-09-13
Butwal Power Company Limited,14,632,614,619,3145,1939565,618,1,2017-09-14
Butwal Power Company Limited,8,637,625,625,788,496861,619,6,2017-09-17
Butwal Power Company Limited,5,623,619,619,1042,646154,625,-6,2017-09-18
Butwal Power Company Limited,14,620,616,620,1155,715632,619,1,2017-09-20
Butwal Power Company Limited,17,629,608,628,4418,2708216,615,13,2017-10-09
Butwal Power Company Limited,3,612,610,612,371,226402,620,-8,2017-09-24
Butwal Power Company Limited,1,624,624,624,50,31200,612,12,2017-09-25
Butwal Power Company Limited,3,624,620,620,595,370100,624,-4,2017-09-26
Butwal Power Company Limited,2,635,632,635,110,69820,620,15,2017-10-03
Butwal Power Company Limited,9,646,637,640,2470,1584520,635,5,2017-10-04
Butwal Power Company Limited,7,628,611,615,660,406660,640,-25,2017-10-08
Butwal Power Company Limited,7,616,609,611,907,553987,628,-17,2017-10-10
Butwal Power Company Limited,7,615,610,610,1715,1048410,611,-1,2017-10-11
Butwal Power Company Limited,3,615,600,615,1425,856035,610,5,2017-10-15
Butwal Power Company Limited,22,646,617,646,40696,25248210,615,31,2017-10-16
Butwal Power Company Limited,30,657,617,642,38258,23801263,646,-4,2017-10-17
Butwal Power Company Limited,4,642,635,642,800,510100,642,0,2017-10-18
Butwal Power Company Limited,13,645,620,644,38450,23902980,642,2,2017-10-22
Butwal Power Company Limited,36,650,636,645,22420,14386060,644,1,2017-10-23
Butwal Power Company Limited,47,645,618,640,42624,26543758,645,-5,2017-10-24
Butwal Power Company Limited,10,640,628,633,3330,2097930,640,-7,2017-10-25
Butwal Power Company Limited,27,629,620,621,28965,18040130,633,-12,2017-10-29
Butwal Power Company Limited,27,630,612,628,30750,18913442,621,7,2017-10-30
Butwal Power Company Limited,10,625,615,615,2120,1307200,628,-13,2017-10-31
Butwal Power Company Limited,21,628,612,613,10266,6295824,615,-2,2017-11-01
Butwal Power Company Limited,6,625,613,617,841,518055,613,4,2017-11-02
Butwal Power Company Limited,5,608,605,605,743,450515,617,-12,2017-11-05
Butwal Power Company Limited,16,618,594,605,2890,1752466,605,0,2017-11-06
Butwal Power Company Limited,26,617,605,605,4677,2842484,605,0,2017-11-07
Butwal Power Company Limited,11,617,594,605,902,544099,605,0,2017-11-08
Butwal Power Company Limited,7,616,605,610,1680,1021150,605,5,2017-11-09
Butwal Power Company Limited,4,625,610,625,210,128880,610,15,2017-11-12
Butwal Power Company Limited,48,625,613,620,21126,13048285,625,-5,2017-11-13
Butwal Power Company Limited,47,640,612,633,23834,14820164,620,13,2017-11-14
Butwal Power Company Limited,12,635,628,630,2258,1426384,633,-3,2017-11-15
Butwal Power Company Limited,3,619,617,619,5600,3455900,630,-11,2017-11-16
Butwal Power Company Limited,15,631,609,615,2809,1716954,619,-4,2017-11-19
Butwal Power Company Limited,5,615,610,615,650,397965,615,0,2017-11-20
Butwal Power Company Limited,6,627,615,615,434,267898,615,0,2017-11-21
Butwal Power Company Limited,33,639,615,628,20382,12617853,615,13,2017-11-22
Butwal Power Company Limited,171,658,630,650,44041,28121674,628,22,2017-11-23
Butwal Power Company Limited,139,685,660,679,32945,22249816,650,29,2017-11-26
Butwal Power Company Limited,169,692,665,681,54675,37148357,679,2,2017-11-27
Butwal Power Company Limited,190,717,670,704,57222,39423604,681,23,2017-11-28
Butwal Power Company Limited,366,732,706,718,97076,69955327,704,14,2017-11-29
Butwal Power Company Limited,209,741,702,729,64779,46556910,718,11,2017-11-30
Butwal Power Company Limited,118,735,718,725,41690,30316052,729,-4,2017-12-04
Butwal Power Company Limited,40,724,701,706,8920,6340906,719,-13,2017-12-20
Butwal Power Company Limited,326,783,732,740,134904,100113840,725,15,2017-12-05
Butwal Power Company Limited,109,750,735,739,28405,21023242,740,-1,2017-12-06
Butwal Power Company Limited,229,770,740,746,71405,53650725,739,7,2017-12-10
Butwal Power Company Limited,67,748,733,745,23786,17630631,746,-1,2017-12-11
Butwal Power Company Limited,120,740,730,735,33355,24545937,745,-10,2017-12-12
Butwal Power Company Limited,66,745,731,742,15965,11801107,735,7,2017-12-13
Butwal Power Company Limited,70,754,723,735,24412,18028516,742,-7,2017-12-14
Butwal Power Company Limited,81,735,721,721,17568,12750878,735,-14,2017-12-17
Butwal Power Company Limited,63,729,717,725,19022,13734980,721,4,2017-12-18
Butwal Power Company Limited,63,721,715,719,11670,8381947,725,-6,2017-12-19
Butwal Power Company Limited,48,720,696,702,7862,5520074,706,-4,2017-12-21
Butwal Power Company Limited,46,714,698,700,9293,6546790,702,-2,2017-12-24
Butwal Power Company Limited,68,703,682,685,17642,12120161,700,-15,2017-12-26
Butwal Power Company Limited,85,698,670,672,18606,12680874,685,-13,2017-12-27
Butwal Power Company Limited,54,685,665,671,13493,9066020,672,-1,2017-12-28
Butwal Power Company Limited,30,684,664,675,12808,8629920,671,4,2017-12-31
Butwal Power Company Limited,61,693,675,691,16391,11208620,675,16,2018-01-01
Butwal Power Company Limited,32,694,685,685,8147,5615493,691,-6,2018-01-02
Butwal Power Company Limited,15,687,676,677,4950,3372400,685,-8,2018-01-03
Butwal Power Company Limited,2,690,680,680,70,48100,677,3,2018-01-04
Butwal Power Company Limited,15,692,680,680,3574,2450564,680,0,2018-01-07
Butwal Power Company Limited,44,690,668,668,14682,9910970,680,-12,2018-01-08
Butwal Power Company Limited,64,690,667,670,24774,16627872,668,2,2018-01-09
Butwal Power Company Limited,21,680,667,677,5221,3497149,670,7,2018-01-10
Butwal Power Company Limited,22,711,660,711,15698,10581281,677,34,2018-01-14
Butwal Power Company Limited,43,697,659,660,5962,3951840,711,-51,2018-01-16
Butwal Power Company Limited,36,665,648,665,13149,8609245,660,5,2018-01-17
Butwal Power Company Limited,34,672,651,651,10515,6919010,665,-14,2018-01-21
Butwal Power Company Limited,21,664,644,654,5600,3634430,651,3,2018-01-22
Butwal Power Company Limited,51,646,630,640,30490,19295865,654,-14,2018-01-23
Butwal Power Company Limited,51,640,630,635,18709,11817545,640,-5,2018-01-24
Butwal Power Company Limited,24,636,629,636,5719,3615132,635,1,2018-01-25
Butwal Power Company Limited,21,648,628,628,4091,2596888,636,-8,2018-01-28
Butwal Power Company Limited,25,635,626,633,6939,4369744,628,5,2018-01-29
Butwal Power Company Limited,133,625,604,617,39540,24213279,633,-16,2018-01-31
Butwal Power Company Limited,84,632,604,611,24376,14803080,617,-6,2018-02-01
Butwal Power Company Limited,133,616,575,580,28989,17011742,611,-31,2018-02-04
Butwal Power Company Limited,81,591,553,558,18707,10465187,580,-22,2018-02-05
Butwal Power Company Limited,36,567,548,557,11101,6114373,558,-1,2018-02-06
Butwal Power Company Limited,12,565,544,558,2625,1437940,557,1,2018-02-07
Butwal Power Company Limited,17,552,540,549,2843,1546241,558,-9,2018-02-08
Butwal Power Company Limited,11,555,532,542,1040,559660,545,-3,2018-02-25
Butwal Power Company Limited,25,566,551,551,4680,2589770,549,2,2018-02-11
Butwal Power Company Limited,18,563,550,563,3108,1727870,551,12,2018-02-12
Butwal Power Company Limited,22,570,550,559,3377,1876699,563,-4,2018-02-14
Butwal Power Company Limited,41,569,556,568,7473,4193286,559,9,2018-02-15
Butwal Power Company Limited,7,575,557,557,1970,1100710,568,-11,2018-02-18
Butwal Power Company Limited,26,551,539,540,4906,2668465,557,-17,2018-02-20
Butwal Power Company Limited,26,559,535,545,3770,2024700,540,5,2018-02-21
Butwal Power Company Limited,20,550,535,545,2575,1381195,545,0,2018-02-22
Butwal Power Company Limited,23,552,524,534,5160,2725890,542,-8,2018-02-26
Butwal Power Company Limited,46,540,517,530,13789,7319395,534,-4,2018-02-27
Butwal Power Company Limited,15,540,512,518,3820,2002900,530,-12,2018-02-28
Butwal Power Company Limited,9,528,498,507,1674,842522,518,-11,2018-03-04
Butwal Power Company Limited,41,517,491,497,8835,4396867,507,-10,2018-03-05
Butwal Power Company Limited,22,506,486,494,4489,2196760,497,-3,2018-03-06
Butwal Power Company Limited,29,513,493,500,5610,2798823,494,6,2018-03-07
Butwal Power Company Limited,23,501,485,485,3050,1490920,500,-15,2018-03-11
Butwal Power Company Limited,31,494,481,481,4562,2210310,485,-4,2018-03-12
Butwal Power Company Limited,12,490,476,490,400,192070,481,9,2018-03-13
Butwal Power Company Limited,23,508,487,489,1540,754780,490,-1,2018-03-14
Butwal Power Company Limited,3,498,489,490,180,88210,489,1,2018-03-15
Butwal Power Company Limited,19,490,483,483,7580,3666175,490,-7,2018-03-18
Butwal Power Company Limited,19,488,480,483,2706,1301658,483,0,2018-03-19
Butwal Power Company Limited,28,490,471,484,8048,3852721,483,1,2018-03-20
Butwal Power Company Limited,20,491,470,482,2271,1079730,484,-2,2018-03-21
Butwal Power Company Limited,42,497,464,464,9957,4674053,482,-18,2018-03-22
Butwal Power Company Limited,62,464,420,436,8421,3660002,464,-28,2018-03-26
Butwal Power Company Limited,43,468,421,468,5142,2226689,436,32,2018-03-27
Butwal Power Company Limited,43,477,442,457,5670,2603690,468,-11,2018-03-28
Butwal Power Company Limited,32,475,452,470,6908,3197386,457,13,2018-03-29
Butwal Power Company Limited,27,467,445,459,8314,3746504,470,-11,2018-04-01
Butwal Power Company Limited,36,462,450,451,11334,5143671,459,-8,2018-04-02
Butwal Power Company Limited,15,469,451,469,3028,1385313,451,18,2018-04-03
Butwal Power Company Limited,25,483,469,471,2382,1133229,469,2,2018-04-04
Butwal Power Company Limited,74,500,480,488,21594,10641602,471,17,2018-04-05
Butwal Power Company Limited,58,515,482,500,12817,6400756,488,12,2018-04-08
Butwal Power Company Limited,177,510,462,470,51497,24946864,500,-30,2018-04-09
Butwal Power Company Limited,102,475,445,461,29800,13757222,470,-9,2018-04-10
Butwal Power Company Limited,40,465,453,462,10222,4666006,461,1,2018-04-11
Butwal Power Company Limited,44,463,455,456,8222,3773195,462,-6,2018-04-12
Butwal Power Company Limited,38,465,447,455,4418,2020218,456,-1,2018-04-15
Butwal Power Company Limited,44,473,455,460,8321,3848383,455,5,2018-04-16
Butwal Power Company Limited,37,483,463,469,10023,4716349,460,9,2018-04-17
Butwal Power Company Limited,77,502,460,476,15163,7240582,469,7,2018-04-18
Butwal Power Company Limited,50,490,473,485,8075,3906900,476,9,2018-04-19
Butwal Power Company Limited,99,515,485,515,25320,12638324,485,30,2018-04-22
Butwal Power Company Limited,87,524,488,495,19712,9806566,515,-20,2018-04-23
Butwal Power Company Limited,37,498,486,487,7482,3660747,495,-8,2018-04-24
Butwal Power Company Limited,23,490,485,485,3009,1465145,487,-2,2018-04-25
Butwal Power Company Limited,51,492,467,480,7128,3408699,485,-5,2018-04-26
Butwal Power Company Limited,22,491,471,491,3581,1728483,480,11,2018-04-29
Butwal Power Company Limited,67,510,480,510,11939,5967366,491,19,2018-05-02
Butwal Power Company Limited,73,520,501,504,21390,10845605,510,-6,2018-05-03
Butwal Power Company Limited,929,500,487,492,38378,18940317,504,-12,2018-05-06
Butwal Power Company Limited,1109,510,490,504,129999,65591052,492,12,2018-05-07
Butwal Power Company Limited,849,507,500,504,26013,13080777,504,0,2018-05-08
Butwal Power Company Limited,703,504,501,502,32277,16227238,504,-2,2018-05-09
Butwal Power Company Limited,345,500,484,485,27610,13504614,502,-17,2018-05-10
Butwal Power Company Limited,291,490,479,481,24752,11889932,485,-4,2018-05-14
Butwal Power Company Limited,49,488,478,479,7094,3395912,481,-2,2018-05-15
Butwal Power Company Limited,35,483,471,483,3820,1836750,479,4,2018-05-16
Butwal Power Company Limited,56,486,479,479,5276,2539516,483,-4,2018-05-17
Butwal Power Company Limited,59,484,474,474,5333,2551349,479,-5,2018-05-20
Butwal Power Company Limited,39,480,471,479,3500,1674390,474,5,2018-05-21
Butwal Power Company Limited,86,481,472,480,12205,5843465,479,1,2018-05-22
Central Finance Co. Ltd.,1,0,0,0,795,123232.95,214,-214,2017-03-09
Central Finance Co. Ltd.,6,192,178,192,69,12848,175,17,2017-06-15
Central Finance Co. Ltd.,69,211,188,190,14108,2853134,192,-2,2017-06-18
Central Finance Co. Ltd.,2,187,184,184,200,37100,190,-6,2017-06-19
Central Finance Co. Ltd.,26,185,176,176,3720,675069,184,-8,2017-06-20
Central Finance Co. Ltd.,33,177,165,167,5424,916558,176,-9,2017-06-21
Central Finance Co. Ltd.,28,176,164,170,7152,1210234,167,3,2017-06-22
Central Finance Co. Ltd.,28,176,168,175,5961,1030154,170,5,2017-06-25
Central Finance Co. Ltd.,2,175,175,175,276,48300,175,0,2017-06-27
Central Finance Co. Ltd.,8,172,169,169,2734,465367,175,-6,2017-06-28
Central Finance Co. Ltd.,6,169,166,166,759,126057,169,-3,2017-07-02
Central Finance Co. Ltd.,5,169,165,169,2917,485205,166,3,2017-07-03
Central Finance Co. Ltd.,5,172,169,169,3000,511500,169,0,2017-07-04
Central Finance Co. Ltd.,12,172,168,172,1954,331122,169,3,2017-07-05
Central Finance Co. Ltd.,21,175,166,172,9377,1594249,172,0,2017-07-06
Central Finance Co. Ltd.,39,189,175,189,14012,2597206,172,17,2017-07-09
Central Finance Co. Ltd.,100,207,192,197,24000,4781500,189,8,2017-07-10
Central Finance Co. Ltd.,14,197,190,190,2997,579320,197,-7,2017-07-11
Central Finance Co. Ltd.,20,193,188,190,3331,632416,190,0,2017-07-12
Central Finance Co. Ltd.,28,191,187,191,8887,1680505,190,1,2017-07-13
Central Finance Co. Ltd.,34,197,187,190,6833,1310178,191,-1,2017-07-16
Central Finance Co. Ltd.,15,195,189,191,6537,1256183,190,1,2017-07-17
Central Finance Co. Ltd.,38,200,194,200,5540,1087350,191,9,2017-07-18
Central Finance Co. Ltd.,29,213,205,213,9678,2037152,205,8,2017-08-03
Central Finance Co. Ltd.,12,199,196,196,830,164013,200,-4,2017-07-19
Central Finance Co. Ltd.,13,197,193,197,2053,400813,196,1,2017-07-20
Central Finance Co. Ltd.,4,200,196,196,323,63348,197,-1,2017-07-23
Central Finance Co. Ltd.,13,196,193,193,3018,585372,196,-3,2017-07-24
Central Finance Co. Ltd.,25,201,195,197,6272,1249860,193,4,2017-07-25
Central Finance Co. Ltd.,16,200,195,198,3969,784931,197,1,2017-07-26
Central Finance Co. Ltd.,6,201,195,200,1196,239090,198,2,2017-07-27
Central Finance Co. Ltd.,24,199,191,194,10962,2136438,200,-6,2017-07-30
Central Finance Co. Ltd.,37,205,195,205,10956,2201454,194,11,2017-07-31
Central Finance Co. Ltd.,53,213,206,213,20597,4328376,205,8,2017-08-01
Central Finance Co. Ltd.,23,216,205,205,7368,1518630,213,-8,2017-08-02
Central Finance Co. Ltd.,4,209,205,205,69,14321,213,-8,2017-08-06
Central Finance Co. Ltd.,13,205,201,201,1607,323807,205,-4,2017-08-07
Central Finance Co. Ltd.,8,205,201,204,2381,486132,201,3,2017-08-09
Central Finance Co. Ltd.,7,205,200,203,432,87535,204,-1,2017-08-10
Central Finance Co. Ltd.,2,200,200,200,166,33200,203,-3,2017-08-13
Central Finance Co. Ltd.,8,204,197,201,1342,269115,200,1,2017-08-15
Central Finance Co. Ltd.,9,209,200,200,1952,395642,201,-1,2017-08-16
Central Finance Co. Ltd.,2,196,196,196,47,9212,200,-4,2017-08-17
Central Finance Co. Ltd.,13,199,195,195,3528,696404,196,-1,2017-08-20
Central Finance Co. Ltd.,11,196,192,192,6010,1167136,195,-3,2017-08-21
Central Finance Co. Ltd.,8,198,192,198,1792,348825,192,6,2017-08-22
Central Finance Co. Ltd.,14,201,194,201,1508,297235,198,3,2017-08-23
Central Finance Co. Ltd.,7,200,196,196,429,85341,201,-5,2017-08-24
Central Finance Co. Ltd.,2,195,194,195,211,40948,196,-1,2017-08-27
Central Finance Co. Ltd.,19,198,192,192,2045,398316,195,-3,2017-08-28
Central Finance Co. Ltd.,21,192,187,189,2181,413301,192,-3,2017-08-30
Central Finance Co. Ltd.,29,190,178,178,6531,1191652,189,-11,2017-08-31
Central Finance Co. Ltd.,16,182,175,178,1997,357750,178,0,2017-09-04
Central Finance Co. Ltd.,18,184,181,184,1207,221415,178,6,2017-09-06
Central Finance Co. Ltd.,14,189,184,188,2335,438036,184,4,2017-09-07
Central Finance Co. Ltd.,4,188,182,182,232,42911,188,-6,2017-09-10
Central Finance Co. Ltd.,3,185,183,183,530,97050,182,1,2017-09-11
Central Finance Co. Ltd.,7,182,180,180,1787,322664,183,-3,2017-09-12
Central Finance Co. Ltd.,9,180,175,175,884,155755,180,-5,2017-09-13
Central Finance Co. Ltd.,7,187,178,187,897,165139,175,12,2017-09-14
Central Finance Co. Ltd.,8,190,185,188,6098,1135495,187,1,2017-09-17
Central Finance Co. Ltd.,8,190,183,187,521,97758,188,-1,2017-09-18
Central Finance Co. Ltd.,3,190,184,184,237,43896,187,-3,2017-09-20
Central Finance Co. Ltd.,5,185,182,182,865,158213,188,-6,2017-10-09
Central Finance Co. Ltd.,5,184,181,181,364,66430,184,-3,2017-09-24
Central Finance Co. Ltd.,5,190,184,190,150,28310,181,9,2017-09-25
Central Finance Co. Ltd.,6,190,187,187,1750,330300,190,-3,2017-09-26
Central Finance Co. Ltd.,3,188,186,188,304,56852,187,1,2017-10-08
Central Finance Co. Ltd.,16,183,176,180,5590,999363,182,-2,2017-10-10
Central Finance Co. Ltd.,11,180,177,179,3299,593303,180,-1,2017-10-11
Central Finance Co. Ltd.,14,185,179,181,2498,451582,179,2,2017-10-12
Central Finance Co. Ltd.,4,181,178,181,1155,207405,181,0,2017-10-15
Central Finance Co. Ltd.,4,190,184,190,815,154415,181,9,2017-10-16
Central Finance Co. Ltd.,13,193,186,186,1840,348860,190,-4,2017-10-17
Central Finance Co. Ltd.,10,191,183,191,1982,369132,186,5,2017-10-18
Central Finance Co. Ltd.,15,195,190,192,4663,895461,191,1,2017-10-22
Central Finance Co. Ltd.,15,198,193,198,3652,710499,192,6,2017-10-23
Central Finance Co. Ltd.,6,195,194,195,1413,275336,198,-3,2017-10-24
Central Finance Co. Ltd.,4,197,195,197,342,67290,195,2,2017-10-25
Central Finance Co. Ltd.,8,197,192,192,3232,625319,197,-5,2017-10-29
Central Finance Co. Ltd.,1,189,189,189,75,14175,192,-3,2017-10-30
Central Finance Co. Ltd.,7,191,188,188,3122,588294,189,-1,2017-10-31
Central Finance Co. Ltd.,14,189,186,187,5962,1116351,188,-1,2017-11-01
Central Finance Co. Ltd.,17,190,188,189,4713,891743,187,2,2017-11-02
Central Finance Co. Ltd.,27,188,184,188,4116,764625,189,-1,2017-11-05
Central Finance Co. Ltd.,3,190,188,190,816,153808,188,2,2017-11-06
Central Finance Co. Ltd.,12,193,188,191,3287,628425,190,1,2017-11-07
Central Finance Co. Ltd.,7,191,186,191,1604,303674,191,0,2017-11-08
Central Finance Co. Ltd.,19,192,186,192,9261,1750382,191,1,2017-11-09
Central Finance Co. Ltd.,15,196,193,195,2466,479948,192,3,2017-11-12
Central Finance Co. Ltd.,23,196,192,192,8740,1693640,195,-3,2017-11-13
Central Finance Co. Ltd.,13,197,193,193,4273,831011,192,1,2017-11-14
Central Finance Co. Ltd.,11,194,190,192,7872,1515771,193,-1,2017-11-15
Central Finance Co. Ltd.,3,193,190,192,515,98680,192,0,2017-11-16
Central Finance Co. Ltd.,12,190,186,189,6191,1163236,192,-3,2017-11-19
Central Finance Co. Ltd.,4,186,186,186,1384,257424,189,-3,2017-11-21
Central Finance Co. Ltd.,2,188,188,188,519,97572,186,2,2017-11-22
Central Finance Co. Ltd.,7,185,182,184,575,105696,188,-4,2017-11-23
Central Finance Co. Ltd.,4,187,181,187,444,80991,184,3,2017-11-26
Central Finance Co. Ltd.,8,190,186,187,2899,543880,187,0,2017-11-27
Central Finance Co. Ltd.,5,186,184,185,1381,254985,187,-2,2017-11-28
Central Finance Co. Ltd.,11,194,185,194,3434,657613,185,9,2017-11-29
Central Finance Co. Ltd.,4,191,188,188,194,36682,194,-6,2017-11-30
Central Finance Co. Ltd.,12,186,184,184,1268,234912,188,-4,2017-12-04
Central Finance Co. Ltd.,5,147,144,147,936,136720,145,2,2017-12-20
Central Finance Co. Ltd.,6,185,182,184,1051,193786,184,0,2017-12-05
Central Finance Co. Ltd.,31,191,183,191,3616,684428,184,7,2017-12-06
Central Finance Co. Ltd.,17,188,182,182,4531,831492,191,-9,2017-12-10
Central Finance Co. Ltd.,31,189,184,184,14703,2720770,182,2,2017-12-11
Central Finance Co. Ltd.,23,187,182,185,3129,577362,184,1,2017-12-12
Central Finance Co. Ltd.,16,187,183,184,1410,261273,185,-1,2017-12-13
Central Finance Co. Ltd.,18,187,184,184,3261,606444,184,0,2017-12-14
Central Finance Co. Ltd.,35,185,174,179,10806,1925093,184,-5,2017-12-17
Central Finance Co. Ltd.,49,185,170,172,9209,1598600,179,-7,2017-12-18
Central Finance Co. Ltd.,14,153,145,145,1675,245571,148,-3,2017-12-19
Central Finance Co. Ltd.,2,147,145,145,200,29200,147,-2,2017-12-21
Central Finance Co. Ltd.,3,145,143,145,530,76790,145,0,2017-12-24
Central Finance Co. Ltd.,2,147,145,145,600,88000,145,0,2017-12-26
Central Finance Co. Ltd.,7,144,138,138,1013,144479,145,-7,2017-12-28
Central Finance Co. Ltd.,3,136,136,136,609,82824,138,-2,2017-12-31
Central Finance Co. Ltd.,11,144,136,144,3494,489078,136,8,2018-01-01
Central Finance Co. Ltd.,11,144,140,142,1380,197160,144,-2,2018-01-02
Central Finance Co. Ltd.,1,140,140,140,50,7000,142,-2,2018-01-03
Central Finance Co. Ltd.,10,138,136,138,903,123776,140,-2,2018-01-04
Central Finance Co. Ltd.,3,138,136,136,800,109000,138,-2,2018-01-07
Central Finance Co. Ltd.,3,142,138,142,457,63566,136,6,2018-01-08
Central Finance Co. Ltd.,6,142,140,142,711,100562,142,0,2018-01-09
Central Finance Co. Ltd.,8,146,143,143,1617,233443,142,1,2018-01-10
Central Finance Co. Ltd.,9,141,134,134,3000,414000,143,-9,2018-01-14
Central Finance Co. Ltd.,5,134,132,134,2904,386608,134,0,2018-01-16
Central Finance Co. Ltd.,1,136,136,136,259,35224,134,2,2018-01-17
Central Finance Co. Ltd.,7,140,137,137,1777,244063,136,1,2018-01-21
Central Finance Co. Ltd.,13,136,133,134,2195,293844,137,-3,2018-01-22
Central Finance Co. Ltd.,2,136,134,136,80,10820,134,2,2018-01-23
Central Finance Co. Ltd.,1,136,136,136,194,26384,136,0,2018-01-24
Central Finance Co. Ltd.,11,138,135,136,4981,685673,136,0,2018-01-25
Central Finance Co. Ltd.,16,138,135,137,3141,429441,136,1,2018-01-28
Central Finance Co. Ltd.,4,137,137,137,1616,221392,137,0,2018-01-29
Central Finance Co. Ltd.,9,138,136,138,693,94633,137,1,2018-01-31
Central Finance Co. Ltd.,4,138,136,136,1117,152522,138,-2,2018-02-01
Central Finance Co. Ltd.,18,136,132,133,2704,362336,136,-3,2018-02-04
Central Finance Co. Ltd.,5,135,133,133,4305,580815,133,0,2018-02-05
Central Finance Co. Ltd.,4,137,135,137,325,43975,133,4,2018-02-06
Central Finance Co. Ltd.,2,135,135,135,199,26865,137,-2,2018-02-07
Central Finance Co. Ltd.,3,136,135,135,145,19610,135,0,2018-02-08
Central Finance Co. Ltd.,1,135,135,135,1455,196425,135,0,2018-02-11
Central Finance Co. Ltd.,1,137,137,137,10,1370,135,2,2018-02-12
Central Finance Co. Ltd.,3,135,135,135,6953,938655,137,-2,2018-02-14
Central Finance Co. Ltd.,10,143,135,143,1498,207318,135,8,2018-02-15
Central Finance Co. Ltd.,6,143,141,141,1265,179395,143,-2,2018-02-18
Central Finance Co. Ltd.,3,139,139,139,330,45870,141,-2,2018-02-20
Central Finance Co. Ltd.,3,137,135,135,590,80650,139,-4,2018-02-27
Central Finance Co. Ltd.,3,133,131,131,1096,145576,135,-4,2018-02-28
Central Finance Co. Ltd.,1,129,129,129,26,3354,131,-2,2018-03-05
Central Finance Co. Ltd.,1,128,128,128,50,6400,129,-1,2018-03-06
Central Finance Co. Ltd.,15,130,124,128,6696,846300,128,0,2018-03-07
Central Finance Co. Ltd.,1,126,126,126,200,25200,128,-2,2018-03-11
Central Finance Co. Ltd.,5,125,123,123,1048,130924,126,-3,2018-03-12
Central Finance Co. Ltd.,5,123,123,123,1030,126690,123,0,2018-03-13
Central Finance Co. Ltd.,3,125,123,123,328,40400,123,0,2018-03-14
Central Finance Co. Ltd.,3,123,123,123,550,67650,123,0,2018-03-18
Central Finance Co. Ltd.,2,122,121,121,1000,121500,123,-2,2018-03-19
Central Finance Co. Ltd.,34,127,120,122,12161,1482381,121,1,2018-03-20
Central Finance Co. Ltd.,10,123,121,121,3098,375078,122,-1,2018-03-21
Central Finance Co. Ltd.,10,122,119,119,1991,238520,121,-2,2018-03-22
Central Finance Co. Ltd.,6,117,114,114,580,66545,119,-5,2018-03-26
Central Finance Co. Ltd.,14,118,114,116,6530,754750,114,2,2018-03-27
Central Finance Co. Ltd.,3,117,115,117,2100,245500,116,1,2018-03-28
Central Finance Co. Ltd.,5,119,117,119,2250,267450,117,2,2018-03-29
Central Finance Co. Ltd.,5,119,119,119,1282,152558,119,0,2018-04-01
Central Finance Co. Ltd.,2,118,117,117,202,23734,119,-2,2018-04-02
Central Finance Co. Ltd.,4,119,117,119,1864,220988,117,2,2018-04-04
Central Finance Co. Ltd.,11,121,119,121,1580,189780,119,2,2018-04-05
Central Finance Co. Ltd.,5,125,123,123,2055,253765,121,2,2018-04-08
Central Finance Co. Ltd.,9,125,122,125,1528,188832,123,2,2018-04-09
Central Finance Co. Ltd.,7,123,122,123,1372,168644,125,-2,2018-04-10
Central Finance Co. Ltd.,5,125,122,122,208,25426,123,-1,2018-04-11
Central Finance Co. Ltd.,5,120,118,118,2060,245200,122,-4,2018-04-12
Central Finance Co. Ltd.,4,120,117,120,1600,190700,118,2,2018-04-15
Central Finance Co. Ltd.,2,122,121,121,300,36500,120,1,2018-04-16
Central Finance Co. Ltd.,17,125,121,122,8372,1029842,121,1,2018-04-17
Central Finance Co. Ltd.,3,128,124,128,349,44274,122,6,2018-04-18
Central Finance Co. Ltd.,22,130,122,122,4887,605968,128,-6,2018-04-19
Central Finance Co. Ltd.,18,134,124,134,9140,1195538,122,12,2018-04-22
Central Finance Co. Ltd.,13,134,128,128,2514,332548,134,-6,2018-04-23
Central Finance Co. Ltd.,12,128,125,125,2371,298497,128,-3,2018-04-24
Central Finance Co. Ltd.,10,125,121,121,3030,369590,125,-4,2018-04-25
Central Finance Co. Ltd.,8,125,120,120,1610,194850,121,-1,2018-04-26
Central Finance Co. Ltd.,1,118,118,118,200,23600,120,-2,2018-04-29
Central Finance Co. Ltd.,8,124,118,124,1542,185534,118,6,2018-05-02
Central Finance Co. Ltd.,7,126,122,124,1060,131360,124,0,2018-05-03
Central Finance Co. Ltd.,14,130,120,130,2717,342620,124,6,2018-05-06
Central Finance Co. Ltd.,14,128,121,123,3015,366427,130,-7,2018-05-08
Central Finance Co. Ltd.,26,122,119,120,8191,985041,123,-3,2018-05-09
Central Finance Co. Ltd.,17,122,118,120,4440,528360,120,0,2018-05-10
Central Finance Co. Ltd.,7,121,119,119,1852,221337,120,-1,2018-05-14
Central Finance Co. Ltd.,1,117,117,117,75,8775,119,-2,2018-05-15
Central Finance Co. Ltd.,2,121,119,121,150,17950,117,4,2018-05-16
Central Finance Co. Ltd.,4,122,120,120,540,65300,121,-1,2018-05-17
Central Finance Co. Ltd.,4,128,122,128,60,7520,120,8,2018-05-20
Central Finance Co. Ltd.,5,126,120,120,265,32530,128,-8,2018-05-22
Central Finance Co. Ltd. Promoter Share,1,100,100,100,2670,267000,100,0,2018-01-04
Central Finance Co. Ltd. Promoter Share,1,100,100,100,4029,402900,100,0,2018-02-20
Century Commercial Bank Ltd.,162,429,423,427,33690,14335148,426,1,2016-05-23
Century Commercial Bank Ltd.,126,445,421,429,21594,9326688,427,2,2016-05-24
Century Commercial Bank Ltd.,147,430,413,415,35092,14696913,429,-14,2016-05-25
Century Commercial Bank Ltd.,128,422,402,417,33538,13900230,415,2,2016-05-26
Century Commercial Bank Ltd.,74,425,406,413,22133,9178601,417,-4,2016-05-29
Century Commercial Bank Ltd.,96,417,405,412,24030,9923511,413,-1,2016-05-30
Century Commercial Bank Ltd.,83,416,411,416,23075,9530962,412,4,2016-05-31
Century Commercial Bank Ltd.,68,415,407,412,19835,8149779,416,-4,2016-06-01
Century Commercial Bank Ltd.,79,413,402,411,13917,5675812,412,-1,2016-06-02
Century Commercial Bank Ltd.,122,414,395,398,30472,12253441,411,-13,2016-06-05
Century Commercial Bank Ltd.,69,410,405,406,15144,6176838,398,8,2016-06-06
Century Commercial Bank Ltd.,116,416,408,410,28123,11556178,406,4,2016-06-07
Century Commercial Bank Ltd.,120,425,418,423,20445,8638110,421,2,2016-06-23
Century Commercial Bank Ltd.,121,425,409,424,34139,14277588,410,14,2016-06-08
Century Commercial Bank Ltd.,87,425,409,412,24414,10140728,424,-12,2016-06-09
Century Commercial Bank Ltd.,157,434,411,428,44150,18801588,412,16,2016-06-12
Century Commercial Bank Ltd.,85,431,415,421,16573,6986748,428,-7,2016-06-13
Century Commercial Bank Ltd.,164,428,419,423,47129,20020434,421,2,2016-06-14
Century Commercial Bank Ltd.,94,427,419,420,18929,7994793,423,-3,2016-06-15
Century Commercial Bank Ltd.,96,425,415,416,20345,8515940,420,-4,2016-06-16
Century Commercial Bank Ltd.,89,424,409,417,15072,6325414,416,1,2016-06-19
Century Commercial Bank Ltd.,88,418,411,416,19274,8007881,417,-1,2016-06-20
Century Commercial Bank Ltd.,90,426,415,418,14250,5940619,416,2,2016-06-21
Century Commercial Bank Ltd.,151,437,410,421,33758,14306161,418,3,2016-06-22
Century Commercial Bank Ltd.,159,434,419,431,34296,14642179,423,8,2016-06-26
Century Commercial Bank Ltd.,311,474,430,474,82409,37447650,431,43,2016-06-27
Century Commercial Bank Ltd.,398,501,460,475,103214,50141820,474,1,2016-06-28
Century Commercial Bank Ltd.,167,502,470,482,42072,20196578,475,7,2016-06-29
Century Commercial Bank Ltd.,174,482,465,466,36151,17089345,482,-16,2016-06-30
Century Commercial Bank Ltd.,160,475,466,466,29871,14020569,466,0,2016-07-03
Century Commercial Bank Ltd.,85,477,463,471,18712,8807036,466,5,2016-07-04
Century Commercial Bank Ltd.,104,475,462,475,19211,8985180,471,4,2016-07-05
Century Commercial Bank Ltd.,98,475,466,470,21248,10016566,475,-5,2016-07-06
Century Commercial Bank Ltd.,119,480,468,479,27246,12926226,470,9,2016-07-10
Century Commercial Bank Ltd.,83,478,465,469,28573,13402052,479,-10,2016-07-11
Century Commercial Bank Ltd.,82,478,450,462,21615,9950505,469,-7,2016-07-12
Century Commercial Bank Ltd.,86,465,446,460,19389,8797116,462,-2,2016-07-13
Century Commercial Bank Ltd.,77,477,459,461,14668,6815762,460,1,2016-07-14
Century Commercial Bank Ltd.,141,497,461,484,46993,22737699,461,23,2016-07-17
Century Commercial Bank Ltd.,260,500,489,492,60030,29662540,484,8,2016-07-18
Century Commercial Bank Ltd.,298,510,495,505,80036,40132129,492,13,2016-07-19
Century Commercial Bank Ltd.,224,520,496,500,51252,26118426,505,-5,2016-07-20
Century Commercial Bank Ltd.,212,520,497,515,46111,23400670,500,15,2016-07-21
Century Commercial Bank Ltd.,488,566,515,562,111193,60980692,515,47,2016-07-25
Century Commercial Bank Ltd.,579,599,573,599,146847,86344641,562,37,2016-07-26
Century Commercial Bank Ltd.,500,615,600,601,111813,67942369,599,2,2016-07-27
Century Commercial Bank Ltd.,405,602,575,595,72736,43273161,601,-6,2016-07-28
Century Commercial Bank Ltd.,430,600,574,584,85280,49571962,595,-11,2016-07-31
Century Commercial Bank Ltd.,591,596,568,575,109944,63469551,584,-9,2016-08-01
Century Commercial Bank Ltd.,182,493,455,474,47514,22268265,465,9,2016-08-02
Century Commercial Bank Ltd.,81,478,460,470,18071,8416018,474,-4,2016-08-03
Century Commercial Bank Ltd.,103,470,446,446,19405,8781900,470,-24,2016-08-04
Century Commercial Bank Ltd.,154,475,439,445,31669,14459874,446,-1,2016-08-07
Century Commercial Bank Ltd.,55,440,413,413,8778,3734957,445,-32,2016-08-08
Century Commercial Bank Ltd.,27,453,421,437,10756,4776140,413,24,2016-08-09
Century Commercial Bank Ltd.,176,462,435,449,38047,17021389,437,12,2016-08-10
Century Commercial Bank Ltd.,120,457,442,447,23683,10601970,449,-2,2016-08-11
Century Commercial Bank Ltd.,74,450,427,438,14507,6358700,447,-9,2016-08-14
Century Commercial Bank Ltd.,80,445,415,417,16126,6839770,438,-21,2016-08-15
Century Commercial Bank Ltd.,46,442,432,440,5993,2617627,445,-5,2016-08-31
Century Commercial Bank Ltd.,84,440,417,428,13605,5807615,417,11,2016-08-16
Century Commercial Bank Ltd.,87,436,421,423,13727,5867690,428,-5,2016-08-17
Century Commercial Bank Ltd.,54,430,416,423,11552,4859459,423,0,2016-08-21
Century Commercial Bank Ltd.,57,424,403,413,9102,3759908,423,-10,2016-08-22
Century Commercial Bank Ltd.,71,417,405,408,13868,5666249,413,-5,2016-08-23
Century Commercial Bank Ltd.,67,420,405,418,10502,4342690,408,10,2016-08-24
Century Commercial Bank Ltd.,69,425,414,420,15195,6359136,418,2,2016-08-28
Century Commercial Bank Ltd.,51,436,412,424,13627,5688831,420,4,2016-08-29
Century Commercial Bank Ltd.,118,445,430,445,26865,11786466,424,21,2016-08-30
Century Commercial Bank Ltd.,56,443,436,443,10406,4573782,440,3,2016-09-01
Century Commercial Bank Ltd.,76,449,436,440,23062,10158330,443,-3,2016-09-04
Century Commercial Bank Ltd.,176,484,432,484,50251,23246185,440,44,2016-09-05
Century Commercial Bank Ltd.,661,532,490,500,186575,94335371,484,16,2016-09-06
Century Commercial Bank Ltd.,283,512,482,487,70497,34930454,500,-13,2016-09-07
Century Commercial Bank Ltd.,113,489,470,485,19208,9155581,487,-2,2016-09-08
Century Commercial Bank Ltd.,103,495,470,470,18115,8637363,485,-15,2016-09-11
Century Commercial Bank Ltd.,72,479,460,467,14388,6707709,470,-3,2016-09-12
Century Commercial Bank Ltd.,125,488,461,480,32048,14966369,467,13,2016-09-14
Century Commercial Bank Ltd.,115,476,465,470,17746,8319430,480,-10,2016-09-18
Century Commercial Bank Ltd.,93,470,462,466,29396,13628379,470,-4,2016-09-20
Century Commercial Bank Ltd.,60,465,449,460,13625,6212158,466,-6,2016-09-21
Century Commercial Bank Ltd.,74,462,450,455,7207,3275443,460,-5,2016-09-22
Century Commercial Bank Ltd.,109,450,433,436,21028,9254936,455,-19,2016-09-25
Century Commercial Bank Ltd.,90,462,436,455,15674,7078621,436,19,2016-09-26
Century Commercial Bank Ltd.,77,463,450,453,11105,5046687,455,-2,2016-09-27
Century Commercial Bank Ltd.,67,459,445,450,12917,5782838,453,-3,2016-09-28
Century Commercial Bank Ltd.,53,457,443,450,12110,5445942,450,0,2016-09-29
Century Commercial Bank Ltd.,47,449,440,445,8736,3880648,450,-5,2016-10-02
Century Commercial Bank Ltd.,46,464,442,448,11946,5379547,445,3,2016-10-03
Century Commercial Bank Ltd.,54,464,455,464,13258,6099093,448,16,2016-10-04
Century Commercial Bank Ltd.,54,474,454,470,11271,5227519,464,6,2016-10-05
Century Commercial Bank Ltd.,73,475,463,470,27899,13097198,470,0,2016-10-06
Century Commercial Bank Ltd.,26,470,455,455,6205,2832221,470,-15,2016-10-16
Century Commercial Bank Ltd.,72,469,448,461,14176,6494557,455,6,2016-10-17
Century Commercial Bank Ltd.,49,465,452,455,15033,6871535,461,-6,2016-10-18
Century Commercial Bank Ltd.,63,465,453,463,9935,4555563,455,8,2016-10-19
Century Commercial Bank Ltd.,40,468,460,465,5660,2622894,463,2,2016-10-20
Century Commercial Bank Ltd.,61,471,457,457,10562,4873899,465,-8,2016-10-23
Century Commercial Bank Ltd.,47,460,450,459,11584,5285005,457,2,2016-10-24
Century Commercial Bank Ltd.,59,459,445,459,10008,4520721,459,0,2016-10-25
Century Commercial Bank Ltd.,44,458,446,451,9676,4378580,459,-8,2016-10-26
Century Commercial Bank Ltd.,51,462,453,460,9681,4433408,451,9,2016-10-27
Century Commercial Bank Ltd.,22,455,442,455,2426,1087254,460,-5,2016-11-03
Century Commercial Bank Ltd.,50,456,447,448,11974,5383802,455,-7,2016-11-07
Century Commercial Bank Ltd.,53,448,436,441,11228,4951540,448,-7,2016-11-08
Century Commercial Bank Ltd.,50,448,425,434,9936,4273051,441,-7,2016-11-09
Century Commercial Bank Ltd.,85,439,421,429,25010,10697584,434,-5,2016-11-10
Century Commercial Bank Ltd.,41,434,409,425,5271,2233862,429,-4,2016-11-13
Century Commercial Bank Ltd.,57,427,417,422,7819,3283194,425,-3,2016-11-14
Century Commercial Bank Ltd.,60,430,418,421,9731,4119582,422,-1,2016-11-15
Century Commercial Bank Ltd.,70,421,410,421,10416,4309559,421,0,2016-11-16
Century Commercial Bank Ltd.,66,419,406,408,11501,4721137,421,-13,2016-11-17
Century Commercial Bank Ltd.,94,401,385,393,16986,6685561,408,-15,2016-11-20
Century Commercial Bank Ltd.,90,405,382,389,15796,6133034,393,-4,2016-11-21
Century Commercial Bank Ltd.,74,385,374,374,11852,4485441,389,-15,2016-11-22
Century Commercial Bank Ltd.,72,381,359,360,23850,8723706,374,-14,2016-11-23
Century Commercial Bank Ltd.,59,388,362,365,12814,4748149,360,5,2016-11-24
Century Commercial Bank Ltd.,47,360,345,347,7933,2763521,365,-18,2016-11-27
Century Commercial Bank Ltd.,61,367,314,367,8118,2698392,347,20,2016-11-28
Century Commercial Bank Ltd.,81,382,346,380,14831,5408097,367,13,2016-11-29
Century Commercial Bank Ltd.,105,400,383,400,23054,9098308,380,20,2016-11-30
Century Commercial Bank Ltd.,70,408,383,390,8717,3450565,400,-10,2016-12-01
Century Commercial Bank Ltd.,46,395,378,385,5276,2050772,390,-5,2016-12-04
Century Commercial Bank Ltd.,54,391,370,380,8118,3057726,385,-5,2016-12-05
Century Commercial Bank Ltd.,30,388,373,378,3706,1405807,380,-2,2016-12-06
Century Commercial Bank Ltd.,44,380,372,376,4825,1813906,378,-2,2016-12-07
Century Commercial Bank Ltd.,37,377,371,375,7703,2883041,376,-1,2016-12-08
Century Commercial Bank Ltd.,40,375,364,370,4408,1629400,375,-5,2016-12-11
Century Commercial Bank Ltd.,59,371,356,363,10285,3720007,370,-7,2016-12-12
Century Commercial Bank Ltd.,34,370,357,365,5132,1856834,363,2,2016-12-14
Century Commercial Bank Ltd.,42,367,360,365,8004,2904160,365,0,2016-12-15
Century Commercial Bank Ltd.,66,364,352,355,11147,3967461,365,-10,2016-12-18
Century Commercial Bank Ltd.,83,355,350,353,13641,4813228,355,-2,2016-12-19
Century Commercial Bank Ltd.,111,353,338,342,19925,6861265,353,-11,2016-12-20
Century Commercial Bank Ltd.,70,344,333,340,8007,2704513,342,-2,2016-12-21
Century Commercial Bank Ltd.,64,340,329,336,9637,3222835,340,-4,2016-12-22
Century Commercial Bank Ltd.,102,335,324,327,18920,6202197,336,-9,2016-12-26
Century Commercial Bank Ltd.,76,330,315,322,9231,2976109,327,-5,2016-12-27
Century Commercial Bank Ltd.,99,334,315,325,8963,2896426,322,3,2016-12-28
Century Commercial Bank Ltd.,120,341,325,330,15732,5179397,325,5,2016-12-29
Century Commercial Bank Ltd.,91,340,332,340,10815,3645441,330,10,2017-01-01
Century Commercial Bank Ltd.,84,358,334,346,15424,5319977,340,6,2017-01-02
Century Commercial Bank Ltd.,62,347,335,338,7610,2592643,346,-8,2017-01-03
Century Commercial Bank Ltd.,49,338,330,336,7440,2474773,338,-2,2017-01-04
Century Commercial Bank Ltd.,59,340,330,335,9398,3140650,336,-1,2017-01-05
Century Commercial Bank Ltd.,71,331,325,327,7357,2412087,335,-8,2017-01-08
Century Commercial Bank Ltd.,36,338,328,332,4378,1447855,327,5,2017-01-09
Century Commercial Bank Ltd.,44,335,329,333,3729,1244128,332,1,2017-01-10
Century Commercial Bank Ltd.,43,338,330,332,3861,1283679,333,-1,2017-01-11
Century Commercial Bank Ltd.,29,335,330,334,3271,1086333,332,2,2017-01-12
Century Commercial Bank Ltd.,57,336,328,334,8776,2917064,334,0,2017-01-15
Century Commercial Bank Ltd.,36,331,325,328,3198,1046537,334,-6,2017-01-16
Century Commercial Bank Ltd.,42,328,320,326,4812,1565102,328,-2,2017-01-17
Century Commercial Bank Ltd.,19,329,320,329,2671,866004,326,3,2017-01-18
Century Commercial Bank Ltd.,38,335,325,325,4483,1461908,329,-4,2017-01-19
Century Commercial Bank Ltd.,60,327,320,322,8571,2770814,325,-3,2017-01-22
Century Commercial Bank Ltd.,67,325,318,323,6818,2198014,322,1,2017-01-23
Century Commercial Bank Ltd.,81,329,312,320,15486,4927698,323,-3,2017-01-24
Century Commercial Bank Ltd.,71,320,300,305,16963,5191776,320,-15,2017-01-25
Century Commercial Bank Ltd.,90,307,295,302,12278,3683066,305,-3,2017-01-26
Century Commercial Bank Ltd.,120,305,273,273,21487,6131869,302,-29,2017-01-30
Century Commercial Bank Ltd.,101,293,261,293,17986,4952529,273,20,2017-01-31
Century Commercial Bank Ltd.,91,314,288,314,14411,4357690,293,21,2017-02-01
Century Commercial Bank Ltd.,93,322,304,308,15782,4921551,314,-6,2017-02-02
Century Commercial Bank Ltd.,49,308,298,304,6087,1838078,308,-4,2017-02-05
Century Commercial Bank Ltd.,37,304,298,300,3708,1114245,304,-4,2017-02-06
Century Commercial Bank Ltd.,68,303,293,300,13192,3914050,300,0,2017-02-07
Century Commercial Bank Ltd.,92,300,291,292,16093,4746297,300,-8,2017-02-08
Century Commercial Bank Ltd.,108,295,288,291,15872,4595736,292,-1,2017-02-09
Century Commercial Bank Ltd.,106,295,269,275,15634,4350531,291,-16,2017-02-12
Century Commercial Bank Ltd.,80,285,255,284,15241,4069414,275,9,2017-02-13
Century Commercial Bank Ltd.,87,290,272,280,13470,3762090,284,-4,2017-02-14
Century Commercial Bank Ltd.,113,299,275,297,31337,9005753,280,17,2017-02-15
Century Commercial Bank Ltd.,105,305,286,295,23287,6880162,297,-2,2017-02-16
Century Commercial Bank Ltd.,87,302,286,300,21720,6425981,295,5,2017-02-19
Century Commercial Bank Ltd.,84,306,291,291,11423,3407383,300,-9,2017-02-20
Century Commercial Bank Ltd.,93,302,287,292,21176,6210628,291,1,2017-02-21
Century Commercial Bank Ltd.,61,296,279,284,10772,3074568,292,-8,2017-02-22
Century Commercial Bank Ltd.,53,287,274,284,6784,1919340,284,0,2017-02-23
Century Commercial Bank Ltd.,51,285,280,280,13152,3698008,284,-4,2017-02-26
Century Commercial Bank Ltd.,45,285,277,285,5893,1659175,280,5,2017-02-28
Century Commercial Bank Ltd.,36,293,286,292,4937,1428491,285,7,2017-03-01
Century Commercial Bank Ltd.,29,292,285,291,3516,1019248,292,-1,2017-03-02
Century Commercial Bank Ltd.,195,320,294,310,46610,14133897,291,19,2017-03-05
Century Commercial Bank Ltd.,92,327,310,327,22377,7135163,317,10,2017-03-21
Century Commercial Bank Ltd.,138,316,304,306,29809,9261267,310,-4,2017-03-06
Century Commercial Bank Ltd.,102,306,296,301,14891,4472790,306,-5,2017-03-07
Century Commercial Bank Ltd.,73,305,299,303,12252,3695618,301,2,2017-03-09
Century Commercial Bank Ltd.,41,302,300,300,9097,2731134,303,-3,2017-03-13
Century Commercial Bank Ltd.,43,304,296,296,3638,1097125,300,-4,2017-03-14
Century Commercial Bank Ltd.,31,300,290,300,4440,1313636,296,4,2017-03-15
Century Commercial Bank Ltd.,58,302,297,297,12554,3751010,300,-3,2017-03-16
Century Commercial Bank Ltd.,91,309,300,305,20771,6305070,297,8,2017-03-19
Century Commercial Bank Ltd.,127,325,308,317,41159,12978028,305,12,2017-03-20
Century Commercial Bank Ltd.,184,350,322,328,37078,12476525,327,1,2017-03-22
Century Commercial Bank Ltd.,413,352,334,342,108461,37126475,328,14,2017-03-23
Century Commercial Bank Ltd.,383,375,342,369,84659,30661449,342,27,2017-03-26
Century Commercial Bank Ltd.,207,405,376,405,46569,18294054,369,36,2017-03-28
Century Commercial Bank Ltd.,456,437,395,397,70187,28774796,405,-8,2017-03-29
Century Commercial Bank Ltd.,499,403,380,398,89786,35346789,397,1,2017-03-30
Century Commercial Bank Ltd.,179,398,369,387,41367,16384891,362,25,2017-04-03
Century Commercial Bank Ltd.,201,396,373,380,45490,17429548,387,-7,2017-04-04
Century Commercial Bank Ltd.,144,387,371,385,22725,8628582,380,5,2017-04-06
Century Commercial Bank Ltd.,106,393,381,387,18250,7043523,385,2,2017-04-09
Century Commercial Bank Ltd.,84,389,380,383,17118,6569123,387,-4,2017-04-10
Century Commercial Bank Ltd.,120,397,384,385,24158,9347568,383,2,2017-04-11
Century Commercial Bank Ltd.,210,402,385,388,50460,19716459,385,3,2017-04-12
Century Commercial Bank Ltd.,131,400,381,383,18577,7175887,388,-5,2017-04-13
Century Commercial Bank Ltd.,145,400,381,381,26743,10357875,383,-2,2017-04-16
Century Commercial Bank Ltd.,146,382,365,365,22916,8483671,381,-16,2017-04-18
Century Commercial Bank Ltd.,79,382,372,381,14714,5572524,365,16,2017-04-19
Century Commercial Bank Ltd.,115,390,384,387,18654,7216765,381,6,2017-04-20
Century Commercial Bank Ltd.,177,417,394,400,43116,17335800,387,13,2017-04-23
Century Commercial Bank Ltd.,111,396,384,390,19760,7712206,400,-10,2017-04-24
Century Commercial Bank Ltd.,90,396,383,392,11609,4552327,390,2,2017-04-25
Century Commercial Bank Ltd.,47,392,387,387,7700,2996756,392,-5,2017-04-26
Century Commercial Bank Ltd.,73,390,380,385,9270,3587428,387,-2,2017-04-27
Century Commercial Bank Ltd.,74,387,378,380,12168,4625371,385,-5,2017-04-30
Century Commercial Bank Ltd.,88,387,375,377,13814,5241572,380,-3,2017-05-02
Century Commercial Bank Ltd.,69,389,375,378,12028,4576769,377,1,2017-05-03
Century Commercial Bank Ltd.,65,378,371,376,9563,3581161,378,-2,2017-05-04
Century Commercial Bank Ltd.,92,375,368,368,15960,5923765,376,-8,2017-05-07
Century Commercial Bank Ltd.,53,375,368,371,4990,1851740,368,3,2017-05-08
Century Commercial Bank Ltd.,87,375,368,370,13616,5039119,371,-1,2017-05-09
Century Commercial Bank Ltd.,71,380,370,379,7919,2967017,370,9,2017-05-11
Century Commercial Bank Ltd.,105,393,386,388,15412,5988040,379,9,2017-05-15
Century Commercial Bank Ltd.,76,390,382,383,8899,3431877,388,-5,2017-05-16
Century Commercial Bank Ltd.,91,393,380,385,12878,4966206,383,2,2017-05-17
Century Commercial Bank Ltd.,84,387,378,380,10502,4005664,385,-5,2017-05-18
Century Commercial Bank Ltd.,70,385,377,379,8508,3230983,380,-1,2017-05-21
Century Commercial Bank Ltd.,47,380,372,372,9359,3503781,379,-7,2017-05-22
Century Commercial Bank Ltd.,68,385,378,381,8177,3107713,372,9,2017-05-23
Century Commercial Bank Ltd.,69,385,375,383,7969,3021925,381,2,2017-05-24
Century Commercial Bank Ltd.,92,384,377,378,13082,4982833,383,-5,2017-05-28
Century Commercial Bank Ltd.,77,384,373,377,12786,4830538,378,-1,2017-05-30
Century Commercial Bank Ltd.,72,387,375,387,8836,3341378,377,10,2017-05-31
Century Commercial Bank Ltd.,131,390,376,380,21543,8176081,387,-7,2017-06-01
Century Commercial Bank Ltd.,87,380,370,375,19291,7183280,380,-5,2017-06-04
Century Commercial Bank Ltd.,62,381,375,377,6447,2432769,375,2,2017-06-05
Century Commercial Bank Ltd.,87,387,378,385,12230,4695286,377,8,2017-06-06
Century Commercial Bank Ltd.,106,394,382,384,15231,5857803,385,-1,2017-06-07
Century Commercial Bank Ltd.,66,387,375,375,9464,3572225,384,-9,2017-06-08
Century Commercial Bank Ltd.,120,381,357,370,11901,4396679,375,-5,2017-06-11
Century Commercial Bank Ltd.,74,375,363,367,5473,2013957,370,-3,2017-06-12
Century Commercial Bank Ltd.,63,376,366,370,8273,3081996,367,3,2017-06-13
Century Commercial Bank Ltd.,44,376,371,372,5887,2203051,370,2,2017-06-14
Century Commercial Bank Ltd.,74,377,370,372,10388,3876998,372,0,2017-06-15
Century Commercial Bank Ltd.,69,380,370,371,7692,2876853,372,-1,2017-06-18
Century Commercial Bank Ltd.,75,377,365,366,8204,3017710,371,-5,2017-06-19
Century Commercial Bank Ltd.,84,373,353,364,12516,4524530,366,-2,2017-06-20
Century Commercial Bank Ltd.,81,370,360,365,9024,3294661,364,1,2017-06-21
Century Commercial Bank Ltd.,104,370,361,366,13202,4842540,365,1,2017-06-22
Century Commercial Bank Ltd.,50,370,360,367,4322,1584042,366,1,2017-06-25
Century Commercial Bank Ltd.,68,371,365,366,6600,2422119,367,-1,2017-06-27
Century Commercial Bank Ltd.,45,370,362,370,7509,2740908,366,4,2017-06-28
Century Commercial Bank Ltd.,66,370,360,363,7993,2909974,370,-7,2017-07-02
Century Commercial Bank Ltd.,55,366,356,360,9395,3408302,363,-3,2017-07-03
Century Commercial Bank Ltd.,253,370,357,365,37167,13649048,360,5,2017-07-04
Century Commercial Bank Ltd.,287,372,363,365,43103,15769395,365,0,2017-07-05
Century Commercial Bank Ltd.,248,375,368,373,31529,11715677,365,8,2017-07-06
Century Commercial Bank Ltd.,315,388,368,378,46920,17744383,373,5,2017-07-09
Century Commercial Bank Ltd.,596,380,370,373,93602,35058545,378,-5,2017-07-10
Century Commercial Bank Ltd.,146,300,283,293,28677,8363574,295,-2,2017-07-11
Century Commercial Bank Ltd.,51,295,290,293,5330,1556703,293,0,2017-07-12
Century Commercial Bank Ltd.,63,295,285,290,5052,1458110,293,-3,2017-07-13
Century Commercial Bank Ltd.,157,295,280,282,36054,10187227,290,-8,2017-07-16
Century Commercial Bank Ltd.,91,285,280,285,14944,4212217,282,3,2017-07-17
Century Commercial Bank Ltd.,95,289,279,281,25630,7243183,285,-4,2017-07-18
Century Commercial Bank Ltd.,96,270,264,265,15480,4123980,266,-1,2017-08-03
Century Commercial Bank Ltd.,133,285,279,280,29680,8351435,281,-1,2017-07-19
Century Commercial Bank Ltd.,112,281,276,279,20463,5687717,280,-1,2017-07-20
Century Commercial Bank Ltd.,157,275,270,270,29258,7934513,279,-9,2017-07-23
Century Commercial Bank Ltd.,115,271,267,267,22452,6051992,270,-3,2017-07-24
Century Commercial Bank Ltd.,100,276,267,270,15107,4079370,267,3,2017-07-25
Century Commercial Bank Ltd.,79,275,265,268,8552,2295507,270,-2,2017-07-26
Century Commercial Bank Ltd.,83,270,261,266,11831,3148885,268,-2,2017-07-27
Century Commercial Bank Ltd.,88,270,264,268,10921,2919737,266,2,2017-07-30
Century Commercial Bank Ltd.,94,272,263,263,12566,3336570,268,-5,2017-07-31
Century Commercial Bank Ltd.,125,269,262,265,19982,5301488,263,2,2017-08-01
Century Commercial Bank Ltd.,72,269,265,266,9592,2552790,265,1,2017-08-02
Century Commercial Bank Ltd.,113,270,263,265,18533,4923769,265,0,2017-08-06
Century Commercial Bank Ltd.,96,270,262,262,15387,4072648,265,-3,2017-08-07
Century Commercial Bank Ltd.,78,264,261,263,11836,3103011,262,1,2017-08-09
Century Commercial Bank Ltd.,98,264,260,262,20797,5440403,263,-1,2017-08-10
Century Commercial Bank Ltd.,64,263,255,258,10887,2809925,262,-4,2017-08-13
Century Commercial Bank Ltd.,56,260,252,255,9720,2478527,258,-3,2017-08-15
Century Commercial Bank Ltd.,70,261,255,257,11950,3069136,255,2,2017-08-16
Century Commercial Bank Ltd.,81,258,253,255,10645,2712864,257,-2,2017-08-17
Century Commercial Bank Ltd.,82,255,250,253,12875,3270657,255,-2,2017-08-20
Century Commercial Bank Ltd.,87,253,245,252,14620,3644152,253,-1,2017-08-21
Century Commercial Bank Ltd.,100,254,246,252,14678,3667922,252,0,2017-08-22
Century Commercial Bank Ltd.,87,250,244,248,19900,4891478,252,-4,2017-08-23
Century Commercial Bank Ltd.,64,250,247,248,14776,3670281,248,0,2017-08-24
Century Commercial Bank Ltd.,97,252,240,248,16743,4123697,248,0,2017-08-27
Century Commercial Bank Ltd.,162,244,238,240,29205,7000064,248,-8,2017-08-28
Century Commercial Bank Ltd.,133,239,228,233,42969,9973611,240,-7,2017-08-30
Century Commercial Bank Ltd.,175,235,229,229,47074,10842238,233,-4,2017-08-31
Century Commercial Bank Ltd.,180,233,220,227,34272,7711518,229,-2,2017-09-04
Century Commercial Bank Ltd.,129,232,225,229,15786,3582331,227,2,2017-09-06
Century Commercial Bank Ltd.,143,230,219,224,38774,8637948,229,-5,2017-09-07
Century Commercial Bank Ltd.,119,223,218,221,21674,4775815,224,-3,2017-09-10
Century Commercial Bank Ltd.,135,223,217,220,22251,4899779,221,-1,2017-09-11
Century Commercial Bank Ltd.,134,221,215,217,26821,5811483,220,-3,2017-09-12
Century Commercial Bank Ltd.,120,220,215,215,49155,10629261,217,-2,2017-09-13
Century Commercial Bank Ltd.,86,222,217,220,15934,3493876,215,5,2017-09-14
Century Commercial Bank Ltd.,120,227,216,224,27181,6060300,220,4,2017-09-17
Century Commercial Bank Ltd.,122,231,223,225,19404,4378793,224,1,2017-09-18
Century Commercial Bank Ltd.,73,227,220,227,8806,1967427,225,2,2017-09-20
Century Commercial Bank Ltd.,63,224,217,221,14569,3193941,222,-1,2017-10-09
Century Commercial Bank Ltd.,90,227,219,224,24297,5376932,227,-3,2017-09-24
Century Commercial Bank Ltd.,67,230,225,229,15642,3563282,224,5,2017-09-25
Century Commercial Bank Ltd.,83,231,225,227,17968,4104174,229,-2,2017-09-26
Century Commercial Bank Ltd.,37,228,224,224,5430,1225603,227,-3,2017-10-03
Century Commercial Bank Ltd.,44,226,223,223,9430,2119332,224,-1,2017-10-04
Century Commercial Bank Ltd.,90,224,216,222,22508,4931080,223,-1,2017-10-08
Century Commercial Bank Ltd.,51,225,218,221,9421,2091703,221,0,2017-10-10
Century Commercial Bank Ltd.,65,224,218,220,14337,3156850,221,-1,2017-10-11
Century Commercial Bank Ltd.,62,223,217,220,10682,2352956,220,0,2017-10-12
Century Commercial Bank Ltd.,59,224,218,223,14671,3230153,220,3,2017-10-15
Century Commercial Bank Ltd.,60,230,225,229,14419,3275808,223,6,2017-10-16
Century Commercial Bank Ltd.,91,232,224,226,25133,5696125,229,-3,2017-10-17
Century Commercial Bank Ltd.,58,231,224,230,22709,5183311,226,4,2017-10-18
Century Commercial Bank Ltd.,47,234,228,228,10179,2343299,230,-2,2017-10-22
Century Commercial Bank Ltd.,54,231,225,228,15990,3638103,228,0,2017-10-23
Century Commercial Bank Ltd.,65,229,225,226,9305,2108312,228,-2,2017-10-24
Century Commercial Bank Ltd.,66,228,223,226,11026,2478645,226,0,2017-10-25
Century Commercial Bank Ltd.,83,228,220,222,22643,5026921,226,-4,2017-10-29
Century Commercial Bank Ltd.,89,226,221,224,28421,6328112,222,2,2017-10-30
Century Commercial Bank Ltd.,92,227,221,222,21305,4741869,224,-2,2017-10-31
Century Commercial Bank Ltd.,75,225,220,222,15277,3389131,222,0,2017-11-01
Century Commercial Bank Ltd.,102,230,219,224,22585,5043811,222,2,2017-11-02
Century Commercial Bank Ltd.,122,226,218,222,35339,7747045,224,-2,2017-11-05
Century Commercial Bank Ltd.,108,222,217,219,23855,5238243,222,-3,2017-11-06
Century Commercial Bank Ltd.,87,223,218,219,13451,2959074,219,0,2017-11-07
Century Commercial Bank Ltd.,108,220,216,219,17456,3802959,219,0,2017-11-08
Century Commercial Bank Ltd.,113,220,213,218,22392,4853170,219,-1,2017-11-09
Century Commercial Bank Ltd.,152,219,212,217,32892,7118418,218,-1,2017-11-12
Century Commercial Bank Ltd.,159,220,216,219,35302,7658310,217,2,2017-11-13
Century Commercial Bank Ltd.,228,226,217,223,56878,12534277,219,4,2017-11-14
Century Commercial Bank Ltd.,144,225,219,219,31906,7062060,223,-4,2017-11-15
Century Commercial Bank Ltd.,110,221,216,216,19169,4172273,219,-3,2017-11-16
Century Commercial Bank Ltd.,138,218,214,216,27172,5849910,216,0,2017-11-19
Century Commercial Bank Ltd.,111,217,214,215,19943,4290929,216,-1,2017-11-20
Century Commercial Bank Ltd.,100,220,214,217,14940,3247289,215,2,2017-11-21
Century Commercial Bank Ltd.,128,218,213,216,26424,5697866,217,-1,2017-11-22
Century Commercial Bank Ltd.,114,221,215,215,20511,4449686,216,-1,2017-11-23
Century Commercial Bank Ltd.,100,220,216,219,17332,3773277,215,4,2017-11-26
Century Commercial Bank Ltd.,99,219,216,218,18072,3938682,219,-1,2017-11-27
Century Commercial Bank Ltd.,108,219,216,219,18135,3940112,218,1,2017-11-28
Century Commercial Bank Ltd.,114,222,218,219,34784,7653570,219,0,2017-11-29
Century Commercial Bank Ltd.,123,220,216,216,35361,7696080,219,-3,2017-11-30
Century Commercial Bank Ltd.,124,220,216,216,22505,4892275,216,0,2017-12-04
Century Commercial Bank Ltd.,78,217,212,213,12624,2693222,215,-2,2017-12-20
Century Commercial Bank Ltd.,92,218,215,217,26048,5634421,216,1,2017-12-05
Century Commercial Bank Ltd.,102,222,215,220,16368,3591619,217,3,2017-12-06
Century Commercial Bank Ltd.,107,222,215,215,21353,4674175,220,-5,2017-12-10
Century Commercial Bank Ltd.,86,218,215,217,28021,6072121,215,2,2017-12-11
Century Commercial Bank Ltd.,95,217,215,216,16243,3505941,217,-1,2017-12-12
Century Commercial Bank Ltd.,74,219,214,217,13317,2877205,216,1,2017-12-13
Century Commercial Bank Ltd.,123,218,215,216,17630,3818462,217,-1,2017-12-14
Century Commercial Bank Ltd.,97,220,213,215,12701,2731481,216,-1,2017-12-17
Century Commercial Bank Ltd.,110,217,214,215,28723,6190767,215,0,2017-12-18
Century Commercial Bank Ltd.,108,218,212,215,21229,4542282,215,0,2017-12-19
Century Commercial Bank Ltd.,99,214,210,213,18875,3987730,213,0,2017-12-21
Century Commercial Bank Ltd.,102,216,210,210,15181,3221533,213,-3,2017-12-24
Century Commercial Bank Ltd.,92,212,208,209,13961,2923704,210,-1,2017-12-26
Century Commercial Bank Ltd.,117,210,201,205,28954,5933321,209,-4,2017-12-27
Century Commercial Bank Ltd.,113,205,200,203,28388,5728501,205,-2,2017-12-28
Century Commercial Bank Ltd.,64,202,197,200,17338,3459474,203,-3,2017-12-31
Century Commercial Bank Ltd.,114,207,197,204,25129,5059693,200,4,2018-01-01
Century Commercial Bank Ltd.,73,205,201,203,11636,2366071,204,-1,2018-01-02
Century Commercial Bank Ltd.,77,203,195,200,16446,3275264,203,-3,2018-01-03
Century Commercial Bank Ltd.,103,201,198,199,17133,3420127,200,-1,2018-01-04
Century Commercial Bank Ltd.,85,201,197,201,11871,2364305,199,2,2018-01-07
Century Commercial Bank Ltd.,99,200,198,200,18975,3779775,201,-1,2018-01-08
Century Commercial Bank Ltd.,68,203,199,201,9485,1905833,200,1,2018-01-09
Century Commercial Bank Ltd.,64,202,199,199,8899,1779497,201,-2,2018-01-10
Century Commercial Bank Ltd.,82,200,197,199,12212,2415781,199,0,2018-01-14
Century Commercial Bank Ltd.,62,200,197,197,9822,1942665,199,-2,2018-01-16
Century Commercial Bank Ltd.,78,200,194,197,11870,2329854,197,0,2018-01-17
Century Commercial Bank Ltd.,110,201,195,195,24296,4818307,197,-2,2018-01-21
Century Commercial Bank Ltd.,68,197,193,193,12568,2439149,195,-2,2018-01-22
Century Commercial Bank Ltd.,69,194,191,191,15842,3031637,193,-2,2018-01-23
Century Commercial Bank Ltd.,53,194,190,193,9933,1908718,191,2,2018-01-24
Century Commercial Bank Ltd.,68,195,192,194,13043,2518937,193,1,2018-01-25
Century Commercial Bank Ltd.,90,196,193,194,17172,3337959,194,0,2018-01-28
Century Commercial Bank Ltd.,116,198,194,196,23872,4679610,194,2,2018-01-29
Century Commercial Bank Ltd.,91,199,195,198,13783,2722107,196,2,2018-01-31
Century Commercial Bank Ltd.,115,200,197,199,21031,4177773,198,1,2018-02-01
Century Commercial Bank Ltd.,146,201,196,196,19836,3930606,199,-3,2018-02-04
Century Commercial Bank Ltd.,103,196,193,195,17540,3409284,196,-1,2018-02-05
Century Commercial Bank Ltd.,111,195,190,193,23887,4592607,195,-2,2018-02-06
Century Commercial Bank Ltd.,78,193,191,193,15882,3044139,193,0,2018-02-07
Century Commercial Bank Ltd.,113,192,190,191,24134,4607120,193,-2,2018-02-08
Century Commercial Bank Ltd.,109,191,186,187,23904,4483533,193,-6,2018-02-25
Century Commercial Bank Ltd.,102,193,191,191,21237,4072104,191,0,2018-02-11
Century Commercial Bank Ltd.,104,195,191,191,13773,2640693,191,0,2018-02-12
Century Commercial Bank Ltd.,96,193,189,192,24739,4721392,191,1,2018-02-14
Century Commercial Bank Ltd.,200,202,192,199,35071,6873286,192,7,2018-02-15
Century Commercial Bank Ltd.,285,207,198,202,86731,17600895,199,3,2018-02-18
Century Commercial Bank Ltd.,160,206,199,200,53786,10825043,202,-2,2018-02-20
Century Commercial Bank Ltd.,224,201,197,200,56892,11343876,200,0,2018-02-21
Century Commercial Bank Ltd.,452,205,200,203,166215,33557296,200,3,2018-02-22
Century Commercial Bank Ltd.,57,187,185,187,16820,3130683,187,0,2018-02-26
Century Commercial Bank Ltd.,56,190,185,188,13100,2446631,187,1,2018-02-27
Century Commercial Bank Ltd.,94,187,180,184,20574,3755990,188,-4,2018-02-28
Century Commercial Bank Ltd.,92,181,172,179,19914,3506168,184,-5,2018-03-04
Century Commercial Bank Ltd.,106,180,172,173,29268,5139206,179,-6,2018-03-05
Century Commercial Bank Ltd.,133,175,169,175,36632,6294435,173,2,2018-03-06
Century Commercial Bank Ltd.,143,182,175,180,32280,5756813,175,5,2018-03-07
Century Commercial Bank Ltd.,106,181,173,177,14950,2620342,180,-3,2018-03-11
Century Commercial Bank Ltd.,65,177,172,172,13018,2267446,177,-5,2018-03-12
Century Commercial Bank Ltd.,71,176,170,176,14927,2570847,172,4,2018-03-13
Century Commercial Bank Ltd.,45,177,173,176,7452,1306084,176,0,2018-03-14
Century Commercial Bank Ltd.,83,179,173,177,22517,3979334,176,1,2018-03-15
Century Commercial Bank Ltd.,86,179,175,176,18665,3292598,177,-1,2018-03-18
Century Commercial Bank Ltd.,72,178,172,172,9295,1625667,176,-4,2018-03-19
Century Commercial Bank Ltd.,77,172,169,171,13986,2380931,172,-1,2018-03-20
Century Commercial Bank Ltd.,96,172,167,170,20050,3387309,171,-1,2018-03-21
Century Commercial Bank Ltd.,139,175,168,169,34221,5802743,170,-1,2018-03-22
Century Commercial Bank Ltd.,147,166,156,163,39454,6332098,169,-6,2018-03-26
Century Commercial Bank Ltd.,152,175,155,174,48424,7784501,163,11,2018-03-27
Century Commercial Bank Ltd.,168,174,163,168,30581,5219594,174,-6,2018-03-28
Century Commercial Bank Ltd.,67,173,167,170,11959,2037092,168,2,2018-03-29
Century Commercial Bank Ltd.,101,173,166,167,16422,2753525,170,-3,2018-04-01
Century Commercial Bank Ltd.,56,169,166,168,10780,1803365,167,1,2018-04-02
Century Commercial Bank Ltd.,59,171,168,170,6439,1092332,168,2,2018-04-03
Century Commercial Bank Ltd.,94,174,170,173,18003,3106659,170,3,2018-04-04
Century Commercial Bank Ltd.,133,176,172,174,21036,3658618,173,1,2018-04-05
Century Commercial Bank Ltd.,134,180,175,177,30768,5475917,174,3,2018-04-08
Century Commercial Bank Ltd.,164,183,176,176,38428,6846599,177,-1,2018-04-09
Century Commercial Bank Ltd.,97,179,173,173,18431,3231720,176,-3,2018-04-10
Century Commercial Bank Ltd.,62,176,167,171,8618,1477985,173,-2,2018-04-11
Century Commercial Bank Ltd.,93,176,171,172,14256,2468112,171,1,2018-04-12
Century Commercial Bank Ltd.,48,175,166,175,9922,1689975,172,3,2018-04-15
Century Commercial Bank Ltd.,65,176,172,176,11926,2084930,175,1,2018-04-16
Century Commercial Bank Ltd.,95,180,174,176,27395,4840815,176,0,2018-04-17
Century Commercial Bank Ltd.,100,192,173,183,31845,5717071,176,7,2018-04-18
Century Commercial Bank Ltd.,170,190,180,189,33870,6281094,183,6,2018-04-19
Century Commercial Bank Ltd.,227,200,191,198,63676,12390776,189,9,2018-04-22
Century Commercial Bank Ltd.,231,205,191,193,55863,11048113,198,-5,2018-04-23
Century Commercial Bank Ltd.,398,202,192,198,139399,27637688,193,5,2018-04-24
Century Commercial Bank Ltd.,216,204,196,199,52695,10499447,198,1,2018-04-25
Century Commercial Bank Ltd.,158,200,193,196,46209,9088083,199,-3,2018-04-26
Century Commercial Bank Ltd.,93,197,193,195,16351,3192588,196,-1,2018-04-29
Century Commercial Bank Ltd.,100,196,191,195,18476,3568045,195,0,2018-05-02
Century Commercial Bank Ltd.,120,198,193,195,28916,5625302,195,0,2018-05-03
Century Commercial Bank Ltd.,120,196,191,191,18077,3474271,195,-4,2018-05-06
Century Commercial Bank Ltd.,75,193,190,190,11539,2201769,191,-1,2018-05-07
Century Commercial Bank Ltd.,97,194,191,194,16632,3192879,190,4,2018-05-08
Century Commercial Bank Ltd.,89,197,192,193,14008,2705624,194,-1,2018-05-09
Century Commercial Bank Ltd.,68,194,190,192,11154,2135848,193,-1,2018-05-10
Century Commercial Bank Ltd.,159,193,186,188,46955,8845507,192,-4,2018-05-14
Century Commercial Bank Ltd.,29,188,185,188,6077,1133051,188,0,2018-05-15
Century Commercial Bank Ltd.,22,190,187,188,3596,677141,188,0,2018-05-16
Century Commercial Bank Ltd.,58,191,186,187,9273,1746085,188,-1,2018-05-17
Century Commercial Bank Ltd.,84,193,186,186,21772,4091408,187,-1,2018-05-20
Century Commercial Bank Ltd.,81,188,184,187,17671,3285153,186,1,2018-05-21
Century Commercial Bank Ltd.,45,187,185,185,7500,1391460,187,-2,2018-05-22
Century Commercial Bank Ltd. Promoter Share,3,209,209,209,60000,12540000,205,4,2017-07-09
Century Commercial Bank Ltd. Promoter Share,2,209,209,209,26976,5637984,209,0,2017-07-23
Century Commercial Bank Ltd. Promoter Share,3,209,209,209,100519,21008471,209,0,2017-07-26
Century Commercial Bank Ltd. Promoter Share,1,209,209,209,6000,1254000,209,0,2017-09-07
Century Commercial Bank Ltd. Promoter Share,1,209,209,209,9520,1989680,209,0,2017-09-20
Century Commercial Bank Ltd. Promoter Share,1,209,209,209,22750,4754750,209,0,2017-10-25
Century Commercial Bank Ltd. Promoter Share,1,209,209,209,22000,4598000,209,0,2017-10-29
Century Commercial Bank Ltd. Promoter Share,1,209,209,209,64817,13546753,209,0,2017-11-30
Century Commercial Bank Ltd. Promoter Share,1,205,205,205,11352,2327160,209,-4,2017-12-06
Century Commercial Bank Ltd. Promoter Share,1,205,205,205,11000,2255000,205,0,2018-01-14
Century Commercial Bank Ltd. Promoter Share,1,205,205,205,16202,3321410,205,0,2018-02-15
Century Commercial Bank Ltd. Promoter Share,5,205,201,201,27339,5541299,205,-4,2018-02-22
Century Commercial Bank Ltd. Promoter Share,1,197,197,197,12693,2500521,201,-4,2018-02-28
Century Commercial Bank Ltd. Promoter Share,1,194,194,194,19847,3850318,197,-3,2018-03-11
Century Commercial Bank Ltd. Promoter Share,1,191,191,191,1683,321453,194,-3,2018-03-13
Century Commercial Bank Ltd. Promoter Share,1,191,191,191,5000,955000,191,0,2018-03-27
Century Commercial Bank Ltd. Promoter Share,1,188,188,188,3005,564940,191,-3,2018-03-28
Century Commercial Bank Ltd. Promoter Share,1,185,185,185,40908,7567980,188,-3,2018-03-29
Century Commercial Bank Ltd. Promoter Share,9,182,182,182,17500,3185000,185,-3,2018-04-16
Century Commercial Bank Ltd. Promoter Share,1,182,182,182,14625,2661750,182,0,2018-04-29
Century Commercial Bank Ltd. Promoter Share,1,182,182,182,12500,2275000,182,0,2018-05-03
Century Commercial Bank Ltd. Promoter Share,2,182,182,182,78210,14234220,182,0,2018-05-21
Chhimek Laghubitta Bikas Bank Limited,34,2020,1965,2000,6591,13163909,1999,1,2016-05-23
Chhimek Laghubitta Bikas Bank Limited,95,2095,1980,2095,21590,43584063,2000,95,2016-05-24
Chhimek Laghubitta Bikas Bank Limited,100,2203,2054,2125,14114,29739600,2095,30,2016-05-25
Chhimek Laghubitta Bikas Bank Limited,61,2155,2070,2150,11233,23816787,2125,25,2016-05-26
Chhimek Laghubitta Bikas Bank Limited,23,2160,2150,2155,2260,4868264,2150,5,2016-05-29
Chhimek Laghubitta Bikas Bank Limited,21,2155,2115,2130,2968,6331920,2155,-25,2016-05-30
Chhimek Laghubitta Bikas Bank Limited,29,2130,2100,2100,4216,8919115,2130,-30,2016-05-31
Chhimek Laghubitta Bikas Bank Limited,26,2140,2090,2090,3133,6604174,2100,-10,2016-06-01
Chhimek Laghubitta Bikas Bank Limited,23,2090,2049,2060,2895,5968925,2090,-30,2016-06-02
Chhimek Laghubitta Bikas Bank Limited,32,2050,1960,1985,3448,6840111,2060,-75,2016-06-05
Chhimek Laghubitta Bikas Bank Limited,29,2065,2000,2025,3260,6604975,1985,40,2016-06-06
Chhimek Laghubitta Bikas Bank Limited,17,2065,2025,2030,1872,3819450,2025,5,2016-06-07
Chhimek Laghubitta Bikas Bank Limited,32,2288,2191,2197,4617,10265683,2200,-3,2016-06-23
Chhimek Laghubitta Bikas Bank Limited,14,2050,2022,2030,2301,4688320,2030,0,2016-06-08
Chhimek Laghubitta Bikas Bank Limited,13,2100,2020,2100,2001,4124230,2030,70,2016-06-09
Chhimek Laghubitta Bikas Bank Limited,29,2130,2090,2100,4258,8970928,2100,0,2016-06-12
Chhimek Laghubitta Bikas Bank Limited,94,2267,2100,2205,18104,38965487,2100,105,2016-06-13
Chhimek Laghubitta Bikas Bank Limited,126,2329,2211,2245,15227,34319389,2205,40,2016-06-14
Chhimek Laghubitta Bikas Bank Limited,55,2299,2190,2230,6154,13861754,2245,-15,2016-06-15
Chhimek Laghubitta Bikas Bank Limited,38,2270,2200,2235,4850,10893787,2230,5,2016-06-16
Chhimek Laghubitta Bikas Bank Limited,64,2229,2150,2180,7461,16342044,2235,-55,2016-06-19
Chhimek Laghubitta Bikas Bank Limited,15,2170,2150,2170,1700,3669400,2180,-10,2016-06-20
Chhimek Laghubitta Bikas Bank Limited,23,2201,2170,2200,3106,6790340,2170,30,2016-06-21
Chhimek Laghubitta Bikas Bank Limited,37,2240,2190,2200,6688,14814789,2200,0,2016-06-22
Chhimek Laghubitta Bikas Bank Limited,29,2240,2198,2200,3945,8728489,2197,3,2016-06-26
Chhimek Laghubitta Bikas Bank Limited,25,2230,2210,2210,3799,8424538,2200,10,2016-06-27
Chhimek Laghubitta Bikas Bank Limited,6,2245,2225,2245,1150,2566000,2210,35,2016-06-28
Chhimek Laghubitta Bikas Bank Limited,55,2300,2221,2281,9975,22497724,2245,36,2016-06-29
Chhimek Laghubitta Bikas Bank Limited,91,2370,2254,2370,13730,31935271,2281,89,2016-06-30
Chhimek Laghubitta Bikas Bank Limited,130,2600,2382,2585,21254,53574364,2370,215,2016-07-03
Chhimek Laghubitta Bikas Bank Limited,95,2688,2490,2490,13158,33303761,2585,-95,2016-07-04
Chhimek Laghubitta Bikas Bank Limited,41,2450,2400,2430,5672,13733674,2490,-60,2016-07-05
Chhimek Laghubitta Bikas Bank Limited,31,2430,2370,2379,4532,10826940,2430,-51,2016-07-06
Chhimek Laghubitta Bikas Bank Limited,47,2480,2407,2420,7311,17896503,2379,41,2016-07-10
Chhimek Laghubitta Bikas Bank Limited,22,2417,2303,2303,2332,5503228,2420,-117,2016-07-11
Chhimek Laghubitta Bikas Bank Limited,63,2300,2160,2270,7375,16527038,2303,-33,2016-07-12
Chhimek Laghubitta Bikas Bank Limited,34,2274,2205,2240,5207,11680223,2270,-30,2016-07-13
Chhimek Laghubitta Bikas Bank Limited,57,2340,2250,2290,10129,23050843,2240,50,2016-07-14
Chhimek Laghubitta Bikas Bank Limited,8,2245,2061,2061,130,273730,2290,-229,2016-07-17
Chhimek Laghubitta Bikas Bank Limited,148,2035,1855,2000,20355,40436860,2061,-61,2016-07-18
Chhimek Laghubitta Bikas Bank Limited,43,2120,2000,2035,6698,13807887,2000,35,2016-07-19
Chhimek Laghubitta Bikas Bank Limited,35,2070,2000,2005,4108,8319751,2035,-30,2016-07-20
Chhimek Laghubitta Bikas Bank Limited,38,2100,2000,2100,7757,15812981,2005,95,2016-07-21
Chhimek Laghubitta Bikas Bank Limited,41,2184,2110,2180,5323,11482504,2100,80,2016-07-25
Chhimek Laghubitta Bikas Bank Limited,16,2270,2170,2270,3323,7429235,2180,90,2016-07-26
Chhimek Laghubitta Bikas Bank Limited,21,2315,2210,2210,2212,4929782,2270,-60,2016-07-27
Chhimek Laghubitta Bikas Bank Limited,34,2300,2205,2230,3209,7202705,2210,20,2016-07-28
Chhimek Laghubitta Bikas Bank Limited,35,2300,2250,2269,4688,10655403,2230,39,2016-07-31
Chhimek Laghubitta Bikas Bank Limited,23,2260,2180,2250,8966,20103615,2269,-19,2016-08-01
Chhimek Laghubitta Bikas Bank Limited,27,2220,2180,2180,2165,4774460,2250,-70,2016-08-02
Chhimek Laghubitta Bikas Bank Limited,19,2195,2150,2180,2248,4878580,2180,0,2016-08-03
Chhimek Laghubitta Bikas Bank Limited,34,2140,2050,2091,4854,10215823,2180,-89,2016-08-04
Chhimek Laghubitta Bikas Bank Limited,28,2258,2070,2100,3196,7005968,2091,9,2016-08-07
Chhimek Laghubitta Bikas Bank Limited,11,2070,1996,1996,1655,3369150,2100,-104,2016-08-08
Chhimek Laghubitta Bikas Bank Limited,3,2116,2035,2116,30,62260,1996,120,2016-08-09
Chhimek Laghubitta Bikas Bank Limited,29,2142,2050,2087,4248,8984212,2116,-29,2016-08-10
Chhimek Laghubitta Bikas Bank Limited,30,2120,2058,2114,5784,12114574,2087,27,2016-08-11
Chhimek Laghubitta Bikas Bank Limited,24,2100,2030,2050,2341,4841758,2114,-64,2016-08-14
Chhimek Laghubitta Bikas Bank Limited,32,2010,1952,2000,3036,6027596,2050,-50,2016-08-15
Chhimek Laghubitta Bikas Bank Limited,8,2101,2090,2090,1260,2641200,2120,-30,2016-08-31
Chhimek Laghubitta Bikas Bank Limited,4,2030,2000,2030,808,1634600,2000,30,2016-08-16
Chhimek Laghubitta Bikas Bank Limited,5,2089,2030,2089,750,1530970,2030,59,2016-08-17
Chhimek Laghubitta Bikas Bank Limited,13,2071,2019,2021,1252,2548758,2089,-68,2016-08-21
Chhimek Laghubitta Bikas Bank Limited,6,1995,1960,1970,354,702000,2021,-51,2016-08-22
Chhimek Laghubitta Bikas Bank Limited,31,1990,1930,1930,4020,7850445,1970,-40,2016-08-23
Chhimek Laghubitta Bikas Bank Limited,21,2040,1920,2040,3058,5996940,1930,110,2016-08-24
Chhimek Laghubitta Bikas Bank Limited,15,2055,2020,2050,1784,3639682,2040,10,2016-08-28
Chhimek Laghubitta Bikas Bank Limited,23,2100,2020,2100,2922,6002520,2050,50,2016-08-29
Chhimek Laghubitta Bikas Bank Limited,14,2120,2097,2120,1715,3609315,2100,20,2016-08-30
Chhimek Laghubitta Bikas Bank Limited,8,2090,2050,2090,830,1719030,2090,0,2016-09-01
Chhimek Laghubitta Bikas Bank Limited,21,2090,2049,2080,7537,15652420,2090,-10,2016-09-04
Chhimek Laghubitta Bikas Bank Limited,18,2120,2081,2081,3312,6941925,2080,1,2016-09-05
Chhimek Laghubitta Bikas Bank Limited,28,2120,2050,2076,4813,10061277,2081,-5,2016-09-06
Chhimek Laghubitta Bikas Bank Limited,10,2100,2080,2080,2159,4507220,2076,4,2016-09-07
Chhimek Laghubitta Bikas Bank Limited,13,2101,2050,2075,1758,3645100,2080,-5,2016-09-08
Chhimek Laghubitta Bikas Bank Limited,34,2110,2050,2098,7946,16452081,2075,23,2016-09-11
Chhimek Laghubitta Bikas Bank Limited,23,2145,2105,2125,2521,5359990,2098,27,2016-09-12
Chhimek Laghubitta Bikas Bank Limited,20,2140,2090,2100,3198,6742640,2125,-25,2016-09-14
Chhimek Laghubitta Bikas Bank Limited,26,2070,2026,2040,2637,5368881,2100,-60,2016-09-18
Chhimek Laghubitta Bikas Bank Limited,23,2050,2035,2040,2432,4967680,2040,0,2016-09-20
Chhimek Laghubitta Bikas Bank Limited,13,2060,2002,2060,2815,5711158,2040,20,2016-09-21
Chhimek Laghubitta Bikas Bank Limited,32,2050,2010,2010,2628,5318416,2060,-50,2016-09-22
Chhimek Laghubitta Bikas Bank Limited,23,2010,1810,1876,1963,3657350,2010,-134,2016-09-25
Chhimek Laghubitta Bikas Bank Limited,18,1970,1840,1950,1995,3783499,1876,74,2016-09-26
Chhimek Laghubitta Bikas Bank Limited,12,2080,2007,2028,1448,2972126,1950,78,2016-09-27
Chhimek Laghubitta Bikas Bank Limited,6,2000,1970,1975,1698,3382096,2028,-53,2016-09-28
Chhimek Laghubitta Bikas Bank Limited,40,1975,1870,1890,6086,11654370,1975,-85,2016-09-29
Chhimek Laghubitta Bikas Bank Limited,35,1900,1865,1874,2764,5181212,1890,-16,2016-10-02
Chhimek Laghubitta Bikas Bank Limited,11,1899,1880,1885,2228,4214853,1874,11,2016-10-03
Chhimek Laghubitta Bikas Bank Limited,28,1885,1840,1850,3863,7157340,1885,-35,2016-10-04
Chhimek Laghubitta Bikas Bank Limited,8,1871,1851,1870,582,1082517,1850,20,2016-10-05
Chhimek Laghubitta Bikas Bank Limited,8,1950,1885,1949,1078,2066469,1870,79,2016-10-06
Chhimek Laghubitta Bikas Bank Limited,13,1925,1850,1882,2554,4831351,1949,-67,2016-10-16
Chhimek Laghubitta Bikas Bank Limited,2,1880,1871,1871,139,261077,1882,-11,2016-10-17
Chhimek Laghubitta Bikas Bank Limited,7,1895,1861,1870,1223,2297771,1871,-1,2016-10-18
Chhimek Laghubitta Bikas Bank Limited,12,1907,1900,1900,1150,2189000,1870,30,2016-10-19
Chhimek Laghubitta Bikas Bank Limited,22,1900,1865,1895,3127,5901988,1900,-5,2016-10-20
Chhimek Laghubitta Bikas Bank Limited,7,1920,1880,1880,549,1042520,1895,-15,2016-10-23
Chhimek Laghubitta Bikas Bank Limited,13,1899,1870,1885,1502,2834123,1880,5,2016-10-24
Chhimek Laghubitta Bikas Bank Limited,18,1920,1850,1857,3185,5964540,1885,-28,2016-10-25
Chhimek Laghubitta Bikas Bank Limited,2,1850,1846,1850,200,369800,1857,-7,2016-10-26
Chhimek Laghubitta Bikas Bank Limited,49,1960,1885,1960,6363,12178055,1850,110,2016-10-27
Chhimek Laghubitta Bikas Bank Limited,216,2115,1999,2104,26916,55546908,1960,144,2016-11-03
Chhimek Laghubitta Bikas Bank Limited,69,2155,2098,2107,9194,19481938,2104,3,2016-11-07
Chhimek Laghubitta Bikas Bank Limited,48,2110,2050,2060,6490,13396125,2107,-47,2016-11-08
Chhimek Laghubitta Bikas Bank Limited,54,2060,1985,2020,6641,13372417,2060,-40,2016-11-09
Chhimek Laghubitta Bikas Bank Limited,28,2055,2020,2040,2807,5719180,2020,20,2016-11-10
Chhimek Laghubitta Bikas Bank Limited,11,2099,2031,2050,798,1635560,2040,10,2016-11-13
Chhimek Laghubitta Bikas Bank Limited,17,2055,2016,2050,2202,4469343,2050,0,2016-11-14
Chhimek Laghubitta Bikas Bank Limited,20,2050,2011,2026,2004,4087025,2050,-24,2016-11-15
Chhimek Laghubitta Bikas Bank Limited,17,2040,2000,2015,2401,4848305,2026,-11,2016-11-16
Chhimek Laghubitta Bikas Bank Limited,26,2019,1950,1967,2476,4903722,2015,-48,2016-11-17
Chhimek Laghubitta Bikas Bank Limited,47,1928,1801,1872,8416,15592348,1967,-95,2016-11-20
Chhimek Laghubitta Bikas Bank Limited,32,1924,1814,1850,4706,8777061,1872,-22,2016-11-21
Chhimek Laghubitta Bikas Bank Limited,25,1871,1839,1839,2132,3947500,1850,-11,2016-11-22
Chhimek Laghubitta Bikas Bank Limited,31,1850,1785,1795,2768,5034256,1839,-44,2016-11-23
Chhimek Laghubitta Bikas Bank Limited,37,1866,1720,1740,3779,6624614,1795,-55,2016-11-24
Chhimek Laghubitta Bikas Bank Limited,78,1706,1566,1567,6654,10573006,1740,-173,2016-11-27
Chhimek Laghubitta Bikas Bank Limited,63,1723,1411,1669,7666,11659295,1567,102,2016-11-28
Chhimek Laghubitta Bikas Bank Limited,55,1770,1625,1770,5227,8756227,1669,101,2016-11-29
Chhimek Laghubitta Bikas Bank Limited,63,1816,1725,1816,6741,12026645,1770,46,2016-11-30
Chhimek Laghubitta Bikas Bank Limited,55,1840,1721,1770,4721,8404267,1816,-46,2016-12-01
Chhimek Laghubitta Bikas Bank Limited,68,1825,1730,1790,7558,13414084,1770,20,2016-12-04
Chhimek Laghubitta Bikas Bank Limited,40,1825,1746,1755,2583,4581485,1790,-35,2016-12-05
Chhimek Laghubitta Bikas Bank Limited,26,1790,1755,1770,2789,4934933,1755,15,2016-12-06
Chhimek Laghubitta Bikas Bank Limited,57,1805,1750,1751,5324,9405182,1770,-19,2016-12-07
Chhimek Laghubitta Bikas Bank Limited,201,1760,1716,1755,18701,32477867,1751,4,2016-12-08
Chhimek Laghubitta Bikas Bank Limited,47,1250,1195,1200,3320,4014815,1254,-54,2016-12-11
Chhimek Laghubitta Bikas Bank Limited,19,1180,1157,1180,1037,1215620,1200,-20,2016-12-12
Chhimek Laghubitta Bikas Bank Limited,18,1180,1168,1170,1973,2308998,1180,-10,2016-12-14
Chhimek Laghubitta Bikas Bank Limited,17,1200,1150,1200,2387,2822303,1170,30,2016-12-15
Chhimek Laghubitta Bikas Bank Limited,23,1200,1160,1160,3128,3651430,1200,-40,2016-12-18
Chhimek Laghubitta Bikas Bank Limited,12,1169,1150,1150,550,637620,1160,-10,2016-12-19
Chhimek Laghubitta Bikas Bank Limited,5,1152,1132,1140,300,343300,1150,-10,2016-12-20
Chhimek Laghubitta Bikas Bank Limited,4,1150,1140,1142,330,378160,1140,2,2016-12-21
Chhimek Laghubitta Bikas Bank Limited,16,1164,1120,1120,1180,1348180,1142,-22,2016-12-22
Chhimek Laghubitta Bikas Bank Limited,14,1098,1061,1070,1093,1171013,1120,-50,2016-12-26
Chhimek Laghubitta Bikas Bank Limited,23,1055,1026,1026,1449,1513530,1070,-44,2016-12-27
Chhimek Laghubitta Bikas Bank Limited,14,1050,1006,1046,1003,1037048,1026,20,2016-12-28
Chhimek Laghubitta Bikas Bank Limited,20,1090,1055,1080,1599,1730770,1046,34,2016-12-29
Chhimek Laghubitta Bikas Bank Limited,26,1166,1100,1136,2236,2550040,1080,56,2017-01-01
Chhimek Laghubitta Bikas Bank Limited,24,1170,1135,1159,2166,2491258,1136,23,2017-01-02
Chhimek Laghubitta Bikas Bank Limited,19,1138,1125,1125,1780,2018890,1159,-34,2017-01-03
Chhimek Laghubitta Bikas Bank Limited,4,1125,1125,1125,442,497250,1125,0,2017-01-04
Chhimek Laghubitta Bikas Bank Limited,6,1115,1111,1115,715,796825,1125,-10,2017-01-05
Chhimek Laghubitta Bikas Bank Limited,5,1120,1101,1120,350,388780,1115,5,2017-01-08
Chhimek Laghubitta Bikas Bank Limited,11,1150,1130,1141,954,1085398,1120,21,2017-01-09
Chhimek Laghubitta Bikas Bank Limited,18,1165,1137,1150,1292,1485700,1141,9,2017-01-10
Chhimek Laghubitta Bikas Bank Limited,6,1155,1140,1140,560,643000,1150,-10,2017-01-11
Chhimek Laghubitta Bikas Bank Limited,22,1148,1118,1140,2501,2835196,1140,0,2017-01-12
Chhimek Laghubitta Bikas Bank Limited,1,1140,1140,1140,50,57000,1140,0,2017-01-15
Chhimek Laghubitta Bikas Bank Limited,4,1125,1105,1105,320,357000,1140,-35,2017-01-16
Chhimek Laghubitta Bikas Bank Limited,24,1100,1076,1076,2286,2472500,1105,-29,2017-01-17
Chhimek Laghubitta Bikas Bank Limited,5,1100,1080,1080,350,379000,1076,4,2017-01-18
Chhimek Laghubitta Bikas Bank Limited,8,1090,1061,1082,508,547380,1080,2,2017-01-19
Chhimek Laghubitta Bikas Bank Limited,17,1061,1041,1041,1725,1818080,1082,-41,2017-01-22
Chhimek Laghubitta Bikas Bank Limited,5,1040,1031,1040,299,309628,1041,-1,2017-01-23
Chhimek Laghubitta Bikas Bank Limited,17,1042,1002,1002,880,895960,1040,-38,2017-01-24
Chhimek Laghubitta Bikas Bank Limited,26,1000,980,980,2015,1983460,1002,-22,2017-01-25
Chhimek Laghubitta Bikas Bank Limited,22,1001,962,971,1964,1919648,980,-9,2017-01-26
Chhimek Laghubitta Bikas Bank Limited,17,975,895,895,1790,1679890,971,-76,2017-01-30
Chhimek Laghubitta Bikas Bank Limited,24,912,829,860,2950,2550770,895,-35,2017-01-31
Chhimek Laghubitta Bikas Bank Limited,9,946,875,946,690,635120,860,86,2017-02-01
Chhimek Laghubitta Bikas Bank Limited,55,1010,945,990,5722,5553317,946,44,2017-02-02
Chhimek Laghubitta Bikas Bank Limited,9,990,970,973,1020,999120,990,-17,2017-02-05
Chhimek Laghubitta Bikas Bank Limited,12,970,941,970,874,839250,973,-3,2017-02-06
Chhimek Laghubitta Bikas Bank Limited,15,980,955,965,1120,1086510,970,-5,2017-02-07
Chhimek Laghubitta Bikas Bank Limited,29,965,932,932,2301,2192066,965,-33,2017-02-08
Chhimek Laghubitta Bikas Bank Limited,30,958,914,914,2040,1894820,932,-18,2017-02-09
Chhimek Laghubitta Bikas Bank Limited,22,919,890,891,2843,2548820,914,-23,2017-02-12
Chhimek Laghubitta Bikas Bank Limited,6,908,874,908,270,236830,891,17,2017-02-13
Chhimek Laghubitta Bikas Bank Limited,12,926,900,920,720,659900,908,12,2017-02-14
Chhimek Laghubitta Bikas Bank Limited,19,994,920,990,1796,1717842,920,70,2017-02-15
Chhimek Laghubitta Bikas Bank Limited,31,1005,982,1005,1966,1960173,990,15,2017-02-16
Chhimek Laghubitta Bikas Bank Limited,20,1060,1000,1060,1779,1808590,1005,55,2017-02-19
Chhimek Laghubitta Bikas Bank Limited,41,1101,999,999,3365,3636820,1060,-61,2017-02-20
Chhimek Laghubitta Bikas Bank Limited,38,1045,990,1000,3779,3858945,999,1,2017-02-21
Chhimek Laghubitta Bikas Bank Limited,13,1009,980,999,1165,1166095,1000,-1,2017-02-22
Chhimek Laghubitta Bikas Bank Limited,12,1000,961,961,675,664810,999,-38,2017-02-23
Chhimek Laghubitta Bikas Bank Limited,26,950,918,935,2128,1980092,961,-26,2017-02-28
Chhimek Laghubitta Bikas Bank Limited,12,991,930,991,961,913350,935,56,2017-03-01
Chhimek Laghubitta Bikas Bank Limited,17,1004,980,1000,1430,1424030,991,9,2017-03-02
Chhimek Laghubitta Bikas Bank Limited,9,1020,990,1020,548,551990,1000,20,2017-03-05
Chhimek Laghubitta Bikas Bank Limited,59,1232,1080,1232,5910,6894638,1120,112,2017-03-21
Chhimek Laghubitta Bikas Bank Limited,18,1045,1000,1000,1375,1390800,1020,-20,2017-03-06
Chhimek Laghubitta Bikas Bank Limited,22,1020,980,980,2405,2374735,1000,-20,2017-03-07
Chhimek Laghubitta Bikas Bank Limited,10,1005,981,990,577,576150,980,10,2017-03-09
Chhimek Laghubitta Bikas Bank Limited,6,1000,986,999,497,496053,990,9,2017-03-13
Chhimek Laghubitta Bikas Bank Limited,15,1018,990,1010,1710,1718612,999,11,2017-03-14
Chhimek Laghubitta Bikas Bank Limited,7,1019,999,1000,1250,1255000,1010,-10,2017-03-15
Chhimek Laghubitta Bikas Bank Limited,5,999,980,995,295,291530,1000,-5,2017-03-16
Chhimek Laghubitta Bikas Bank Limited,15,1028,1000,1028,1538,1560992,995,33,2017-03-19
Chhimek Laghubitta Bikas Bank Limited,34,1120,1040,1120,2663,2894631,1028,92,2017-03-20
Chhimek Laghubitta Bikas Bank Limited,128,1355,1250,1269,15504,20395728,1232,37,2017-03-22
Chhimek Laghubitta Bikas Bank Limited,42,1309,1250,1270,4820,6148714,1269,1,2017-03-23
Chhimek Laghubitta Bikas Bank Limited,58,1368,1270,1323,5849,7741207,1270,53,2017-03-26
Chhimek Laghubitta Bikas Bank Limited,68,1446,1325,1446,7144,10004883,1323,123,2017-03-28
Chhimek Laghubitta Bikas Bank Limited,124,1500,1410,1410,13324,19363210,1446,-36,2017-03-29
Chhimek Laghubitta Bikas Bank Limited,61,1430,1340,1390,5173,7187956,1410,-20,2017-03-30
Chhimek Laghubitta Bikas Bank Limited,66,1525,1417,1525,9477,14125500,1390,135,2017-04-02
Chhimek Laghubitta Bikas Bank Limited,133,1600,1489,1508,23054,35521946,1525,-17,2017-04-03
Chhimek Laghubitta Bikas Bank Limited,67,1515,1450,1500,6424,9613582,1508,-8,2017-04-04
Chhimek Laghubitta Bikas Bank Limited,88,1515,1470,1472,9720,14540669,1500,-28,2017-04-06
Chhimek Laghubitta Bikas Bank Limited,68,1510,1445,1510,7800,11608817,1472,38,2017-04-09
Chhimek Laghubitta Bikas Bank Limited,175,1640,1480,1600,23577,37584746,1510,90,2017-04-10
Chhimek Laghubitta Bikas Bank Limited,144,1688,1580,1688,21180,34801767,1600,88,2017-04-11
Chhimek Laghubitta Bikas Bank Limited,125,1780,1650,1650,15631,26902507,1688,-38,2017-04-12
Chhimek Laghubitta Bikas Bank Limited,126,1713,1600,1675,17248,28349562,1650,25,2017-04-13
Chhimek Laghubitta Bikas Bank Limited,47,1690,1580,1580,5071,8230348,1675,-95,2017-04-16
Chhimek Laghubitta Bikas Bank Limited,107,1589,1491,1525,12042,18487796,1580,-55,2017-04-18
Chhimek Laghubitta Bikas Bank Limited,78,1635,1524,1630,9444,15039228,1525,105,2017-04-19
Chhimek Laghubitta Bikas Bank Limited,129,1695,1610,1630,15166,25179718,1630,0,2017-04-20
Chhimek Laghubitta Bikas Bank Limited,80,1762,1640,1670,10570,17706315,1630,40,2017-04-23
Chhimek Laghubitta Bikas Bank Limited,69,1703,1610,1620,9349,15245684,1670,-50,2017-04-24
Chhimek Laghubitta Bikas Bank Limited,61,1654,1600,1616,14382,23176020,1620,-4,2017-04-25
Chhimek Laghubitta Bikas Bank Limited,64,1650,1604,1630,10743,17484745,1616,14,2017-04-26
Chhimek Laghubitta Bikas Bank Limited,74,1660,1600,1630,12693,20504842,1630,0,2017-04-27
Chhimek Laghubitta Bikas Bank Limited,45,1630,1576,1600,6141,9852519,1630,-30,2017-04-30
Chhimek Laghubitta Bikas Bank Limited,78,1620,1580,1614,12210,19596926,1600,14,2017-05-02
Chhimek Laghubitta Bikas Bank Limited,42,1678,1605,1605,3905,6347151,1614,-9,2017-05-03
Chhimek Laghubitta Bikas Bank Limited,45,1611,1600,1601,4078,6535495,1605,-4,2017-05-04
Chhimek Laghubitta Bikas Bank Limited,79,1633,1585,1597,5797,9272920,1601,-4,2017-05-07
Chhimek Laghubitta Bikas Bank Limited,57,1609,1561,1595,5584,8905269,1597,-2,2017-05-08
Chhimek Laghubitta Bikas Bank Limited,45,1635,1595,1635,4109,6614967,1595,40,2017-05-09
Chhimek Laghubitta Bikas Bank Limited,64,1655,1620,1650,8705,14261333,1635,15,2017-05-11
Chhimek Laghubitta Bikas Bank Limited,106,1700,1630,1679,22050,36882691,1650,29,2017-05-15
Chhimek Laghubitta Bikas Bank Limited,39,1680,1660,1665,5253,8785872,1679,-14,2017-05-16
Chhimek Laghubitta Bikas Bank Limited,24,1653,1642,1653,3015,4963060,1665,-12,2017-05-17
Chhimek Laghubitta Bikas Bank Limited,42,1660,1640,1660,5532,9150006,1653,7,2017-05-18
Chhimek Laghubitta Bikas Bank Limited,16,1658,1635,1637,2125,3497535,1660,-23,2017-05-21
Chhimek Laghubitta Bikas Bank Limited,31,1635,1602,1620,4833,7828264,1637,-17,2017-05-22
Chhimek Laghubitta Bikas Bank Limited,44,1639,1601,1623,7114,11571297,1620,3,2017-05-23
Chhimek Laghubitta Bikas Bank Limited,30,1648,1601,1644,5316,8578107,1623,21,2017-05-24
Chhimek Laghubitta Bikas Bank Limited,61,1625,1600,1600,6281,10107906,1644,-44,2017-05-28
Chhimek Laghubitta Bikas Bank Limited,66,1611,1580,1585,8938,14326822,1600,-15,2017-05-30
Chhimek Laghubitta Bikas Bank Limited,70,1619,1540,1590,6764,10616933,1585,5,2017-05-31
Chhimek Laghubitta Bikas Bank Limited,38,1620,1585,1585,7297,11638855,1590,-5,2017-06-01
Chhimek Laghubitta Bikas Bank Limited,19,1596,1560,1595,2467,3888995,1585,10,2017-06-04
Chhimek Laghubitta Bikas Bank Limited,12,1626,1591,1591,923,1482148,1595,-4,2017-06-05
Chhimek Laghubitta Bikas Bank Limited,62,1625,1595,1625,13167,21128872,1591,34,2017-06-06
Chhimek Laghubitta Bikas Bank Limited,37,1625,1600,1601,2753,4429058,1625,-24,2017-06-07
Chhimek Laghubitta Bikas Bank Limited,30,1612,1595,1604,3259,5235847,1601,3,2017-06-08
Chhimek Laghubitta Bikas Bank Limited,24,1586,1550,1572,3358,5267278,1604,-32,2017-06-11
Chhimek Laghubitta Bikas Bank Limited,35,1585,1550,1556,4657,7267541,1572,-16,2017-06-12
Chhimek Laghubitta Bikas Bank Limited,38,1565,1540,1540,3626,5632020,1556,-16,2017-06-13
Chhimek Laghubitta Bikas Bank Limited,29,1566,1516,1566,2126,3287787,1540,26,2017-06-14
Chhimek Laghubitta Bikas Bank Limited,37,1580,1550,1550,2721,4260030,1566,-16,2017-06-15
Chhimek Laghubitta Bikas Bank Limited,16,1555,1545,1545,1402,2171790,1550,-5,2017-06-18
Chhimek Laghubitta Bikas Bank Limited,31,1559,1515,1515,3187,4861697,1545,-30,2017-06-19
Chhimek Laghubitta Bikas Bank Limited,43,1525,1490,1510,4407,6671019,1515,-5,2017-06-20
Chhimek Laghubitta Bikas Bank Limited,23,1515,1492,1510,2943,4435397,1510,0,2017-06-21
Chhimek Laghubitta Bikas Bank Limited,26,1560,1520,1530,2376,3645580,1510,20,2017-06-22
Chhimek Laghubitta Bikas Bank Limited,29,1560,1532,1543,2480,3824562,1530,13,2017-06-25
Chhimek Laghubitta Bikas Bank Limited,19,1555,1536,1541,1869,2893044,1543,-2,2017-06-27
Chhimek Laghubitta Bikas Bank Limited,9,1541,1511,1522,1180,1791200,1541,-19,2017-06-28
Chhimek Laghubitta Bikas Bank Limited,30,1522,1502,1503,2397,3615203,1522,-19,2017-07-02
Chhimek Laghubitta Bikas Bank Limited,20,1530,1505,1505,981,1492362,1503,2,2017-07-03
Chhimek Laghubitta Bikas Bank Limited,13,1515,1506,1515,1198,1809954,1505,10,2017-07-04
Chhimek Laghubitta Bikas Bank Limited,16,1530,1509,1530,1091,1651800,1515,15,2017-07-05
Chhimek Laghubitta Bikas Bank Limited,48,1579,1518,1560,6076,9400970,1530,30,2017-07-06
Chhimek Laghubitta Bikas Bank Limited,70,1618,1506,1560,6530,10202758,1560,0,2017-07-09
Chhimek Laghubitta Bikas Bank Limited,20,1591,1540,1540,1167,1815018,1560,-20,2017-07-10
Chhimek Laghubitta Bikas Bank Limited,23,1548,1510,1536,2255,3464944,1540,-4,2017-07-11
Chhimek Laghubitta Bikas Bank Limited,24,1541,1516,1536,3549,5413591,1536,0,2017-07-12
Chhimek Laghubitta Bikas Bank Limited,33,1536,1510,1525,3816,5789531,1536,-11,2017-07-13
Chhimek Laghubitta Bikas Bank Limited,8,1558,1525,1558,1791,2738122,1525,33,2017-07-16
Chhimek Laghubitta Bikas Bank Limited,33,1575,1530,1567,2478,3878767,1558,9,2017-07-17
Chhimek Laghubitta Bikas Bank Limited,56,1600,1571,1599,6472,10263228,1567,32,2017-07-18
Chhimek Laghubitta Bikas Bank Limited,97,1719,1683,1689,13025,22006175,1700,-11,2017-08-03
Chhimek Laghubitta Bikas Bank Limited,34,1610,1580,1580,3190,5085731,1599,-19,2017-07-19
Chhimek Laghubitta Bikas Bank Limited,19,1594,1581,1591,1415,2247045,1580,11,2017-07-20
Chhimek Laghubitta Bikas Bank Limited,32,1605,1581,1581,3213,5125108,1591,-10,2017-07-23
Chhimek Laghubitta Bikas Bank Limited,21,1590,1573,1580,1235,1955695,1581,-1,2017-07-24
Chhimek Laghubitta Bikas Bank Limited,30,1600,1565,1580,6539,10389211,1580,0,2017-07-25
Chhimek Laghubitta Bikas Bank Limited,41,1611,1590,1590,5970,9540244,1580,10,2017-07-26
Chhimek Laghubitta Bikas Bank Limited,77,1680,1590,1645,10420,16993132,1590,55,2017-07-27
Chhimek Laghubitta Bikas Bank Limited,54,1655,1590,1650,5927,9728060,1645,5,2017-07-30
Chhimek Laghubitta Bikas Bank Limited,54,1669,1632,1632,4866,8021684,1650,-18,2017-07-31
Chhimek Laghubitta Bikas Bank Limited,111,1670,1645,1668,14068,23364304,1632,36,2017-08-01
Chhimek Laghubitta Bikas Bank Limited,112,1700,1664,1700,15224,25664089,1668,32,2017-08-02
Chhimek Laghubitta Bikas Bank Limited,48,1695,1643,1679,5733,9571337,1689,-10,2017-08-06
Chhimek Laghubitta Bikas Bank Limited,34,1700,1665,1673,6067,10147394,1679,-6,2017-08-07
Chhimek Laghubitta Bikas Bank Limited,33,1675,1660,1670,3493,5832440,1673,-3,2017-08-09
Chhimek Laghubitta Bikas Bank Limited,76,1690,1658,1666,6501,10864003,1670,-4,2017-08-10
Chhimek Laghubitta Bikas Bank Limited,33,1660,1636,1645,3527,5810493,1666,-21,2017-08-13
Chhimek Laghubitta Bikas Bank Limited,67,1640,1600,1600,7452,11974250,1645,-45,2017-08-15
Chhimek Laghubitta Bikas Bank Limited,78,1625,1595,1600,6952,11198610,1600,0,2017-08-16
Chhimek Laghubitta Bikas Bank Limited,17,1630,1600,1630,1334,2148100,1600,30,2017-08-17
Chhimek Laghubitta Bikas Bank Limited,42,1620,1585,1605,4309,6914541,1630,-25,2017-08-20
Chhimek Laghubitta Bikas Bank Limited,26,1610,1590,1590,2827,4524033,1605,-15,2017-08-21
Chhimek Laghubitta Bikas Bank Limited,27,1625,1590,1610,4166,6715068,1590,20,2017-08-22
Chhimek Laghubitta Bikas Bank Limited,22,1630,1595,1597,1404,2255397,1610,-13,2017-08-23
Chhimek Laghubitta Bikas Bank Limited,26,1632,1600,1632,2588,4185810,1597,35,2017-08-24
Chhimek Laghubitta Bikas Bank Limited,86,1667,1632,1665,10695,17687865,1632,33,2017-08-27
Chhimek Laghubitta Bikas Bank Limited,315,1730,1668,1715,37349,63482696,1665,50,2017-08-28
Chhimek Laghubitta Bikas Bank Limited,317,1752,1715,1730,37820,65505167,1715,15,2017-08-30
Chhimek Laghubitta Bikas Bank Limited,166,1729,1691,1700,22004,37592249,1730,-30,2017-08-31
Chhimek Laghubitta Bikas Bank Limited,108,1700,1655,1660,10338,17287259,1700,-40,2017-09-04
Chhimek Laghubitta Bikas Bank Limited,76,1695,1666,1690,17721,29877058,1660,30,2017-09-06
Chhimek Laghubitta Bikas Bank Limited,88,1700,1680,1690,12590,21242582,1690,0,2017-09-07
Chhimek Laghubitta Bikas Bank Limited,171,1657,1521,1521,17382,26497507,1690,-169,2017-09-10
Chhimek Laghubitta Bikas Bank Limited,142,1515,1433,1490,17683,26237338,1521,-31,2017-09-11
Chhimek Laghubitta Bikas Bank Limited,61,1480,1446,1446,5114,7484760,1490,-44,2017-09-12
Chhimek Laghubitta Bikas Bank Limited,34,1474,1418,1427,3603,5176612,1446,-19,2017-09-13
Chhimek Laghubitta Bikas Bank Limited,48,1475,1426,1460,5223,7501585,1427,33,2017-09-14
Chhimek Laghubitta Bikas Bank Limited,28,1489,1440,1480,3810,5564634,1460,20,2017-09-17
Chhimek Laghubitta Bikas Bank Limited,22,1488,1460,1470,3870,5681400,1480,-10,2017-09-18
Chhimek Laghubitta Bikas Bank Limited,16,1450,1426,1450,1057,1525308,1470,-20,2017-09-20
Chhimek Laghubitta Bikas Bank Limited,11,1428,1390,1390,1302,1825360,1400,-10,2017-10-09
Chhimek Laghubitta Bikas Bank Limited,11,1479,1465,1465,1472,2170400,1450,15,2017-09-24
Chhimek Laghubitta Bikas Bank Limited,14,1470,1465,1465,1257,1846945,1465,0,2017-09-25
Chhimek Laghubitta Bikas Bank Limited,3,1474,1467,1472,252,370534,1465,7,2017-09-26
Chhimek Laghubitta Bikas Bank Limited,3,1485,1470,1485,302,445210,1472,13,2017-10-03
Chhimek Laghubitta Bikas Bank Limited,16,1465,1437,1438,1170,1691190,1485,-47,2017-10-04
Chhimek Laghubitta Bikas Bank Limited,15,1425,1378,1400,913,1279554,1438,-38,2017-10-08
Chhimek Laghubitta Bikas Bank Limited,18,1417,1388,1390,1175,1639340,1390,0,2017-10-10
Chhimek Laghubitta Bikas Bank Limited,33,1405,1381,1395,1604,2236985,1390,5,2017-10-11
Chhimek Laghubitta Bikas Bank Limited,17,1400,1385,1390,1230,1713158,1395,-5,2017-10-12
Chhimek Laghubitta Bikas Bank Limited,36,1405,1390,1390,4390,6148593,1390,0,2017-10-15
Chhimek Laghubitta Bikas Bank Limited,37,1460,1370,1455,5248,7334310,1390,65,2017-10-16
Chhimek Laghubitta Bikas Bank Limited,42,1469,1426,1440,4226,6103815,1455,-15,2017-10-17
Chhimek Laghubitta Bikas Bank Limited,39,1460,1430,1450,3084,4455254,1440,10,2017-10-18
Chhimek Laghubitta Bikas Bank Limited,110,1479,1443,1445,10352,15022491,1450,-5,2017-10-22
Chhimek Laghubitta Bikas Bank Limited,80,1250,1194,1234,5803,7029318,1205,29,2017-10-23
Chhimek Laghubitta Bikas Bank Limited,20,1220,1187,1187,725,878740,1234,-47,2017-10-24
Chhimek Laghubitta Bikas Bank Limited,28,1185,1162,1180,1468,1718024,1187,-7,2017-10-25
Chhimek Laghubitta Bikas Bank Limited,24,1170,1146,1146,1947,2254142,1180,-34,2017-10-29
Chhimek Laghubitta Bikas Bank Limited,29,1144,1130,1140,3365,3813845,1146,-6,2017-10-30
Chhimek Laghubitta Bikas Bank Limited,7,1140,1126,1126,400,451200,1140,-14,2017-10-31
Chhimek Laghubitta Bikas Bank Limited,6,1125,1118,1120,680,761490,1126,-6,2017-11-01
Chhimek Laghubitta Bikas Bank Limited,37,1125,1100,1123,4419,4916760,1120,3,2017-11-02
Chhimek Laghubitta Bikas Bank Limited,26,1120,1097,1105,2590,2851180,1123,-18,2017-11-05
Chhimek Laghubitta Bikas Bank Limited,28,1120,1070,1070,4340,4741250,1105,-35,2017-11-06
Chhimek Laghubitta Bikas Bank Limited,24,1106,1072,1075,917,993582,1070,5,2017-11-07
Chhimek Laghubitta Bikas Bank Limited,29,1075,1033,1042,2470,2600665,1075,-33,2017-11-08
Chhimek Laghubitta Bikas Bank Limited,25,1100,1040,1078,2153,2290660,1042,36,2017-11-09
Chhimek Laghubitta Bikas Bank Limited,43,1098,1028,1071,3407,3567314,1078,-7,2017-11-12
Chhimek Laghubitta Bikas Bank Limited,33,1091,1065,1077,2675,2867825,1071,6,2017-11-13
Chhimek Laghubitta Bikas Bank Limited,71,1137,1080,1127,7512,8384918,1077,50,2017-11-14
Chhimek Laghubitta Bikas Bank Limited,72,1162,1125,1135,6875,7799790,1127,8,2017-11-15
Chhimek Laghubitta Bikas Bank Limited,21,1125,1078,1112,2310,2540960,1135,-23,2017-11-16
Chhimek Laghubitta Bikas Bank Limited,25,1110,1066,1110,1670,1799820,1112,-2,2017-11-19
Chhimek Laghubitta Bikas Bank Limited,11,1120,1080,1094,1178,1290132,1110,-16,2017-11-20
Chhimek Laghubitta Bikas Bank Limited,14,1100,1090,1094,1235,1355040,1094,0,2017-11-21
Chhimek Laghubitta Bikas Bank Limited,26,1100,1088,1091,2232,2440813,1094,-3,2017-11-22
Chhimek Laghubitta Bikas Bank Limited,13,1110,1090,1100,1290,1413500,1091,9,2017-11-23
Chhimek Laghubitta Bikas Bank Limited,13,1132,1108,1120,1485,1657190,1100,20,2017-11-26
Chhimek Laghubitta Bikas Bank Limited,9,1121,1100,1120,360,402400,1120,0,2017-11-27
Chhimek Laghubitta Bikas Bank Limited,24,1115,1095,1095,3635,3993720,1120,-25,2017-11-28
Chhimek Laghubitta Bikas Bank Limited,25,1134,1094,1112,2514,2816289,1095,17,2017-11-29
Chhimek Laghubitta Bikas Bank Limited,32,1134,1113,1130,3683,4132514,1112,18,2017-11-30
Chhimek Laghubitta Bikas Bank Limited,16,1152,1100,1100,1240,1371350,1130,-30,2017-12-04
Chhimek Laghubitta Bikas Bank Limited,12,1080,1060,1075,920,987963,1070,5,2017-12-20
Chhimek Laghubitta Bikas Bank Limited,5,1130,1100,1130,563,624850,1100,30,2017-12-05
Chhimek Laghubitta Bikas Bank Limited,11,1144,1130,1130,800,910370,1130,0,2017-12-06
Chhimek Laghubitta Bikas Bank Limited,35,1173,1100,1100,3747,4200240,1130,-30,2017-12-10
Chhimek Laghubitta Bikas Bank Limited,8,1121,1110,1120,402,449862,1100,20,2017-12-11
Chhimek Laghubitta Bikas Bank Limited,15,1112,1100,1100,1886,2082074,1120,-20,2017-12-12
Chhimek Laghubitta Bikas Bank Limited,11,1115,1100,1101,1689,1866687,1100,1,2017-12-13
Chhimek Laghubitta Bikas Bank Limited,1,1101,1101,1101,100,110100,1101,0,2017-12-14
Chhimek Laghubitta Bikas Bank Limited,9,1101,1095,1095,1794,1973312,1101,-6,2017-12-17
Chhimek Laghubitta Bikas Bank Limited,28,1109,1080,1080,2004,2181880,1095,-15,2017-12-18
Chhimek Laghubitta Bikas Bank Limited,15,1090,1070,1070,1430,1535470,1080,-10,2017-12-19
Chhimek Laghubitta Bikas Bank Limited,17,1075,1060,1060,746,795160,1075,-15,2017-12-21
Chhimek Laghubitta Bikas Bank Limited,24,1081,1060,1060,5494,5846102,1060,0,2017-12-24
Chhimek Laghubitta Bikas Bank Limited,24,1055,1035,1035,2511,2620634,1060,-25,2017-12-26
Chhimek Laghubitta Bikas Bank Limited,45,1050,1015,1020,3098,3188629,1035,-15,2017-12-27
Chhimek Laghubitta Bikas Bank Limited,24,1040,1000,1000,1700,1727710,1020,-20,2017-12-28
Chhimek Laghubitta Bikas Bank Limited,23,999,975,980,5243,5150517,1000,-20,2017-12-31
Chhimek Laghubitta Bikas Bank Limited,12,1035,990,1035,625,633940,980,55,2018-01-01
Chhimek Laghubitta Bikas Bank Limited,27,1044,1000,1000,3815,3887850,1035,-35,2018-01-02
Chhimek Laghubitta Bikas Bank Limited,20,1009,993,995,1597,1590251,1000,-5,2018-01-03
Chhimek Laghubitta Bikas Bank Limited,7,1035,990,1035,664,664950,995,40,2018-01-04
Chhimek Laghubitta Bikas Bank Limited,2,1040,1040,1040,125,130000,1035,5,2018-01-07
Chhimek Laghubitta Bikas Bank Limited,10,1040,1020,1030,732,752262,1040,-10,2018-01-08
Chhimek Laghubitta Bikas Bank Limited,19,1060,1035,1060,1269,1331318,1030,30,2018-01-09
Chhimek Laghubitta Bikas Bank Limited,16,1045,1031,1031,1187,1227947,1060,-29,2018-01-10
Chhimek Laghubitta Bikas Bank Limited,7,1030,1010,1020,425,431620,1031,-11,2018-01-14
Chhimek Laghubitta Bikas Bank Limited,28,1019,999,1015,2869,2885040,1020,-5,2018-01-16
Chhimek Laghubitta Bikas Bank Limited,14,1010,995,1000,860,860800,1015,-15,2018-01-17
Chhimek Laghubitta Bikas Bank Limited,7,1002,1000,1000,617,617602,1000,0,2018-01-21
Chhimek Laghubitta Bikas Bank Limited,9,1002,997,997,724,723900,1000,-3,2018-01-22
Chhimek Laghubitta Bikas Bank Limited,11,1005,994,1001,1754,1751062,997,4,2018-01-23
Chhimek Laghubitta Bikas Bank Limited,12,1000,990,1000,1067,1061680,1001,-1,2018-01-24
Chhimek Laghubitta Bikas Bank Limited,9,1020,1000,1020,1585,1586922,1000,20,2018-01-25
Chhimek Laghubitta Bikas Bank Limited,12,1015,1005,1012,1664,1677102,1020,-8,2018-01-28
Chhimek Laghubitta Bikas Bank Limited,8,1020,1000,1020,220,220400,1012,8,2018-01-29
Chhimek Laghubitta Bikas Bank Limited,22,1025,998,1025,2170,2205948,1020,5,2018-01-31
Chhimek Laghubitta Bikas Bank Limited,22,1035,1027,1027,1746,1799620,1025,2,2018-02-01
Chhimek Laghubitta Bikas Bank Limited,23,1030,1015,1020,3495,3552100,1027,-7,2018-02-04
Chhimek Laghubitta Bikas Bank Limited,15,1040,1000,1005,920,928090,1020,-15,2018-02-05
Chhimek Laghubitta Bikas Bank Limited,47,1008,995,997,6995,6986195,1005,-8,2018-02-06
Chhimek Laghubitta Bikas Bank Limited,17,995,986,995,1554,1539690,997,-2,2018-02-07
Chhimek Laghubitta Bikas Bank Limited,8,1015,995,1015,469,471455,995,20,2018-02-08
Chhimek Laghubitta Bikas Bank Limited,35,996,985,986,1982,1964694,1000,-14,2018-02-25
Chhimek Laghubitta Bikas Bank Limited,12,1020,995,995,610,608150,1015,-20,2018-02-11
Chhimek Laghubitta Bikas Bank Limited,14,1020,995,995,710,712940,995,0,2018-02-12
Chhimek Laghubitta Bikas Bank Limited,15,1014,995,1014,1150,1157320,995,19,2018-02-14
Chhimek Laghubitta Bikas Bank Limited,32,1045,1019,1044,2764,2853170,1014,30,2018-02-15
Chhimek Laghubitta Bikas Bank Limited,50,1064,1020,1020,4345,4494168,1044,-24,2018-02-18
Chhimek Laghubitta Bikas Bank Limited,20,1010,1000,1009,2272,2277404,1020,-11,2018-02-20
Chhimek Laghubitta Bikas Bank Limited,29,1010,998,1001,1477,1479290,1009,-8,2018-02-21
Chhimek Laghubitta Bikas Bank Limited,26,1010,993,1000,2005,2003863,1001,-1,2018-02-22
Chhimek Laghubitta Bikas Bank Limited,30,1000,975,976,1773,1743286,986,-10,2018-02-26
Chhimek Laghubitta Bikas Bank Limited,24,995,976,985,1725,1697973,976,9,2018-02-27
Chhimek Laghubitta Bikas Bank Limited,34,987,966,980,1570,1528030,985,-5,2018-02-28
Chhimek Laghubitta Bikas Bank Limited,58,979,927,940,5551,5216700,980,-40,2018-03-04
Chhimek Laghubitta Bikas Bank Limited,53,960,886,889,4075,3709499,940,-51,2018-03-05
Chhimek Laghubitta Bikas Bank Limited,54,907,872,900,6291,5565171,889,11,2018-03-06
Chhimek Laghubitta Bikas Bank Limited,39,921,890,910,2441,2221522,900,10,2018-03-07
Chhimek Laghubitta Bikas Bank Limited,26,900,890,900,2149,1924016,910,-10,2018-03-11
Chhimek Laghubitta Bikas Bank Limited,6,900,890,900,485,435500,900,0,2018-03-12
Chhimek Laghubitta Bikas Bank Limited,13,900,890,895,1959,1751767,900,-5,2018-03-13
Chhimek Laghubitta Bikas Bank Limited,18,903,890,899,1898,1707866,895,4,2018-03-14
Chhimek Laghubitta Bikas Bank Limited,26,904,900,901,4280,3858082,899,2,2018-03-15
Chhimek Laghubitta Bikas Bank Limited,17,909,899,901,3274,2948934,901,0,2018-03-18
Chhimek Laghubitta Bikas Bank Limited,15,902,896,900,1040,934980,901,-1,2018-03-19
Chhimek Laghubitta Bikas Bank Limited,41,900,860,870,3622,3159513,900,-30,2018-03-20
Chhimek Laghubitta Bikas Bank Limited,65,870,806,841,5119,4275688,870,-29,2018-03-21
Chhimek Laghubitta Bikas Bank Limited,34,840,800,825,2095,1726526,841,-16,2018-03-22
Chhimek Laghubitta Bikas Bank Limited,44,809,784,790,3016,2408073,825,-35,2018-03-26
Chhimek Laghubitta Bikas Bank Limited,43,833,733,815,2893,2228313,790,25,2018-03-27
Chhimek Laghubitta Bikas Bank Limited,50,837,785,800,4342,3504634,815,-15,2018-03-28
Chhimek Laghubitta Bikas Bank Limited,42,823,792,823,7116,5684032,800,23,2018-03-29
Chhimek Laghubitta Bikas Bank Limited,44,820,795,802,4732,3811485,823,-21,2018-04-01
Chhimek Laghubitta Bikas Bank Limited,15,805,795,800,870,695360,802,-2,2018-04-02
Chhimek Laghubitta Bikas Bank Limited,30,804,800,804,3248,2606580,800,4,2018-04-03
Chhimek Laghubitta Bikas Bank Limited,19,836,804,830,2126,1742218,804,26,2018-04-04
Chhimek Laghubitta Bikas Bank Limited,56,854,824,850,6835,5757559,830,20,2018-04-05
Chhimek Laghubitta Bikas Bank Limited,93,926,860,915,9153,8226081,850,65,2018-04-08
Chhimek Laghubitta Bikas Bank Limited,68,950,897,940,4990,4623830,915,25,2018-04-09
Chhimek Laghubitta Bikas Bank Limited,50,940,897,898,3170,2929429,940,-42,2018-04-10
Chhimek Laghubitta Bikas Bank Limited,42,910,885,888,2624,2341897,898,-10,2018-04-11
Chhimek Laghubitta Bikas Bank Limited,42,923,887,900,3871,3505982,888,12,2018-04-12
Chhimek Laghubitta Bikas Bank Limited,11,910,887,910,739,666723,900,10,2018-04-15
Chhimek Laghubitta Bikas Bank Limited,63,971,910,957,5762,5457309,910,47,2018-04-16
Chhimek Laghubitta Bikas Bank Limited,135,1050,965,1028,12560,12708608,957,71,2018-04-17
Chhimek Laghubitta Bikas Bank Limited,89,1060,1002,1045,7496,7769100,1028,17,2018-04-18
Chhimek Laghubitta Bikas Bank Limited,49,1045,1020,1040,6365,6570881,1045,-5,2018-04-19
Chhimek Laghubitta Bikas Bank Limited,56,1100,1040,1099,5547,5881493,1040,59,2018-04-22
Chhimek Laghubitta Bikas Bank Limited,122,1120,1030,1069,9899,10702332,1099,-30,2018-04-23
Chhimek Laghubitta Bikas Bank Limited,53,1080,1028,1059,8706,9166302,1069,-10,2018-04-24
Chhimek Laghubitta Bikas Bank Limited,16,1051,1042,1051,1601,1678558,1059,-8,2018-04-25
Chhimek Laghubitta Bikas Bank Limited,42,1045,1010,1025,2815,2866740,1051,-26,2018-04-26
Chhimek Laghubitta Bikas Bank Limited,52,1020,1000,1001,5082,5112596,1025,-24,2018-04-29
Chhimek Laghubitta Bikas Bank Limited,23,1044,981,1040,1965,1967295,1001,39,2018-05-02
Chhimek Laghubitta Bikas Bank Limited,59,1060,1026,1026,5857,6110137,1040,-14,2018-05-03
Chhimek Laghubitta Bikas Bank Limited,20,1045,1025,1030,1278,1313706,1026,4,2018-05-06
Chhimek Laghubitta Bikas Bank Limited,34,1016,1005,1015,5514,5588128,1030,-15,2018-05-07
Chhimek Laghubitta Bikas Bank Limited,22,1019,995,1018,2155,2178978,1015,3,2018-05-08
Chhimek Laghubitta Bikas Bank Limited,23,1038,1011,1011,2592,2642106,1018,-7,2018-05-09
Chhimek Laghubitta Bikas Bank Limited,6,1020,1003,1020,910,925614,1011,9,2018-05-10
Chhimek Laghubitta Bikas Bank Limited,22,1019,1010,1012,2458,2489759,1020,-8,2018-05-14
Chhimek Laghubitta Bikas Bank Limited,6,1025,1005,1006,201,203407,1012,-6,2018-05-15
Chhimek Laghubitta Bikas Bank Limited,23,1010,1000,1003,1447,1455461,1006,-3,2018-05-16
Chhimek Laghubitta Bikas Bank Limited,11,1010,1005,1010,606,611290,1003,7,2018-05-17
Chhimek Laghubitta Bikas Bank Limited,16,1030,1000,1003,1002,1015680,1010,-7,2018-05-20
Chhimek Laghubitta Bikas Bank Limited,13,1015,1000,1010,772,778495,1003,7,2018-05-21
Chhimek Laghubitta Bikas Bank Limited,11,1030,1001,1003,1204,1214543,1010,-7,2018-05-22
Chhimek Laghubitta Bikas Bank Limited Promoter Share,2,1100,1100,1100,17629,19391900,1110,-10,2016-08-04
Chhimek Laghubitta Bikas Bank Limited Promoter Share,1,500,500,500,2297,1148500,500,0,2018-03-11
Chhyangdi Hydropower Ltd.,33,323,294,323,775,244637,0,323,2017-08-03
Chhyangdi Hydropower Ltd.,519,355,300,316,10396,3333783,323,-7,2017-08-06
Chhyangdi Hydropower Ltd.,277,312,285,285,4374,1288178,316,-31,2017-08-07
Chhyangdi Hydropower Ltd.,117,280,257,260,5869,1515113,285,-25,2017-08-09
Chhyangdi Hydropower Ltd.,55,260,238,260,2022,506640,260,0,2017-08-10
Chhyangdi Hydropower Ltd.,24,257,239,243,379,92619,260,-17,2017-08-13
Chhyangdi Hydropower Ltd.,34,240,220,221,608,136848,243,-22,2017-08-15
Chhyangdi Hydropower Ltd.,28,227,217,217,528,117122,221,-4,2017-08-16
Chhyangdi Hydropower Ltd.,30,214,209,211,628,132194,217,-6,2017-08-17
Chhyangdi Hydropower Ltd.,41,215,207,210,700,146070,211,-1,2017-08-20
Chhyangdi Hydropower Ltd.,64,218,197,201,1788,372928,210,-9,2017-08-21
Chhyangdi Hydropower Ltd.,87,207,198,200,6521,1327556,201,-1,2017-08-22
Chhyangdi Hydropower Ltd.,64,199,187,187,3955,757350,200,-13,2017-08-23
Chhyangdi Hydropower Ltd.,41,195,181,195,4342,834660,187,8,2017-08-24
Chhyangdi Hydropower Ltd.,72,200,193,200,2006,391950,195,5,2017-08-27
Chhyangdi Hydropower Ltd.,25,201,195,201,280,55418,200,1,2017-08-28
Chhyangdi Hydropower Ltd.,20,202,197,197,1851,370363,201,-4,2017-08-30
Chhyangdi Hydropower Ltd.,31,196,188,195,487,94427,197,-2,2017-08-31
Chhyangdi Hydropower Ltd.,27,192,186,186,1582,299059,195,-9,2017-09-04
Chhyangdi Hydropower Ltd.,24,190,186,190,370,69632,186,4,2017-09-06
Chhyangdi Hydropower Ltd.,33,190,183,183,1146,211837,190,-7,2017-09-07
Chhyangdi Hydropower Ltd.,50,183,174,177,968,172121,183,-6,2017-09-10
Chhyangdi Hydropower Ltd.,15,175,166,166,179,30998,177,-11,2017-09-11
Chhyangdi Hydropower Ltd.,5,165,164,164,98,16116,166,-2,2017-09-12
Chhyangdi Hydropower Ltd.,11,163,156,163,184,29485,164,-1,2017-09-13
Chhyangdi Hydropower Ltd.,11,163,160,163,407,65918,163,0,2017-09-14
Chhyangdi Hydropower Ltd.,15,165,158,159,248,39778,163,-4,2017-09-17
Chhyangdi Hydropower Ltd.,20,165,157,163,603,97469,159,4,2017-09-18
Chhyangdi Hydropower Ltd.,8,165,161,161,131,21205,163,-2,2017-09-20
Chhyangdi Hydropower Ltd.,7,170,168,168,172,29084,173,-5,2017-10-09
Chhyangdi Hydropower Ltd.,9,163,158,163,618,99240,161,2,2017-09-24
Chhyangdi Hydropower Ltd.,3,169,166,169,80,13490,163,6,2017-09-25
Chhyangdi Hydropower Ltd.,22,179,169,175,1151,199407,169,6,2017-09-26
Chhyangdi Hydropower Ltd.,4,175,172,172,150,26148,175,-3,2017-10-03
Chhyangdi Hydropower Ltd.,4,172,172,172,40,6880,172,0,2017-10-04
Chhyangdi Hydropower Ltd.,7,173,166,173,94,15900,172,1,2017-10-08
Chhyangdi Hydropower Ltd.,18,168,163,168,228,37866,168,0,2017-10-10
Chhyangdi Hydropower Ltd.,3,168,165,168,76,12690,168,0,2017-10-11
Chhyangdi Hydropower Ltd.,6,174,168,173,92,15796,168,5,2017-10-12
Chhyangdi Hydropower Ltd.,11,176,171,176,352,61108,173,3,2017-10-15
Chhyangdi Hydropower Ltd.,26,185,179,185,541,97977,176,9,2017-10-16
Chhyangdi Hydropower Ltd.,17,196,183,196,1005,190129,185,11,2017-10-17
Chhyangdi Hydropower Ltd.,3,196,195,196,30,5870,196,0,2017-10-18
Chhyangdi Hydropower Ltd.,3,199,196,199,56,11054,196,3,2017-10-22
Chhyangdi Hydropower Ltd.,26,198,192,195,422,82204,199,-4,2017-10-23
Chhyangdi Hydropower Ltd.,23,205,195,205,888,176844,195,10,2017-10-24
Chhyangdi Hydropower Ltd.,41,213,201,201,1238,250886,205,-4,2017-10-25
Chhyangdi Hydropower Ltd.,2,199,197,199,20,3960,201,-2,2017-10-29
Chhyangdi Hydropower Ltd.,4,197,196,196,88,17258,199,-3,2017-10-30
Chhyangdi Hydropower Ltd.,13,195,190,195,351,67361,196,-1,2017-10-31
Chhyangdi Hydropower Ltd.,9,194,192,194,197,38188,195,-1,2017-11-01
Chhyangdi Hydropower Ltd.,7,194,190,190,258,49241,194,-4,2017-11-02
Chhyangdi Hydropower Ltd.,8,196,187,196,199,37756,190,6,2017-11-05
Chhyangdi Hydropower Ltd.,8,196,190,194,114,22000,196,-2,2017-11-06
Chhyangdi Hydropower Ltd.,2,191,188,188,20,3790,194,-6,2017-11-07
Chhyangdi Hydropower Ltd.,9,185,182,182,162,29616,188,-6,2017-11-08
Chhyangdi Hydropower Ltd.,16,185,173,185,378,68564,182,3,2017-11-09
Chhyangdi Hydropower Ltd.,7,182,178,181,142,25434,185,-4,2017-11-12
Chhyangdi Hydropower Ltd.,16,180,179,180,424,76266,181,-1,2017-11-13
Chhyangdi Hydropower Ltd.,19,180,175,180,871,155119,180,0,2017-11-14
Chhyangdi Hydropower Ltd.,12,181,178,178,225,40212,180,-2,2017-11-15
Chhyangdi Hydropower Ltd.,8,181,175,178,3014,536402,178,0,2017-11-16
Chhyangdi Hydropower Ltd.,9,175,172,175,1655,289259,178,-3,2017-11-19
Chhyangdi Hydropower Ltd.,6,178,176,176,60,10600,175,1,2017-11-20
Chhyangdi Hydropower Ltd.,40,177,171,175,514,89924,176,-1,2017-11-21
Chhyangdi Hydropower Ltd.,36,173,167,171,387,66229,175,-4,2017-11-22
Chhyangdi Hydropower Ltd.,16,170,170,170,168,28560,171,-1,2017-11-23
Chhyangdi Hydropower Ltd.,7,180,169,180,82,14266,170,10,2017-11-26
Chhyangdi Hydropower Ltd.,14,183,179,183,433,78206,180,3,2017-11-27
Chhyangdi Hydropower Ltd.,5,186,183,186,98,17984,183,3,2017-11-28
Chhyangdi Hydropower Ltd.,13,188,183,183,671,124860,186,-3,2017-11-29
Chhyangdi Hydropower Ltd.,18,188,180,188,333,61395,183,5,2017-11-30
Chhyangdi Hydropower Ltd.,23,185,180,181,386,70471,188,-7,2017-12-04
Chhyangdi Hydropower Ltd.,5,182,180,181,122,22106,183,-2,2017-12-20
Chhyangdi Hydropower Ltd.,27,186,180,186,365,66392,181,5,2017-12-05
Chhyangdi Hydropower Ltd.,39,204,186,200,1341,264141,186,14,2017-12-06
Chhyangdi Hydropower Ltd.,12,199,193,199,512,100696,200,-1,2017-12-10
Chhyangdi Hydropower Ltd.,7,196,191,191,94,18024,199,-8,2017-12-11
Chhyangdi Hydropower Ltd.,20,192,188,189,1884,358252,191,-2,2017-12-12
Chhyangdi Hydropower Ltd.,4,188,185,185,64,11900,189,-4,2017-12-13
Chhyangdi Hydropower Ltd.,13,185,182,184,130,23890,185,-1,2017-12-14
Chhyangdi Hydropower Ltd.,7,184,180,184,118,21518,184,0,2017-12-17
Chhyangdi Hydropower Ltd.,11,184,183,183,278,51040,184,-1,2017-12-18
Chhyangdi Hydropower Ltd.,7,184,181,183,70,12790,183,0,2017-12-19
Chhyangdi Hydropower Ltd.,17,184,178,184,573,105080,181,3,2017-12-21
Chhyangdi Hydropower Ltd.,7,181,172,172,70,12400,184,-12,2017-12-24
Chhyangdi Hydropower Ltd.,15,175,171,174,201,34797,172,2,2017-12-26
Chhyangdi Hydropower Ltd.,10,177,172,172,272,47064,174,-2,2017-12-27
Chhyangdi Hydropower Ltd.,12,173,170,171,172,29393,172,-1,2017-12-28
Chhyangdi Hydropower Ltd.,13,172,169,169,648,110446,171,-2,2017-12-31
Chhyangdi Hydropower Ltd.,11,178,170,175,154,26730,169,6,2018-01-01
Chhyangdi Hydropower Ltd.,18,183,172,180,1050,188760,175,5,2018-01-02
Chhyangdi Hydropower Ltd.,5,178,177,178,94,16688,180,-2,2018-01-03
Chhyangdi Hydropower Ltd.,12,181,175,181,299,53602,178,3,2018-01-04
Chhyangdi Hydropower Ltd.,7,185,180,183,238,43592,181,2,2018-01-07
Chhyangdi Hydropower Ltd.,9,184,183,183,560,103030,183,0,2018-01-08
Chhyangdi Hydropower Ltd.,9,183,181,181,141,25589,183,-2,2018-01-09
Chhyangdi Hydropower Ltd.,16,180,179,179,190,34160,181,-2,2018-01-10
Chhyangdi Hydropower Ltd.,3,180,178,178,45,8080,179,-1,2018-01-14
Chhyangdi Hydropower Ltd.,5,175,169,169,74,12788,178,-9,2018-01-16
Chhyangdi Hydropower Ltd.,13,171,166,171,154,25864,169,2,2018-01-17
Chhyangdi Hydropower Ltd.,22,176,171,173,271,46860,171,2,2018-01-21
Chhyangdi Hydropower Ltd.,4,170,167,170,40,6770,173,-3,2018-01-22
Chhyangdi Hydropower Ltd.,9,168,165,168,90,15070,170,-2,2018-01-23
Chhyangdi Hydropower Ltd.,10,175,170,175,105,18035,168,7,2018-01-24
Chhyangdi Hydropower Ltd.,13,174,172,172,135,23250,175,-3,2018-01-25
Chhyangdi Hydropower Ltd.,15,173,170,173,179,30552,172,1,2018-01-28
Chhyangdi Hydropower Ltd.,13,176,170,170,192,32980,173,-3,2018-01-29
Chhyangdi Hydropower Ltd.,7,175,168,172,94,16136,170,2,2018-01-31
Chhyangdi Hydropower Ltd.,3,174,171,172,72,12360,172,0,2018-02-01
Chhyangdi Hydropower Ltd.,10,170,166,168,105,17665,172,-4,2018-02-04
Chhyangdi Hydropower Ltd.,4,170,168,168,152,25810,168,0,2018-02-06
Chhyangdi Hydropower Ltd.,5,171,168,171,563,96243,168,3,2018-02-07
Chhyangdi Hydropower Ltd.,13,174,170,172,736,125802,171,1,2018-02-08
Chhyangdi Hydropower Ltd.,9,170,168,170,204,34522,171,-1,2018-02-25
Chhyangdi Hydropower Ltd.,4,172,169,169,64,10876,172,-3,2018-02-11
Chhyangdi Hydropower Ltd.,9,169,166,166,538,90148,169,-3,2018-02-12
Chhyangdi Hydropower Ltd.,4,168,168,168,88,14784,166,2,2018-02-14
Chhyangdi Hydropower Ltd.,9,174,168,174,148,25210,168,6,2018-02-15
Chhyangdi Hydropower Ltd.,4,180,177,180,40,7170,174,6,2018-02-18
Chhyangdi Hydropower Ltd.,3,177,174,174,54,9426,180,-6,2018-02-20
Chhyangdi Hydropower Ltd.,2,171,171,171,20,3420,174,-3,2018-02-21
Chhyangdi Hydropower Ltd.,2,171,168,171,33,5574,171,0,2018-02-22
Chhyangdi Hydropower Ltd.,8,173,170,171,435,74995,170,1,2018-02-26
Chhyangdi Hydropower Ltd.,4,170,170,170,69,11730,171,-1,2018-02-27
Chhyangdi Hydropower Ltd.,5,173,165,165,813,135971,170,-5,2018-02-28
Chhyangdi Hydropower Ltd.,2,162,160,160,42,6740,165,-5,2018-03-05
Chhyangdi Hydropower Ltd.,1,160,160,160,10,1600,160,0,2018-03-06
Chhyangdi Hydropower Ltd.,9,163,159,160,191,30615,160,0,2018-03-07
Chhyangdi Hydropower Ltd.,10,159,155,158,243,38315,160,-2,2018-03-11
Chhyangdi Hydropower Ltd.,17,155,150,154,360,55390,158,-4,2018-03-12
Chhyangdi Hydropower Ltd.,20,154,150,151,220,33530,154,-3,2018-03-13
Chhyangdi Hydropower Ltd.,2,149,149,149,68,10132,151,-2,2018-03-14
Chhyangdi Hydropower Ltd.,21,153,150,150,234,35500,149,1,2018-03-15
Chhyangdi Hydropower Ltd.,20,156,150,156,248,37724,150,6,2018-03-18
Chhyangdi Hydropower Ltd.,8,156,150,151,211,32028,156,-5,2018-03-19
Chhyangdi Hydropower Ltd.,1,148,148,148,13,1924,151,-3,2018-03-20
Chhyangdi Hydropower Ltd.,8,150,148,150,158,23632,148,2,2018-03-21
Chhyangdi Hydropower Ltd.,5,153,150,150,120,18270,150,0,2018-03-22
Chhyangdi Hydropower Ltd.,15,153,148,148,1624,244280,150,-2,2018-03-26
Chhyangdi Hydropower Ltd.,6,147,145,145,75,10895,148,-3,2018-03-27
Chhyangdi Hydropower Ltd.,2,147,145,147,20,2920,145,2,2018-03-28
Chhyangdi Hydropower Ltd.,3,149,146,149,30,4420,147,2,2018-03-29
Chhyangdi Hydropower Ltd.,7,149,148,148,94,13922,149,-1,2018-04-01
Chhyangdi Hydropower Ltd.,3,149,148,148,34,5052,148,0,2018-04-02
Chhyangdi Hydropower Ltd.,2,152,150,152,23,3470,148,4,2018-04-04
Chhyangdi Hydropower Ltd.,7,160,153,160,275,43537,152,8,2018-04-05
Chhyangdi Hydropower Ltd.,10,163,159,159,100,16160,160,-1,2018-04-08
Chhyangdi Hydropower Ltd.,8,162,159,159,522,83078,159,0,2018-04-09
Chhyangdi Hydropower Ltd.,3,156,156,156,54,8424,159,-3,2018-04-11
Chhyangdi Hydropower Ltd.,24,159,143,154,320,48422,156,-2,2018-04-12
Chhyangdi Hydropower Ltd.,5,160,157,157,87,13791,154,3,2018-04-15
Chhyangdi Hydropower Ltd.,3,157,157,157,33,5181,157,0,2018-04-16
Chhyangdi Hydropower Ltd.,1,160,160,160,10,1600,157,3,2018-04-18
Chhyangdi Hydropower Ltd.,18,168,160,168,564,92812,160,8,2018-04-19
Chhyangdi Hydropower Ltd.,17,171,165,165,261,43275,168,-3,2018-04-22
Chhyangdi Hydropower Ltd.,12,168,165,165,198,32710,165,0,2018-04-23
Chhyangdi Hydropower Ltd.,5,168,162,168,144,24012,165,3,2018-04-24
Chhyangdi Hydropower Ltd.,6,171,168,168,240,40360,168,0,2018-04-25
Chhyangdi Hydropower Ltd.,16,168,165,166,902,148983,168,-2,2018-04-26
Chhyangdi Hydropower Ltd.,5,165,161,161,140,22620,166,-5,2018-04-29
Chhyangdi Hydropower Ltd.,4,158,158,158,284,44872,161,-3,2018-05-02
Chhyangdi Hydropower Ltd.,11,164,160,160,194,31113,158,2,2018-05-03
Chhyangdi Hydropower Ltd.,11,157,154,156,326,50724,160,-4,2018-05-06
Chhyangdi Hydropower Ltd.,7,153,152,153,87,13278,156,-3,2018-05-07
Chhyangdi Hydropower Ltd.,25,154,150,153,643,98225,153,0,2018-05-08
Chhyangdi Hydropower Ltd.,7,157,151,151,118,18138,153,-2,2018-05-09
Chhyangdi Hydropower Ltd.,14,154,148,151,149,22546,151,0,2018-05-10
Chhyangdi Hydropower Ltd.,16,151,146,148,184,27226,151,-3,2018-05-14
Chhyangdi Hydropower Ltd.,2,146,146,146,20,2920,148,-2,2018-05-15
Chhyangdi Hydropower Ltd.,2,150,148,150,35,5210,146,4,2018-05-17
Chhyangdi Hydropower Ltd.,4,148,148,148,64,9472,150,-2,2018-05-20
Chhyangdi Hydropower Ltd.,9,150,146,148,90,13300,148,0,2018-05-21
Chhyangdi Hydropower Ltd.,11,150,147,147,206,30516,148,-1,2018-05-22
Chilime Hydropower Company Limited,50,1291,1285,1285,20537,26414749,1289,-4,2016-05-23
Chilime Hydropower Company Limited,59,1292,1280,1283,10290,13227228,1285,-2,2016-05-24
Chilime Hydropower Company Limited,68,1310,1282,1284,14530,18777047,1283,1,2016-05-25
Chilime Hydropower Company Limited,70,1301,1280,1300,14393,18649990,1284,16,2016-05-26
Chilime Hydropower Company Limited,130,1404,1324,1360,23985,32190887,1300,60,2016-05-29
Chilime Hydropower Company Limited,261,1410,1387,1395,48838,68245350,1360,35,2016-05-30
Chilime Hydropower Company Limited,399,1534,1400,1530,97255,144249518,1395,135,2016-05-31
Chilime Hydropower Company Limited,302,1600,1431,1471,45817,69488106,1530,-59,2016-06-01
Chilime Hydropower Company Limited,119,1453,1412,1419,18850,26877418,1471,-52,2016-06-02
Chilime Hydropower Company Limited,82,1420,1360,1370,13542,18613679,1419,-49,2016-06-05
Chilime Hydropower Company Limited,76,1419,1385,1400,13522,18898096,1370,30,2016-06-06
Chilime Hydropower Company Limited,51,1420,1400,1402,7497,10564310,1400,2,2016-06-07
Chilime Hydropower Company Limited,112,1450,1403,1415,25156,35797570,1400,15,2016-06-23
Chilime Hydropower Company Limited,57,1405,1390,1400,10193,14243653,1402,-2,2016-06-08
Chilime Hydropower Company Limited,47,1405,1381,1394,10848,15077031,1400,-6,2016-06-09
Chilime Hydropower Company Limited,63,1385,1355,1379,13432,18500414,1394,-15,2016-06-12
Chilime Hydropower Company Limited,47,1400,1375,1384,6798,9397276,1379,5,2016-06-13
Chilime Hydropower Company Limited,67,1440,1385,1400,13551,19022367,1384,16,2016-06-14
Chilime Hydropower Company Limited,63,1420,1392,1392,13377,18728073,1400,-8,2016-06-15
Chilime Hydropower Company Limited,77,1404,1384,1395,14575,20313124,1392,3,2016-06-16
Chilime Hydropower Company Limited,67,1391,1368,1370,16926,23249173,1395,-25,2016-06-19
Chilime Hydropower Company Limited,60,1390,1365,1370,10664,14658646,1370,0,2016-06-20
Chilime Hydropower Company Limited,66,1390,1365,1370,10614,14573153,1370,0,2016-06-21
Chilime Hydropower Company Limited,141,1400,1385,1400,24505,34230655,1370,30,2016-06-22
Chilime Hydropower Company Limited,69,1425,1400,1420,14717,20809384,1415,5,2016-06-26
Chilime Hydropower Company Limited,63,1440,1415,1439,8307,11832232,1420,19,2016-06-27
Chilime Hydropower Company Limited,92,1466,1421,1466,18336,26366887,1439,27,2016-06-28
Chilime Hydropower Company Limited,62,1480,1450,1474,13171,19348994,1466,8,2016-06-29
Chilime Hydropower Company Limited,70,1483,1450,1457,12874,18834157,1474,-17,2016-06-30
Chilime Hydropower Company Limited,69,1455,1425,1450,18925,27217145,1457,-7,2016-07-03
Chilime Hydropower Company Limited,53,1450,1432,1440,12735,18329863,1450,-10,2016-07-04
Chilime Hydropower Company Limited,49,1455,1425,1441,7051,10134721,1440,1,2016-07-05
Chilime Hydropower Company Limited,70,1442,1420,1435,15686,22466605,1441,-6,2016-07-06
Chilime Hydropower Company Limited,65,1435,1407,1428,13140,18686805,1435,-7,2016-07-10
Chilime Hydropower Company Limited,42,1425,1405,1406,13098,18438922,1428,-22,2016-07-11
Chilime Hydropower Company Limited,70,1420,1380,1395,11200,15695074,1406,-11,2016-07-12
Chilime Hydropower Company Limited,63,1420,1380,1397,14484,20092756,1395,2,2016-07-13
Chilime Hydropower Company Limited,44,1440,1390,1440,11973,16950070,1397,43,2016-07-14
Chilime Hydropower Company Limited,26,1439,1410,1420,3562,5052022,1440,-20,2016-07-17
Chilime Hydropower Company Limited,48,1440,1399,1410,8608,12102430,1420,-10,2016-07-18
Chilime Hydropower Company Limited,45,1410,1390,1408,7528,10570616,1410,-2,2016-07-19
Chilime Hydropower Company Limited,53,1407,1396,1399,9133,12794019,1408,-9,2016-07-20
Chilime Hydropower Company Limited,32,1400,1380,1394,5974,8329704,1399,-5,2016-07-21
Chilime Hydropower Company Limited,71,1399,1380,1388,12816,17773975,1394,-6,2016-07-25
Chilime Hydropower Company Limited,91,1399,1380,1390,15897,22053737,1388,2,2016-07-26
Chilime Hydropower Company Limited,99,1405,1390,1400,23604,32990114,1390,10,2016-07-27
Chilime Hydropower Company Limited,41,1400,1380,1394,6657,9270631,1400,-6,2016-07-28
Chilime Hydropower Company Limited,54,1401,1382,1389,10000,13886149,1394,-5,2016-07-31
Chilime Hydropower Company Limited,50,1386,1365,1375,7615,10482637,1389,-14,2016-08-01
Chilime Hydropower Company Limited,50,1380,1356,1370,7978,10938904,1375,-5,2016-08-02
Chilime Hydropower Company Limited,45,1380,1355,1367,6283,8566934,1370,-3,2016-08-03
Chilime Hydropower Company Limited,59,1360,1346,1350,9382,12700408,1367,-17,2016-08-04
Chilime Hydropower Company Limited,52,1385,1332,1333,6949,9360246,1350,-17,2016-08-07
Chilime Hydropower Company Limited,46,1315,1286,1286,6257,8143071,1333,-47,2016-08-08
Chilime Hydropower Company Limited,4,1363,1311,1363,170,229370,1286,77,2016-08-09
Chilime Hydropower Company Limited,47,1363,1325,1330,5908,7911505,1363,-33,2016-08-10
Chilime Hydropower Company Limited,28,1340,1311,1325,3058,4066753,1330,-5,2016-08-11
Chilime Hydropower Company Limited,49,1340,1300,1305,7570,9914481,1325,-20,2016-08-14
Chilime Hydropower Company Limited,48,1300,1251,1290,7776,9913582,1305,-15,2016-08-15
Chilime Hydropower Company Limited,53,1317,1275,1285,9813,12710966,1320,-35,2016-08-31
Chilime Hydropower Company Limited,66,1326,1270,1300,8063,10443169,1290,10,2016-08-16
Chilime Hydropower Company Limited,48,1310,1282,1294,7449,9657885,1300,-6,2016-08-17
Chilime Hydropower Company Limited,27,1300,1280,1280,5047,6502921,1294,-14,2016-08-21
Chilime Hydropower Company Limited,54,1290,1240,1250,6770,8491763,1280,-30,2016-08-22
Chilime Hydropower Company Limited,50,1275,1242,1246,6572,8209867,1250,-4,2016-08-23
Chilime Hydropower Company Limited,36,1270,1240,1270,7442,9287630,1246,24,2016-08-24
Chilime Hydropower Company Limited,40,1270,1245,1258,5282,6628095,1270,-12,2016-08-28
Chilime Hydropower Company Limited,95,1260,1233,1239,11341,14063958,1258,-19,2016-08-29
Chilime Hydropower Company Limited,96,1331,1222,1320,71011,87840181,1239,81,2016-08-30
Chilime Hydropower Company Limited,37,1282,1255,1270,4037,5118692,1285,-15,2016-09-01
Chilime Hydropower Company Limited,50,1273,1255,1260,9147,11527393,1270,-10,2016-09-04
Chilime Hydropower Company Limited,42,1275,1260,1265,6650,8419250,1260,5,2016-09-05
Chilime Hydropower Company Limited,42,1301,1262,1284,5232,6720016,1265,19,2016-09-06
Chilime Hydropower Company Limited,48,1300,1271,1271,6388,8181339,1284,-13,2016-09-07
Chilime Hydropower Company Limited,177,1360,1280,1328,34560,45352346,1271,57,2016-09-08
Chilime Hydropower Company Limited,187,1436,1350,1365,38150,52618197,1328,37,2016-09-11
Chilime Hydropower Company Limited,62,1375,1312,1328,12258,16373325,1365,-37,2016-09-12
Chilime Hydropower Company Limited,68,1330,1305,1320,10744,14138593,1328,-8,2016-09-14
Chilime Hydropower Company Limited,128,1375,1321,1321,18274,24620323,1320,1,2016-09-18
Chilime Hydropower Company Limited,49,1320,1277,1291,7947,10283122,1321,-30,2016-09-20
Chilime Hydropower Company Limited,72,1281,1250,1275,11773,14909636,1291,-16,2016-09-21
Chilime Hydropower Company Limited,44,1290,1251,1285,5403,6872503,1275,10,2016-09-22
Chilime Hydropower Company Limited,48,1285,1251,1257,6551,8245568,1285,-28,2016-09-25
Chilime Hydropower Company Limited,44,1275,1252,1260,4093,5168146,1257,3,2016-09-26
Chilime Hydropower Company Limited,41,1270,1257,1260,3900,4925078,1260,0,2016-09-27
Chilime Hydropower Company Limited,62,1265,1240,1260,13888,17425632,1260,0,2016-09-28
Chilime Hydropower Company Limited,56,1274,1252,1252,10589,13356596,1260,-8,2016-09-29
Chilime Hydropower Company Limited,47,1265,1250,1250,7390,9247295,1252,-2,2016-10-02
Chilime Hydropower Company Limited,50,1259,1246,1250,9567,11969115,1250,0,2016-10-03
Chilime Hydropower Company Limited,45,1262,1245,1251,10341,12957262,1250,1,2016-10-04
Chilime Hydropower Company Limited,67,1261,1235,1249,13441,16756098,1251,-2,2016-10-05
Chilime Hydropower Company Limited,63,1320,1250,1260,13557,17067030,1249,11,2016-10-06
Chilime Hydropower Company Limited,26,1280,1233,1250,4690,5829513,1260,-10,2016-10-16
Chilime Hydropower Company Limited,27,1261,1240,1261,3157,3931405,1250,11,2016-10-17
Chilime Hydropower Company Limited,27,1259,1245,1250,3069,3838844,1261,-11,2016-10-18
Chilime Hydropower Company Limited,34,1256,1245,1256,4542,5681614,1250,6,2016-10-19
Chilime Hydropower Company Limited,38,1255,1249,1254,6590,8244922,1256,-2,2016-10-20
Chilime Hydropower Company Limited,42,1270,1242,1244,4402,5490970,1254,-10,2016-10-23
Chilime Hydropower Company Limited,31,1248,1235,1240,5956,7389318,1244,-4,2016-10-24
Chilime Hydropower Company Limited,21,1242,1235,1240,3442,4264614,1240,0,2016-10-25
Chilime Hydropower Company Limited,31,1250,1225,1235,4471,5507892,1240,-5,2016-10-26
Chilime Hydropower Company Limited,48,1250,1230,1250,8215,10197203,1235,15,2016-10-27
Chilime Hydropower Company Limited,31,1252,1242,1242,3473,4327153,1250,-8,2016-11-03
Chilime Hydropower Company Limited,65,1250,1235,1235,10235,12691744,1242,-7,2016-11-07
Chilime Hydropower Company Limited,42,1245,1223,1223,5750,7109226,1235,-12,2016-11-08
Chilime Hydropower Company Limited,56,1235,1200,1210,9159,11098794,1223,-13,2016-11-09
Chilime Hydropower Company Limited,51,1255,1200,1213,6838,8273717,1210,3,2016-11-10
Chilime Hydropower Company Limited,40,1214,1189,1207,8462,10186646,1213,-6,2016-11-13
Chilime Hydropower Company Limited,47,1211,1198,1198,7342,8842765,1207,-9,2016-11-14
Chilime Hydropower Company Limited,61,1209,1182,1195,8187,9798072,1198,-3,2016-11-15
Chilime Hydropower Company Limited,70,1190,1165,1175,10094,11868049,1195,-20,2016-11-16
Chilime Hydropower Company Limited,91,1175,1136,1136,10894,12490733,1175,-39,2016-11-17
Chilime Hydropower Company Limited,83,1125,1075,1090,8841,9661389,1136,-46,2016-11-20
Chilime Hydropower Company Limited,40,1111,1070,1094,5262,5721841,1090,4,2016-11-21
Chilime Hydropower Company Limited,61,1110,1052,1081,7247,7881159,1094,-13,2016-11-22
Chilime Hydropower Company Limited,65,1085,1066,1070,8833,9492861,1081,-11,2016-11-23
Chilime Hydropower Company Limited,49,1081,1032,1065,6437,6782145,1070,-5,2016-11-24
Chilime Hydropower Company Limited,111,1055,990,1000,19987,20359174,1065,-65,2016-11-27
Chilime Hydropower Company Limited,86,1039,945,1029,13725,13398052,1000,29,2016-11-28
Chilime Hydropower Company Limited,70,1080,980,1080,8460,8636760,1029,51,2016-11-29
Chilime Hydropower Company Limited,95,1101,1065,1080,11229,12154686,1080,0,2016-11-30
Chilime Hydropower Company Limited,88,1122,1051,1062,9635,10330864,1080,-18,2016-12-01
Chilime Hydropower Company Limited,44,1055,1025,1025,6879,7127930,1062,-37,2016-12-04
Chilime Hydropower Company Limited,68,1043,1000,1000,9238,9358451,1025,-25,2016-12-05
Chilime Hydropower Company Limited,91,1020,990,1006,12334,12339665,1000,6,2016-12-06
Chilime Hydropower Company Limited,40,1040,1000,1040,10081,10171542,1006,34,2016-12-07
Chilime Hydropower Company Limited,28,1039,1014,1022,4056,4150123,1040,-18,2016-12-08
Chilime Hydropower Company Limited,54,1029,996,996,9328,9363541,1022,-26,2016-12-11
Chilime Hydropower Company Limited,58,1009,980,1000,8582,8544892,996,4,2016-12-12
Chilime Hydropower Company Limited,52,1000,970,992,5257,5192376,1000,-8,2016-12-14
Chilime Hydropower Company Limited,164,990,960,980,17273,16814232,992,-12,2016-12-15
Chilime Hydropower Company Limited,116,975,958,961,15932,15408347,980,-19,2016-12-18
Chilime Hydropower Company Limited,67,975,955,958,10490,10059891,961,-3,2016-12-19
Chilime Hydropower Company Limited,123,945,917,929,23131,21429306,958,-29,2016-12-20
Chilime Hydropower Company Limited,115,929,905,920,10975,10028973,929,-9,2016-12-21
Chilime Hydropower Company Limited,196,920,900,900,43186,38990579,920,-20,2016-12-22
Chilime Hydropower Company Limited,68,810,781,790,7683,6079488,818,-28,2016-12-26
Chilime Hydropower Company Limited,61,790,760,778,10419,7993611,790,-12,2016-12-27
Chilime Hydropower Company Limited,56,800,771,799,9429,7467409,778,21,2016-12-28
Chilime Hydropower Company Limited,115,811,800,800,24203,19509053,799,1,2016-12-29
Chilime Hydropower Company Limited,83,824,808,815,12046,9813408,800,15,2017-01-01
Chilime Hydropower Company Limited,73,828,811,818,11263,9231338,815,3,2017-01-02
Chilime Hydropower Company Limited,57,820,810,810,6109,4976721,818,-8,2017-01-03
Chilime Hydropower Company Limited,45,810,795,805,3779,3085465,810,-5,2017-01-04
Chilime Hydropower Company Limited,50,811,800,807,6201,4990272,805,2,2017-01-05
Chilime Hydropower Company Limited,36,805,798,800,5787,4632277,807,-7,2017-01-08
Chilime Hydropower Company Limited,34,810,797,802,3187,2557130,800,2,2017-01-09
Chilime Hydropower Company Limited,23,825,802,820,1654,1346482,802,18,2017-01-10
Chilime Hydropower Company Limited,19,821,813,817,2318,1893073,820,-3,2017-01-11
Chilime Hydropower Company Limited,23,820,810,817,5112,4179610,817,0,2017-01-12
Chilime Hydropower Company Limited,6,812,807,807,680,550490,817,-10,2017-01-15
Chilime Hydropower Company Limited,18,815,808,808,1775,1436104,807,1,2017-01-16
Chilime Hydropower Company Limited,23,815,801,809,3867,3123823,808,1,2017-01-17
Chilime Hydropower Company Limited,26,814,793,806,2558,2064154,809,-3,2017-01-18
Chilime Hydropower Company Limited,37,817,800,817,5854,4753587,806,11,2017-01-19
Chilime Hydropower Company Limited,21,820,805,808,2233,1805990,817,-9,2017-01-22
Chilime Hydropower Company Limited,13,820,806,806,1208,977307,808,-2,2017-01-23
Chilime Hydropower Company Limited,31,810,794,794,4553,3639167,806,-12,2017-01-24
Chilime Hydropower Company Limited,42,791,765,772,3943,3067435,794,-22,2017-01-25
Chilime Hydropower Company Limited,36,780,758,770,4229,3253616,772,-2,2017-01-26
Chilime Hydropower Company Limited,66,781,746,746,8571,6549539,770,-24,2017-01-30
Chilime Hydropower Company Limited,34,759,744,752,5457,4088188,746,6,2017-01-31
Chilime Hydropower Company Limited,39,790,760,780,4272,3304817,752,28,2017-02-01
Chilime Hydropower Company Limited,38,786,755,770,5371,4160735,780,-10,2017-02-02
Chilime Hydropower Company Limited,22,772,754,768,3355,2568714,770,-2,2017-02-05
Chilime Hydropower Company Limited,30,770,757,761,5096,3886139,768,-7,2017-02-06
Chilime Hydropower Company Limited,55,761,738,752,18763,13990967,761,-9,2017-02-07
Chilime Hydropower Company Limited,29,755,741,750,3564,2663502,752,-2,2017-02-08
Chilime Hydropower Company Limited,35,753,742,746,3664,2731529,750,-4,2017-02-09
Chilime Hydropower Company Limited,55,760,710,710,6059,4410647,746,-36,2017-02-12
Chilime Hydropower Company Limited,90,727,665,727,17591,12102341,710,17,2017-02-13
Chilime Hydropower Company Limited,85,715,694,700,15059,10548224,727,-27,2017-02-14
Chilime Hydropower Company Limited,51,721,701,721,9467,6737382,700,21,2017-02-15
Chilime Hydropower Company Limited,72,735,711,725,10479,7612743,721,4,2017-02-16
Chilime Hydropower Company Limited,76,730,720,725,9475,6870449,725,0,2017-02-19
Chilime Hydropower Company Limited,80,748,720,730,15394,11308322,725,5,2017-02-20
Chilime Hydropower Company Limited,61,740,721,730,6961,5066048,730,0,2017-02-21
Chilime Hydropower Company Limited,43,742,720,728,6105,4471212,730,-2,2017-02-22
Chilime Hydropower Company Limited,27,740,717,728,2885,2090700,728,0,2017-02-23
Chilime Hydropower Company Limited,43,726,700,712,11221,7961636,728,-16,2017-02-26
Chilime Hydropower Company Limited,30,714,698,714,3227,2291647,712,2,2017-02-28
Chilime Hydropower Company Limited,14,724,715,718,1553,1117603,714,4,2017-03-01
Chilime Hydropower Company Limited,24,729,718,729,2241,1617349,718,11,2017-03-02
Chilime Hydropower Company Limited,47,743,729,739,6340,4673446,729,10,2017-03-05
Chilime Hydropower Company Limited,67,805,765,800,12722,9944528,800,0,2017-03-21
Chilime Hydropower Company Limited,44,755,745,751,6639,4977151,739,12,2017-03-06
Chilime Hydropower Company Limited,37,740,725,734,7849,5711017,751,-17,2017-03-07
Chilime Hydropower Company Limited,26,740,730,733,4564,3357995,734,-1,2017-03-09
Chilime Hydropower Company Limited,24,745,729,729,3666,2682952,733,-4,2017-03-13
Chilime Hydropower Company Limited,13,739,725,732,4108,2997386,729,3,2017-03-14
Chilime Hydropower Company Limited,42,760,725,750,9041,6681136,732,18,2017-03-15
Chilime Hydropower Company Limited,35,760,748,748,5422,4073610,750,-2,2017-03-16
Chilime Hydropower Company Limited,47,790,753,789,6272,4775747,748,41,2017-03-19
Chilime Hydropower Company Limited,52,810,790,800,6779,5399323,789,11,2017-03-20
Chilime Hydropower Company Limited,156,832,796,818,28981,23638955,800,18,2017-03-22
Chilime Hydropower Company Limited,74,836,805,828,10052,8265143,818,10,2017-03-23
Chilime Hydropower Company Limited,124,910,826,910,16026,14288733,828,82,2017-03-26
Chilime Hydropower Company Limited,79,980,928,955,12069,11528977,910,45,2017-03-28
Chilime Hydropower Company Limited,133,988,916,915,21835,20482055,955,-40,2017-03-29
Chilime Hydropower Company Limited,87,930,877,902,9656,8736321,915,-13,2017-03-30
Chilime Hydropower Company Limited,29,940,915,938,7234,6719742,902,36,2017-04-02
Chilime Hydropower Company Limited,81,1009,907,933,12341,11631098,938,-5,2017-04-03
Chilime Hydropower Company Limited,42,944,902,910,4727,4326657,933,-23,2017-04-04
Chilime Hydropower Company Limited,67,923,900,906,11037,10025654,910,-4,2017-04-06
Chilime Hydropower Company Limited,54,910,890,900,6325,5686125,906,-6,2017-04-09
Chilime Hydropower Company Limited,57,934,890,914,8583,7807398,900,14,2017-04-10
Chilime Hydropower Company Limited,36,928,905,914,6002,5482779,914,0,2017-04-11
Chilime Hydropower Company Limited,75,931,910,913,11808,10816913,914,-1,2017-04-12
Chilime Hydropower Company Limited,54,910,885,898,5894,5284787,913,-15,2017-04-13
Chilime Hydropower Company Limited,57,910,875,875,7334,6477763,898,-23,2017-04-16
Chilime Hydropower Company Limited,69,861,836,842,10402,8847010,875,-33,2017-04-18
Chilime Hydropower Company Limited,38,865,826,861,4296,3669630,842,19,2017-04-19
Chilime Hydropower Company Limited,39,869,852,863,5025,4343203,861,2,2017-04-20
Chilime Hydropower Company Limited,75,930,860,879,8966,7884800,863,16,2017-04-23
Chilime Hydropower Company Limited,25,880,858,870,1777,1549029,879,-9,2017-04-24
Chilime Hydropower Company Limited,39,870,850,856,6067,5208709,870,-14,2017-04-25
Chilime Hydropower Company Limited,33,865,841,858,7129,6102904,856,2,2017-04-26
Chilime Hydropower Company Limited,44,865,855,855,5638,4837452,858,-3,2017-04-27
Chilime Hydropower Company Limited,60,858,835,858,9279,7824209,855,3,2017-04-30
Chilime Hydropower Company Limited,39,860,846,857,2708,2315766,858,-1,2017-05-02
Chilime Hydropower Company Limited,44,860,840,848,4891,4155505,857,-9,2017-05-03
Chilime Hydropower Company Limited,45,855,840,845,5108,4333377,848,-3,2017-05-04
Chilime Hydropower Company Limited,42,850,831,831,6717,5618301,845,-14,2017-05-07
Chilime Hydropower Company Limited,31,845,821,840,2483,2073841,831,9,2017-05-08
Chilime Hydropower Company Limited,41,892,830,875,9106,7723826,840,35,2017-05-09
Chilime Hydropower Company Limited,103,905,873,896,19373,17260904,875,21,2017-05-11
Chilime Hydropower Company Limited,63,912,885,896,12837,11485069,896,0,2017-05-15
Chilime Hydropower Company Limited,28,896,863,885,6011,5247473,896,-11,2017-05-16
Chilime Hydropower Company Limited,13,885,865,865,949,829007,885,-20,2017-05-17
Chilime Hydropower Company Limited,25,878,856,878,3449,2977587,865,13,2017-05-18
Chilime Hydropower Company Limited,31,874,855,870,6643,5764988,878,-8,2017-05-21
Chilime Hydropower Company Limited,27,870,852,856,4471,3832610,870,-14,2017-05-22
Chilime Hydropower Company Limited,20,871,860,861,3091,2672707,856,5,2017-05-23
Chilime Hydropower Company Limited,23,875,845,860,4158,3548413,861,-1,2017-05-24
Chilime Hydropower Company Limited,52,850,830,850,9934,8313496,860,-10,2017-05-28
Chilime Hydropower Company Limited,48,845,825,843,13442,11145046,850,-7,2017-05-30
Chilime Hydropower Company Limited,40,855,825,840,5724,4770922,843,-3,2017-05-31
Chilime Hydropower Company Limited,37,857,824,857,10505,8953163,840,17,2017-06-01
Chilime Hydropower Company Limited,38,851,835,835,4819,4051631,857,-22,2017-06-04
Chilime Hydropower Company Limited,31,855,835,840,3043,2585464,835,5,2017-06-05
Chilime Hydropower Company Limited,45,863,824,863,11949,10121807,840,23,2017-06-06
Chilime Hydropower Company Limited,46,872,856,856,6550,5635939,863,-7,2017-06-07
Chilime Hydropower Company Limited,42,855,841,853,4450,3782866,856,-3,2017-06-08
Chilime Hydropower Company Limited,40,842,821,830,6168,5136460,853,-23,2017-06-11
Chilime Hydropower Company Limited,41,833,821,825,4484,3704279,830,-5,2017-06-12
Chilime Hydropower Company Limited,34,840,823,840,3618,3021251,825,15,2017-06-13
Chilime Hydropower Company Limited,12,840,831,840,1123,935821,840,0,2017-06-14
Chilime Hydropower Company Limited,24,850,832,835,2441,2050711,840,-5,2017-06-15
Chilime Hydropower Company Limited,23,835,826,832,2359,1957461,835,-3,2017-06-18
Chilime Hydropower Company Limited,34,827,820,823,3248,2672724,832,-9,2017-06-19
Chilime Hydropower Company Limited,31,825,806,819,4048,3295036,823,-4,2017-06-20
Chilime Hydropower Company Limited,34,816,805,815,3279,2654848,819,-4,2017-06-21
Chilime Hydropower Company Limited,21,829,815,829,1854,1517990,815,14,2017-06-22
Chilime Hydropower Company Limited,35,833,810,819,5530,4504932,829,-10,2017-06-25
Chilime Hydropower Company Limited,24,835,810,815,2249,1835429,819,-4,2017-06-27
Chilime Hydropower Company Limited,39,819,800,805,7707,6209630,815,-10,2017-06-28
Chilime Hydropower Company Limited,42,810,795,800,3374,2700458,805,-5,2017-07-02
Chilime Hydropower Company Limited,27,805,796,804,3244,2595590,800,4,2017-07-03
Chilime Hydropower Company Limited,25,804,796,799,3289,2629481,804,-5,2017-07-04
Chilime Hydropower Company Limited,29,810,792,810,2646,2116588,799,11,2017-07-05
Chilime Hydropower Company Limited,41,826,806,810,4280,3466882,810,0,2017-07-06
Chilime Hydropower Company Limited,73,815,795,800,11360,9162714,810,-10,2017-07-09
Chilime Hydropower Company Limited,38,805,785,792,6601,5248732,800,-8,2017-07-10
Chilime Hydropower Company Limited,22,807,777,797,2083,1666489,792,5,2017-07-11
Chilime Hydropower Company Limited,45,801,793,793,15624,12415130,797,-4,2017-07-12
Chilime Hydropower Company Limited,42,808,790,798,8375,6658421,793,5,2017-07-13
Chilime Hydropower Company Limited,29,802,795,795,2469,1969465,798,-3,2017-07-16
Chilime Hydropower Company Limited,48,800,786,793,6034,4788753,795,-2,2017-07-17
Chilime Hydropower Company Limited,52,824,791,824,11041,8871198,793,31,2017-07-18
Chilime Hydropower Company Limited,54,825,805,805,12550,10136946,811,-6,2017-08-03
Chilime Hydropower Company Limited,28,826,810,813,4393,3594099,824,-11,2017-07-19
Chilime Hydropower Company Limited,43,820,810,820,6610,5376446,813,7,2017-07-20
Chilime Hydropower Company Limited,49,821,810,821,5784,4720280,820,1,2017-07-23
Chilime Hydropower Company Limited,35,818,808,813,6086,4939754,821,-8,2017-07-24
Chilime Hydropower Company Limited,37,824,808,811,7889,6403398,813,-2,2017-07-25
Chilime Hydropower Company Limited,48,831,805,811,6815,5560717,811,0,2017-07-26
Chilime Hydropower Company Limited,43,821,797,800,6720,5408922,811,-11,2017-07-27
Chilime Hydropower Company Limited,20,804,796,800,3947,3157566,800,0,2017-07-30
Chilime Hydropower Company Limited,76,826,799,820,9056,7286002,800,20,2017-07-31
Chilime Hydropower Company Limited,63,815,810,811,11748,9535683,820,-9,2017-08-01
Chilime Hydropower Company Limited,34,827,810,811,3480,2837879,811,0,2017-08-02
Chilime Hydropower Company Limited,73,820,797,800,9823,7887393,805,-5,2017-08-06
Chilime Hydropower Company Limited,62,805,800,801,9166,7353267,800,1,2017-08-07
Chilime Hydropower Company Limited,56,810,797,797,9656,7745164,801,-4,2017-08-09
Chilime Hydropower Company Limited,58,800,796,800,9472,7560684,797,3,2017-08-10
Chilime Hydropower Company Limited,66,810,790,790,6837,5423320,800,-10,2017-08-13
Chilime Hydropower Company Limited,33,782,775,780,4131,3216869,790,-10,2017-08-15
Chilime Hydropower Company Limited,47,800,780,784,5837,4593049,780,4,2017-08-16
Chilime Hydropower Company Limited,48,795,775,785,8692,6795284,784,1,2017-08-17
Chilime Hydropower Company Limited,43,790,785,786,6586,5183489,785,1,2017-08-20
Chilime Hydropower Company Limited,26,790,780,786,4459,3492397,786,0,2017-08-21
Chilime Hydropower Company Limited,25,790,780,788,1831,1431914,786,2,2017-08-22
Chilime Hydropower Company Limited,25,788,781,781,2525,1979523,788,-7,2017-08-23
Chilime Hydropower Company Limited,29,796,781,783,4503,3528364,781,2,2017-08-24
Chilime Hydropower Company Limited,41,790,785,785,4039,3174470,783,2,2017-08-27
Chilime Hydropower Company Limited,27,785,776,785,3022,2357711,785,0,2017-08-28
Chilime Hydropower Company Limited,51,789,768,770,5921,4569046,785,-15,2017-08-30
Chilime Hydropower Company Limited,41,782,768,773,4956,3815767,770,3,2017-08-31
Chilime Hydropower Company Limited,52,798,762,766,6857,5278080,773,-7,2017-09-04
Chilime Hydropower Company Limited,42,780,762,770,6766,5199725,766,4,2017-09-06
Chilime Hydropower Company Limited,32,772,760,764,4657,3549211,770,-6,2017-09-07
Chilime Hydropower Company Limited,56,768,760,760,5372,4096459,764,-4,2017-09-10
Chilime Hydropower Company Limited,32,765,755,755,4634,3519109,760,-5,2017-09-11
Chilime Hydropower Company Limited,24,755,745,755,2758,2066238,755,0,2017-09-12
Chilime Hydropower Company Limited,31,770,740,770,4620,3487374,755,15,2017-09-13
Chilime Hydropower Company Limited,17,780,758,758,2593,1974055,770,-12,2017-09-14
Chilime Hydropower Company Limited,47,765,744,760,6799,5113958,758,2,2017-09-17
Chilime Hydropower Company Limited,56,784,756,780,6239,4843216,760,20,2017-09-18
Chilime Hydropower Company Limited,25,780,759,780,2888,2224719,780,0,2017-09-20
Chilime Hydropower Company Limited,103,830,804,811,17823,14548276,825,-14,2017-10-09
Chilime Hydropower Company Limited,38,783,770,780,5749,4465340,780,0,2017-09-24
Chilime Hydropower Company Limited,18,799,778,798,2422,1914218,780,18,2017-09-25
Chilime Hydropower Company Limited,48,805,790,800,6536,5221638,798,2,2017-09-26
Chilime Hydropower Company Limited,65,867,800,865,8734,7316684,800,65,2017-10-03
Chilime Hydropower Company Limited,118,899,831,833,21104,17981047,865,-32,2017-10-04
Chilime Hydropower Company Limited,72,840,804,825,10718,8731379,833,-8,2017-10-08
Chilime Hydropower Company Limited,91,830,800,820,11184,9182925,811,9,2017-10-10
Chilime Hydropower Company Limited,263,850,830,848,36901,31098589,820,28,2017-10-11
Chilime Hydropower Company Limited,593,866,835,838,84808,72064222,848,-10,2017-10-12
Chilime Hydropower Company Limited,101,851,829,842,10182,8600839,838,4,2017-10-15
Chilime Hydropower Company Limited,130,865,850,865,22782,19551073,842,23,2017-10-16
Chilime Hydropower Company Limited,179,890,853,885,30025,26398235,865,20,2017-10-17
Chilime Hydropower Company Limited,213,910,876,901,44422,39615806,885,16,2017-10-18
Chilime Hydropower Company Limited,286,928,902,906,53361,48673796,901,5,2017-10-22
Chilime Hydropower Company Limited,73,806,785,786,7825,6212670,788,-2,2017-10-23
Chilime Hydropower Company Limited,37,785,765,766,4833,3729806,786,-20,2017-10-24
Chilime Hydropower Company Limited,49,769,752,755,5893,4467057,766,-11,2017-10-25
Chilime Hydropower Company Limited,69,756,742,748,16281,12253930,755,-7,2017-10-29
Chilime Hydropower Company Limited,30,760,749,757,4175,3159704,748,9,2017-10-30
Chilime Hydropower Company Limited,39,765,757,760,10707,8132405,757,3,2017-10-31
Chilime Hydropower Company Limited,38,780,763,766,6022,4613290,760,6,2017-11-01
Chilime Hydropower Company Limited,40,775,760,775,8464,6522987,766,9,2017-11-02
Chilime Hydropower Company Limited,82,772,754,762,14180,10766436,775,-13,2017-11-05
Chilime Hydropower Company Limited,53,769,750,769,7701,5866300,762,7,2017-11-06
Chilime Hydropower Company Limited,64,780,765,773,8011,6193052,769,4,2017-11-07
Chilime Hydropower Company Limited,84,775,756,757,15506,11814236,773,-16,2017-11-08
Chilime Hydropower Company Limited,45,775,758,765,6570,5039348,757,8,2017-11-09
Chilime Hydropower Company Limited,131,799,775,790,13861,10902888,765,25,2017-11-12
Chilime Hydropower Company Limited,251,855,795,854,39163,32447999,790,64,2017-11-13
Chilime Hydropower Company Limited,431,899,858,885,68710,60327262,854,31,2017-11-14
Chilime Hydropower Company Limited,244,890,854,856,45234,39363519,885,-29,2017-11-15
Chilime Hydropower Company Limited,141,854,837,839,22531,18952525,856,-17,2017-11-16
Chilime Hydropower Company Limited,67,889,833,835,9786,8264325,839,-4,2017-11-19
Chilime Hydropower Company Limited,65,842,821,827,8351,6927444,835,-8,2017-11-20
Chilime Hydropower Company Limited,56,839,823,830,11240,9338456,827,3,2017-11-21
Chilime Hydropower Company Limited,65,853,830,851,10202,8630020,830,21,2017-11-22
Chilime Hydropower Company Limited,84,870,851,866,12262,10571823,851,15,2017-11-23
Chilime Hydropower Company Limited,271,918,855,918,46218,41228336,866,52,2017-11-26
Chilime Hydropower Company Limited,423,965,893,939,69469,64819288,918,21,2017-11-27
Chilime Hydropower Company Limited,254,964,926,960,44590,42333427,939,21,2017-11-28
Chilime Hydropower Company Limited,362,975,932,940,62416,59644907,960,-20,2017-11-29
Chilime Hydropower Company Limited,245,960,920,951,46434,43603301,940,11,2017-11-30
Chilime Hydropower Company Limited,95,960,944,948,17790,16886127,951,-3,2017-12-04
Chilime Hydropower Company Limited,59,948,930,937,14162,13298681,959,-22,2017-12-20
Chilime Hydropower Company Limited,51,938,932,935,10071,9414919,948,-13,2017-12-05
Chilime Hydropower Company Limited,73,969,945,950,13237,12558334,935,15,2017-12-06
Chilime Hydropower Company Limited,121,968,938,947,26553,25126998,950,-3,2017-12-10
Chilime Hydropower Company Limited,90,965,944,945,17274,16401934,947,-2,2017-12-11
Chilime Hydropower Company Limited,85,950,944,946,13681,12958347,945,1,2017-12-12
Chilime Hydropower Company Limited,81,969,932,954,14011,13371997,946,8,2017-12-13
Chilime Hydropower Company Limited,53,963,945,948,9377,8945725,954,-6,2017-12-14
Chilime Hydropower Company Limited,86,953,941,945,13175,12486458,948,-3,2017-12-17
Chilime Hydropower Company Limited,80,956,944,955,16493,15643378,945,10,2017-12-18
Chilime Hydropower Company Limited,76,959,943,959,9790,9266484,955,4,2017-12-19
Chilime Hydropower Company Limited,68,935,921,922,10697,9898501,937,-15,2017-12-21
Chilime Hydropower Company Limited,42,944,920,923,5535,5126200,922,1,2017-12-24
Chilime Hydropower Company Limited,97,911,900,901,22480,20322350,923,-22,2017-12-26
Chilime Hydropower Company Limited,125,919,889,893,19599,17600368,901,-8,2017-12-27
Chilime Hydropower Company Limited,49,905,877,887,6444,5723347,893,-6,2017-12-28
Chilime Hydropower Company Limited,66,885,860,885,8701,7576169,887,-2,2017-12-31
Chilime Hydropower Company Limited,78,915,878,915,17693,15883728,885,30,2018-01-01
Chilime Hydropower Company Limited,51,928,895,895,5932,5396147,915,-20,2018-01-02
Chilime Hydropower Company Limited,41,900,880,885,4558,4043481,895,-10,2018-01-03
Chilime Hydropower Company Limited,36,889,882,882,4324,3826423,885,-3,2018-01-04
Chilime Hydropower Company Limited,48,895,870,885,7112,6298352,882,3,2018-01-07
Chilime Hydropower Company Limited,40,897,885,894,6777,6036951,885,9,2018-01-08
Chilime Hydropower Company Limited,52,905,888,898,10397,9303610,894,4,2018-01-09
Chilime Hydropower Company Limited,60,903,884,892,9988,8904181,898,-6,2018-01-10
Chilime Hydropower Company Limited,63,954,880,954,12479,11235732,892,62,2018-01-14
Chilime Hydropower Company Limited,62,935,876,883,6159,5451896,954,-71,2018-01-16
Chilime Hydropower Company Limited,59,890,875,878,5438,4789330,883,-5,2018-01-17
Chilime Hydropower Company Limited,35,886,872,882,4410,3891096,878,4,2018-01-21
Chilime Hydropower Company Limited,34,899,883,897,3622,3214304,882,15,2018-01-22
Chilime Hydropower Company Limited,33,890,880,881,4559,4025336,897,-16,2018-01-23
Chilime Hydropower Company Limited,33,883,880,881,5504,4850323,881,0,2018-01-24
Chilime Hydropower Company Limited,35,887,881,887,3302,2918441,881,6,2018-01-25
Chilime Hydropower Company Limited,46,890,879,879,4555,4021661,887,-8,2018-01-28
Chilime Hydropower Company Limited,32,880,867,876,3046,2666879,879,-3,2018-01-29
Chilime Hydropower Company Limited,37,880,873,878,2571,2252791,876,2,2018-01-31
Chilime Hydropower Company Limited,43,890,870,875,6821,6000323,878,-3,2018-02-01
Chilime Hydropower Company Limited,43,881,875,878,4102,3600654,875,3,2018-02-04
Chilime Hydropower Company Limited,64,877,866,869,4820,4199476,878,-9,2018-02-05
Chilime Hydropower Company Limited,46,869,858,858,5510,4748865,869,-11,2018-02-06
Chilime Hydropower Company Limited,35,862,845,853,6152,5251097,858,-5,2018-02-07
Chilime Hydropower Company Limited,32,872,850,872,4113,3544269,853,19,2018-02-08
Chilime Hydropower Company Limited,55,850,840,842,6758,5706046,850,-8,2018-02-25
Chilime Hydropower Company Limited,71,866,850,850,9958,8500672,872,-22,2018-02-11
Chilime Hydropower Company Limited,37,855,850,851,3733,3179353,850,1,2018-02-12
Chilime Hydropower Company Limited,19,868,851,860,1570,1342401,851,9,2018-02-14
Chilime Hydropower Company Limited,55,891,861,891,5833,5089707,860,31,2018-02-15
Chilime Hydropower Company Limited,57,890,877,877,5715,5044394,891,-14,2018-02-18
Chilime Hydropower Company Limited,19,877,861,865,1341,1160411,877,-12,2018-02-20
Chilime Hydropower Company Limited,33,860,850,854,1936,1657876,865,-11,2018-02-21
Chilime Hydropower Company Limited,67,860,846,850,8451,7190130,854,-4,2018-02-22
Chilime Hydropower Company Limited,48,845,830,830,7010,5859705,842,-12,2018-02-26
Chilime Hydropower Company Limited,33,850,830,830,4084,3416016,830,0,2018-02-27
Chilime Hydropower Company Limited,46,835,823,825,7979,6593100,830,-5,2018-02-28
Chilime Hydropower Company Limited,75,811,785,792,8077,6435867,825,-33,2018-03-04
Chilime Hydropower Company Limited,70,807,771,773,7455,5831893,792,-19,2018-03-05
Chilime Hydropower Company Limited,55,805,766,790,6587,5131875,773,17,2018-03-06
Chilime Hydropower Company Limited,53,805,790,802,6195,4953410,790,12,2018-03-07
Chilime Hydropower Company Limited,74,798,765,766,7351,5681980,802,-36,2018-03-11
Chilime Hydropower Company Limited,73,765,746,759,11023,8303954,766,-7,2018-03-12
Chilime Hydropower Company Limited,35,760,746,760,5728,4326657,759,1,2018-03-13
Chilime Hydropower Company Limited,27,766,758,766,3345,2550650,760,6,2018-03-14
Chilime Hydropower Company Limited,28,779,760,775,2825,2179835,766,9,2018-03-15
Chilime Hydropower Company Limited,39,777,760,760,4112,3135869,775,-15,2018-03-18
Chilime Hydropower Company Limited,56,764,747,750,8879,6697084,760,-10,2018-03-19
Chilime Hydropower Company Limited,57,750,735,740,4763,3518563,750,-10,2018-03-20
Chilime Hydropower Company Limited,84,740,723,725,6652,4838122,740,-15,2018-03-21
Chilime Hydropower Company Limited,145,743,700,711,17788,12561402,725,-14,2018-03-22
Chilime Hydropower Company Limited,138,712,679,680,13245,9110059,711,-31,2018-03-26
Chilime Hydropower Company Limited,74,745,661,710,6066,4186507,680,30,2018-03-27
Chilime Hydropower Company Limited,163,721,692,700,27220,19137415,710,-10,2018-03-28
Chilime Hydropower Company Limited,86,718,700,717,11280,7968054,700,17,2018-03-29
Chilime Hydropower Company Limited,90,720,689,700,12520,8766700,717,-17,2018-04-01
Chilime Hydropower Company Limited,66,708,696,702,8890,6222916,700,2,2018-04-02
Chilime Hydropower Company Limited,32,710,696,708,7486,6114607.8,702,6,2018-04-03
Chilime Hydropower Company Limited,63,732,710,727,6147,4431197,708,19,2018-04-04
Chilime Hydropower Company Limited,97,748,725,747,10117,7463851,727,20,2018-04-05
Chilime Hydropower Company Limited,129,808,740,794,13684,10524896,747,47,2018-04-08
Chilime Hydropower Company Limited,165,809,779,789,24064,19088845,794,-5,2018-04-09
Chilime Hydropower Company Limited,88,790,757,760,12480,9564956,789,-29,2018-04-10
Chilime Hydropower Company Limited,39,770,752,769,4511,3430740,760,9,2018-04-11
Chilime Hydropower Company Limited,108,782,770,772,17199,13342649,769,3,2018-04-12
Chilime Hydropower Company Limited,88,770,746,762,10876,8300729,772,-10,2018-04-15
Chilime Hydropower Company Limited,69,780,756,761,10684,8241137,762,-1,2018-04-16
Chilime Hydropower Company Limited,83,800,766,787,9818,7665655,761,26,2018-04-17
Chilime Hydropower Company Limited,239,865,778,856,39260,32406336,787,69,2018-04-18
Chilime Hydropower Company Limited,273,880,842,865,49054,42303702,856,9,2018-04-19
Chilime Hydropower Company Limited,195,908,860,906,30381,27017192,865,41,2018-04-22
Chilime Hydropower Company Limited,268,910,860,877,41975,37290698,906,-29,2018-04-23
Chilime Hydropower Company Limited,130,880,859,872,19937,17248816,877,-5,2018-04-24
Chilime Hydropower Company Limited,79,870,853,858,21733,18631118,872,-14,2018-04-25
Chilime Hydropower Company Limited,124,875,829,830,13870,11692436,858,-28,2018-04-26
Chilime Hydropower Company Limited,67,846,816,828,7595,6277355,830,-2,2018-04-29
Chilime Hydropower Company Limited,63,844,815,840,5671,4699330,828,12,2018-05-02
Chilime Hydropower Company Limited,158,875,841,857,28081,24208947,840,17,2018-05-03
Chilime Hydropower Company Limited,70,874,840,852,9425,8023259,857,-5,2018-05-06
Chilime Hydropower Company Limited,70,852,841,844,6952,5891997,852,-8,2018-05-07
Chilime Hydropower Company Limited,56,860,840,854,6343,5371677,844,10,2018-05-08
Chilime Hydropower Company Limited,29,855,850,854,3326,2833126,854,0,2018-05-09
Chilime Hydropower Company Limited,78,847,837,840,8641,7278105,854,-14,2018-05-10
Chilime Hydropower Company Limited,60,838,828,834,5580,4638182,840,-6,2018-05-14
Chilime Hydropower Company Limited,28,832,820,825,3709,3065207,834,-9,2018-05-15
Chilime Hydropower Company Limited,25,840,814,838,5805,4820153,825,13,2018-05-16
Chilime Hydropower Company Limited,52,845,839,841,7015,5896796,838,3,2018-05-17
Chilime Hydropower Company Limited,60,864,836,848,7342,6213700,841,7,2018-05-20
Chilime Hydropower Company Limited,37,854,838,841,5194,4373090,848,-7,2018-05-21
Chilime Hydropower Company Limited,48,857,836,837,8133,5776450.74,841,-4,2018-05-22
Citizen Bank International Limited,129,819,804,819,34313,27824253,806,13,2016-05-23
Citizen Bank International Limited,138,835,813,830,46361,38237397,819,11,2016-05-24
Citizen Bank International Limited,122,835,801,812,36702,29923295,830,-18,2016-05-25
Citizen Bank International Limited,156,840,795,820,54472,44132276,812,8,2016-05-26
Citizen Bank International Limited,107,836,808,825,34318,27944608,820,5,2016-05-29
Citizen Bank International Limited,476,870,830,838,117380,98197521,825,13,2016-05-30
Citizen Bank International Limited,465,846,832,833,104588,87552351,838,-5,2016-05-31
Citizen Bank International Limited,427,835,818,819,90305,74333284,833,-14,2016-06-01
Citizen Bank International Limited,584,828,811,820,134230,110148681,819,1,2016-06-02
Citizen Bank International Limited,1213,830,810,814,256572,209578010,820,-6,2016-06-05
Citizen Bank International Limited,306,595,572,590,63778,37317339,561,29,2016-06-06
Citizen Bank International Limited,262,604,590,590,63364,37804762,590,0,2016-06-07
Citizen Bank International Limited,90,598,585,586,22795,13503467,590,-4,2016-06-23
Citizen Bank International Limited,130,593,571,571,32340,18757722,590,-19,2016-06-08
Citizen Bank International Limited,127,578,563,569,34152,19482002,571,-2,2016-06-09
Citizen Bank International Limited,143,575,561,565,33161,18793471,569,-4,2016-06-12
Citizen Bank International Limited,90,587,566,582,26014,15022413,565,17,2016-06-13
Citizen Bank International Limited,114,590,575,576,57713,33519051,582,-6,2016-06-14
Citizen Bank International Limited,88,582,575,575,21508,12437566,576,-1,2016-06-15
Citizen Bank International Limited,89,587,560,570,20291,11593133,575,-5,2016-06-16
Citizen Bank International Limited,88,578,560,574,31372,17985134,570,4,2016-06-19
Citizen Bank International Limited,85,580,570,577,22228,12781165,574,3,2016-06-20
Citizen Bank International Limited,79,585,578,585,16259,9436124,577,8,2016-06-21
Citizen Bank International Limited,102,610,585,590,26079,15452157,585,5,2016-06-22
Citizen Bank International Limited,109,600,588,600,28810,17191074,586,14,2016-06-26
Citizen Bank International Limited,192,650,605,647,47405,29757189,600,47,2016-06-27
Citizen Bank International Limited,264,686,652,672,60359,40562094,647,25,2016-06-28
Citizen Bank International Limited,179,685,671,672,39389,26591439,672,0,2016-06-29
Citizen Bank International Limited,138,675,652,669,39799,26474271,672,-3,2016-06-30
Citizen Bank International Limited,84,669,649,657,16673,10956033,669,-12,2016-07-03
Citizen Bank International Limited,146,657,640,645,29344,18918036,657,-12,2016-07-04
Citizen Bank International Limited,95,660,636,654,22718,14738396,645,9,2016-07-05
Citizen Bank International Limited,86,663,654,660,15886,10476629,654,6,2016-07-06
Citizen Bank International Limited,98,680,668,676,20794,14045341,660,16,2016-07-10
Citizen Bank International Limited,88,679,664,671,17532,11743328,676,-5,2016-07-11
Citizen Bank International Limited,118,676,618,666,25344,16651415,671,-5,2016-07-12
Citizen Bank International Limited,104,667,651,664,23267,15304227,666,-2,2016-07-13
Citizen Bank International Limited,113,685,664,680,36136,24299244,664,16,2016-07-14
Citizen Bank International Limited,226,708,690,708,56592,39748974,680,28,2016-07-17
Citizen Bank International Limited,150,758,720,745,39551,29305764,708,37,2016-07-18
Citizen Bank International Limited,207,761,743,749,43370,32608365,745,4,2016-07-19
Citizen Bank International Limited,184,770,727,731,44779,33175974,749,-18,2016-07-20
Citizen Bank International Limited,130,742,715,736,26741,19600950,731,5,2016-07-21
Citizen Bank International Limited,207,780,740,755,58643,44416051,736,19,2016-07-25
Citizen Bank International Limited,196,772,750,770,50559,38675450,755,15,2016-07-26
Citizen Bank International Limited,192,790,760,771,40799,31596725,770,1,2016-07-27
Citizen Bank International Limited,166,775,752,760,41941,32051976,771,-11,2016-07-28
Citizen Bank International Limited,134,763,747,755,28513,21418239,760,-5,2016-07-31
Citizen Bank International Limited,128,753,740,743,28959,21576785,755,-12,2016-08-01
Citizen Bank International Limited,94,740,721,733,19076,14009950,743,-10,2016-08-02
Citizen Bank International Limited,135,741,710,728,31185,22640019,733,-5,2016-08-03
Citizen Bank International Limited,173,728,690,713,33607,23990413,728,-15,2016-08-04
Citizen Bank International Limited,154,741,715,720,28173,20462246,713,7,2016-08-07
Citizen Bank International Limited,123,715,680,680,23537,16501601,720,-40,2016-08-08
Citizen Bank International Limited,4,721,693,721,858,607072,680,41,2016-08-09
Citizen Bank International Limited,226,750,706,730,48952,35788355,721,9,2016-08-10
Citizen Bank International Limited,116,733,716,720,21506,15562230,730,-10,2016-08-11
Citizen Bank International Limited,101,722,700,708,16863,11951794,720,-12,2016-08-14
Citizen Bank International Limited,157,700,672,691,35728,24568844,708,-17,2016-08-15
Citizen Bank International Limited,193,775,760,766,34664,26558788,769,-3,2016-08-31
Citizen Bank International Limited,124,725,682,705,25373,17763072,691,14,2016-08-16
Citizen Bank International Limited,117,717,707,714,18607,13252525,705,9,2016-08-17
Citizen Bank International Limited,63,720,700,703,10283,7289603,714,-11,2016-08-21
Citizen Bank International Limited,59,701,689,693,11891,8234851,703,-10,2016-08-22
Citizen Bank International Limited,99,715,683,685,23218,16064861,693,-8,2016-08-23
Citizen Bank International Limited,57,711,686,696,11542,8028965,685,11,2016-08-24
Citizen Bank International Limited,101,728,695,709,23030,16262412,696,13,2016-08-28
Citizen Bank International Limited,207,753,716,745,36147,26586020,709,36,2016-08-29
Citizen Bank International Limited,494,780,752,769,105594,80707069,745,24,2016-08-30
Citizen Bank International Limited,172,773,760,763,38591,29509064,766,-3,2016-09-01
Citizen Bank International Limited,206,770,736,754,50861,37921831,763,-9,2016-09-04
Citizen Bank International Limited,192,750,735,737,43596,32293100,754,-17,2016-09-05
Citizen Bank International Limited,185,750,735,740,49975,37050663,737,3,2016-09-06
Citizen Bank International Limited,118,740,728,730,23702,17430662,740,-10,2016-09-07
Citizen Bank International Limited,97,735,713,725,19551,14144943,730,-5,2016-09-08
Citizen Bank International Limited,108,724,707,718,18242,13021550,725,-7,2016-09-11
Citizen Bank International Limited,324,748,725,748,63107,46760994,718,30,2016-09-12
Citizen Bank International Limited,299,760,750,754,44993,33955838,748,6,2016-09-14
Citizen Bank International Limited,166,751,728,729,24892,18360738,754,-25,2016-09-18
Citizen Bank International Limited,152,744,715,718,22507,16240080,729,-11,2016-09-20
Citizen Bank International Limited,322,732,704,711,60254,42824184,718,-7,2016-09-21
Citizen Bank International Limited,109,610,593,595,20343,12207756,614,-19,2016-09-22
Citizen Bank International Limited,78,595,566,575,13267,7596285,595,-20,2016-09-25
Citizen Bank International Limited,65,610,577,592,10975,6519978,575,17,2016-09-26
Citizen Bank International Limited,64,600,586,590,8720,5168406,592,-2,2016-09-27
Citizen Bank International Limited,53,600,580,585,8034,4686351,590,-5,2016-09-28
Citizen Bank International Limited,60,590,577,590,10241,5943769,585,5,2016-09-29
Citizen Bank International Limited,72,600,580,581,11687,6841100,590,-9,2016-10-02
Citizen Bank International Limited,77,600,589,598,13983,8308826,581,17,2016-10-03
Citizen Bank International Limited,96,599,574,594,19325,11359226,598,-4,2016-10-04
Citizen Bank International Limited,88,599,590,595,19128,11327267,594,1,2016-10-05
Citizen Bank International Limited,128,600,591,599,28469,16966866,595,4,2016-10-06
Citizen Bank International Limited,59,600,580,580,10905,6369187,599,-19,2016-10-16
Citizen Bank International Limited,78,586,577,581,17240,10005904,580,1,2016-10-17
Citizen Bank International Limited,122,581,566,568,25055,14300681,581,-13,2016-10-18
Citizen Bank International Limited,80,575,565,575,15916,9074036,568,7,2016-10-19
Citizen Bank International Limited,96,580,565,567,18527,10571440,575,-8,2016-10-20
Citizen Bank International Limited,187,584,561,563,41810,23921868,567,-4,2016-10-23
Citizen Bank International Limited,100,574,552,560,21609,12166972,563,-3,2016-10-24
Citizen Bank International Limited,95,571,550,557,27003,15013230,560,-3,2016-10-25
Citizen Bank International Limited,117,570,550,556,22026,12166401,557,-1,2016-10-26
Citizen Bank International Limited,78,568,550,559,11565,6501695,556,3,2016-10-27
Citizen Bank International Limited,48,560,540,554,8516,4670149,559,-5,2016-11-03
Citizen Bank International Limited,95,557,540,544,15802,8588885,554,-10,2016-11-07
Citizen Bank International Limited,107,541,525,530,21537,11391302,544,-14,2016-11-08
Citizen Bank International Limited,137,530,505,521,31675,16454781,530,-9,2016-11-09
Citizen Bank International Limited,135,532,516,525,21923,11466996,521,4,2016-11-10
Citizen Bank International Limited,63,530,512,524,18745,9806864,525,-1,2016-11-13
Citizen Bank International Limited,76,528,516,528,14312,7528001,524,4,2016-11-14
Citizen Bank International Limited,96,535,525,525,18050,9570590,528,-3,2016-11-15
Citizen Bank International Limited,70,525,517,520,9483,4938648,525,-5,2016-11-16
Citizen Bank International Limited,141,520,500,507,28316,14385938,520,-13,2016-11-17
Citizen Bank International Limited,202,512,480,495,35078,17184013,507,-12,2016-11-20
Citizen Bank International Limited,197,509,477,497,38236,18745301,495,2,2016-11-21
Citizen Bank International Limited,155,504,480,491,24280,11953834,497,-6,2016-11-22
Citizen Bank International Limited,157,492,480,490,33218,16111041,491,-1,2016-11-23
Citizen Bank International Limited,143,507,482,490,29091,14226529,490,0,2016-11-24
Citizen Bank International Limited,203,490,462,469,36440,17308092,490,-21,2016-11-27
Citizen Bank International Limited,166,500,445,487,34599,15984682,469,18,2016-11-28
Citizen Bank International Limited,230,500,470,500,38597,18931934,487,13,2016-11-29
Citizen Bank International Limited,240,515,492,510,47765,24275388,500,10,2016-11-30
Citizen Bank International Limited,228,520,500,507,35575,18143672,510,-3,2016-12-01
Citizen Bank International Limited,136,507,490,498,23709,11814613,507,-9,2016-12-04
Citizen Bank International Limited,81,497,489,490,9613,4729336,498,-8,2016-12-05
Citizen Bank International Limited,162,504,490,500,27663,13773745,490,10,2016-12-06
Citizen Bank International Limited,133,506,497,502,30890,15432296,500,2,2016-12-07
Citizen Bank International Limited,87,500,497,498,12028,5997251,502,-4,2016-12-08
Citizen Bank International Limited,91,500,492,492,12855,6372591,498,-6,2016-12-11
Citizen Bank International Limited,84,495,480,491,9247,4531230,492,-1,2016-12-12
Citizen Bank International Limited,63,498,490,496,9177,4535827,491,5,2016-12-14
Citizen Bank International Limited,64,500,492,497,13220,6536485,496,1,2016-12-15
Citizen Bank International Limited,66,500,492,498,8863,4399107,497,1,2016-12-18
Citizen Bank International Limited,64,497,489,492,10860,5350775,498,-6,2016-12-19
Citizen Bank International Limited,84,494,479,489,14125,6865221,492,-3,2016-12-20
Citizen Bank International Limited,43,489,482,483,7057,3416447,489,-6,2016-12-21
Citizen Bank International Limited,54,490,478,481,6117,2954044,483,-2,2016-12-22
Citizen Bank International Limited,83,482,465,467,12487,5874353,481,-14,2016-12-26
Citizen Bank International Limited,107,472,451,455,18635,8536083,467,-12,2016-12-27
Citizen Bank International Limited,119,464,450,454,20821,9542661,455,-1,2016-12-28
Citizen Bank International Limited,102,473,460,463,16442,7651815,454,9,2016-12-29
Citizen Bank International Limited,133,482,469,470,23819,11335965,463,7,2017-01-01
Citizen Bank International Limited,293,497,473,495,57360,27785160,470,25,2017-01-02
Citizen Bank International Limited,199,504,480,490,38706,19026283,495,-5,2017-01-03
Citizen Bank International Limited,66,495,483,487,10617,5196705,490,-3,2017-01-04
Citizen Bank International Limited,109,496,485,487,23422,11460681,487,0,2017-01-05
Citizen Bank International Limited,122,489,470,478,64037,30324545,487,-9,2017-01-08
Citizen Bank International Limited,102,487,472,481,27127,12988498,478,3,2017-01-09
Citizen Bank International Limited,83,490,481,489,9787,4767734,481,8,2017-01-10
Citizen Bank International Limited,102,505,475,485,16930,8193930,489,-4,2017-01-11
Citizen Bank International Limited,76,490,483,490,13927,6762469,485,5,2017-01-12
Citizen Bank International Limited,99,488,478,480,24037,11567504,490,-10,2017-01-15
Citizen Bank International Limited,77,482,478,478,15176,7275108,480,-2,2017-01-16
Citizen Bank International Limited,51,488,475,488,8380,4037041,478,10,2017-01-17
Citizen Bank International Limited,72,490,478,480,11593,5574255,488,-8,2017-01-18
Citizen Bank International Limited,77,482,475,477,14819,7088247,480,-3,2017-01-19
Citizen Bank International Limited,69,480,474,475,9577,4562775,477,-2,2017-01-22
Citizen Bank International Limited,128,475,466,467,24004,11250194,475,-8,2017-01-23
Citizen Bank International Limited,107,476,456,456,14259,6550724,467,-11,2017-01-24
Citizen Bank International Limited,141,459,439,444,18426,8235177,456,-12,2017-01-25
Citizen Bank International Limited,162,455,428,436,27168,11866982,444,-8,2017-01-26
Citizen Bank International Limited,172,432,415,416,29106,12225344,436,-20,2017-01-30
Citizen Bank International Limited,153,434,405,420,22900,9588732,416,4,2017-01-31
Citizen Bank International Limited,134,459,426,459,24159,10644695,420,39,2017-02-01
Citizen Bank International Limited,150,485,441,446,29170,13287387,459,-13,2017-02-02
Citizen Bank International Limited,58,446,430,440,4464,1964484,446,-6,2017-02-05
Citizen Bank International Limited,84,443,425,440,13798,5966612,440,0,2017-02-06
Citizen Bank International Limited,105,448,432,440,16074,7043106,440,0,2017-02-07
Citizen Bank International Limited,93,440,427,430,11339,4889162,440,-10,2017-02-08
Citizen Bank International Limited,138,435,420,422,28714,12226787,430,-8,2017-02-09
Citizen Bank International Limited,166,422,406,409,23643,9696869,422,-13,2017-02-12
Citizen Bank International Limited,201,432,393,425,32261,13048143,409,16,2017-02-13
Citizen Bank International Limited,137,430,404,423,23162,9747982,425,-2,2017-02-14
Citizen Bank International Limited,137,435,423,434,19976,8568173,423,11,2017-02-15
Citizen Bank International Limited,171,447,430,437,27387,11939521,434,3,2017-02-16
Citizen Bank International Limited,184,445,429,443,33227,14541508,437,6,2017-02-19
Citizen Bank International Limited,146,462,437,439,22175,9825370,443,-4,2017-02-20
Citizen Bank International Limited,141,450,433,439,24523,10768314,439,0,2017-02-21
Citizen Bank International Limited,58,437,428,434,10960,4738615,439,-5,2017-02-22
Citizen Bank International Limited,74,434,425,425,11572,4953931,434,-9,2017-02-23
Citizen Bank International Limited,83,431,420,423,10685,4521614,425,-2,2017-02-26
Citizen Bank International Limited,113,424,415,422,16896,7078122,423,-1,2017-02-28
Citizen Bank International Limited,71,432,422,430,11877,5075748,422,8,2017-03-01
Citizen Bank International Limited,144,439,430,438,21289,9239104,430,8,2017-03-02
Citizen Bank International Limited,279,448,440,444,43559,19388124,438,6,2017-03-05
Citizen Bank International Limited,125,405,374,405,76368,29598405,385,20,2017-03-21
Citizen Bank International Limited,246,452,442,444,36020,16114756,444,0,2017-03-06
Citizen Bank International Limited,523,444,433,435,83581,36525642,444,-9,2017-03-07
Citizen Bank International Limited,133,371,354,371,24470,8937636,368,3,2017-03-09
Citizen Bank International Limited,58,380,365,377,11320,4253977,371,6,2017-03-13
Citizen Bank International Limited,68,380,372,372,10219,3819225,377,-5,2017-03-14
Citizen Bank International Limited,41,378,365,371,6903,2554789,372,-1,2017-03-15
Citizen Bank International Limited,52,379,370,374,11493,4313938,371,3,2017-03-16
Citizen Bank International Limited,66,380,371,378,12167,4580200,374,4,2017-03-19
Citizen Bank International Limited,89,391,380,385,19180,7371950,378,7,2017-03-20
Citizen Bank International Limited,187,426,408,413,36079,15136626,405,8,2017-03-22
Citizen Bank International Limited,129,420,405,410,20629,8477451,413,-3,2017-03-23
Citizen Bank International Limited,157,429,400,420,37702,15657281,410,10,2017-03-26
Citizen Bank International Limited,117,444,420,431,23529,10144388,420,11,2017-03-28
Citizen Bank International Limited,224,465,424,429,59715,26190392,431,-2,2017-03-29
Citizen Bank International Limited,157,435,412,427,32565,13771265,429,-2,2017-03-30
Citizen Bank International Limited,72,450,430,450,25513,11115622,427,23,2017-04-02
Citizen Bank International Limited,205,469,434,435,54700,24649043,450,-15,2017-04-03
Citizen Bank International Limited,140,460,424,437,24315,10669513,435,2,2017-04-04
Citizen Bank International Limited,87,448,427,431,31692,13688196,437,-6,2017-04-06
Citizen Bank International Limited,107,443,425,427,34452,14768535,431,-4,2017-04-09
Citizen Bank International Limited,88,430,422,427,24873,10563083,427,0,2017-04-10
Citizen Bank International Limited,117,450,427,438,28019,12269826,427,11,2017-04-11
Citizen Bank International Limited,121,448,436,440,28426,12579177,438,2,2017-04-12
Citizen Bank International Limited,91,443,430,440,29088,12687814,440,0,2017-04-13
Citizen Bank International Limited,107,445,426,426,35653,15477398,440,-14,2017-04-16
Citizen Bank International Limited,138,425,410,413,26884,11137600,426,-13,2017-04-18
Citizen Bank International Limited,85,435,412,433,21687,9090980,413,20,2017-04-19
Citizen Bank International Limited,93,440,424,427,22229,9529886,433,-6,2017-04-20
Citizen Bank International Limited,128,451,426,435,27028,11860981,427,8,2017-04-23
Citizen Bank International Limited,74,438,423,424,16675,7128896,435,-11,2017-04-24
Citizen Bank International Limited,87,427,417,420,23374,9838755,424,-4,2017-04-25
Citizen Bank International Limited,68,421,415,415,10145,4238792,420,-5,2017-04-26
Citizen Bank International Limited,88,419,410,412,14566,6035532,415,-3,2017-04-27
Citizen Bank International Limited,131,418,404,405,33365,13588497,412,-7,2017-04-30
Citizen Bank International Limited,111,416,400,405,28119,11469379,405,0,2017-05-02
Citizen Bank International Limited,131,421,400,408,38983,15806296,405,3,2017-05-03
Citizen Bank International Limited,99,414,402,402,18020,7309215,408,-6,2017-05-04
Citizen Bank International Limited,74,410,398,400,12469,5016502,402,-2,2017-05-07
Citizen Bank International Limited,50,407,400,402,8339,3362812,400,2,2017-05-08
Citizen Bank International Limited,79,405,397,402,17825,7134710,402,0,2017-05-09
Citizen Bank International Limited,81,405,400,403,18308,7355014,402,1,2017-05-11
Citizen Bank International Limited,46,406,402,403,10373,4190477,403,0,2017-05-15
Citizen Bank International Limited,36,404,400,402,5893,2371252,403,-1,2017-05-16
Citizen Bank International Limited,57,405,398,400,8418,3374897,402,-2,2017-05-17
Citizen Bank International Limited,63,401,396,400,29557,11822814,400,0,2017-05-18
Citizen Bank International Limited,74,408,390,397,11705,4632186,400,-3,2017-05-21
Citizen Bank International Limited,58,404,385,390,13622,5366859,397,-7,2017-05-22
Citizen Bank International Limited,48,400,394,399,10617,4216215,390,9,2017-05-23
Citizen Bank International Limited,53,400,393,396,11460,4555404,399,-3,2017-05-24
Citizen Bank International Limited,119,400,389,390,24899,9749003,396,-6,2017-05-28
Citizen Bank International Limited,67,399,380,386,11517,4440486,390,-4,2017-05-30
Citizen Bank International Limited,61,395,385,392,10160,3957514,386,6,2017-05-31
Citizen Bank International Limited,86,399,391,392,14561,5751730,392,0,2017-06-01
Citizen Bank International Limited,59,395,387,390,8662,3369200,392,-2,2017-06-04
Citizen Bank International Limited,75,400,390,395,13826,5433066,390,5,2017-06-05
Citizen Bank International Limited,118,405,396,400,22855,9156347,395,5,2017-06-06
Citizen Bank International Limited,85,408,398,398,11914,4787370,400,-2,2017-06-07
Citizen Bank International Limited,67,400,390,398,12734,5023821,398,0,2017-06-08
Citizen Bank International Limited,66,399,385,388,10166,3966643,398,-10,2017-06-11
Citizen Bank International Limited,52,395,386,387,6642,2588597,388,-1,2017-06-12
Citizen Bank International Limited,56,390,378,388,9112,3519979,387,1,2017-06-13
Citizen Bank International Limited,55,390,381,383,7711,2976391,388,-5,2017-06-14
Citizen Bank International Limited,81,390,377,390,12663,4873527,383,7,2017-06-15
Citizen Bank International Limited,56,392,378,380,12869,4909218,390,-10,2017-06-18
Citizen Bank International Limited,94,380,371,373,14471,5405258,380,-7,2017-06-19
Citizen Bank International Limited,75,380,365,375,13366,4979857,373,2,2017-06-20
Citizen Bank International Limited,43,380,370,375,8347,3140841,375,0,2017-06-21
Citizen Bank International Limited,71,381,375,380,13326,5034536,375,5,2017-06-22
Citizen Bank International Limited,91,385,381,381,13814,5286203,380,1,2017-06-25
Citizen Bank International Limited,66,385,380,382,10485,3998908,381,1,2017-06-27
Citizen Bank International Limited,51,380,377,380,12619,4778278,382,-2,2017-06-28
Citizen Bank International Limited,82,380,370,373,11406,4244615,380,-7,2017-07-02
Citizen Bank International Limited,61,379,370,372,10551,3921495,373,-1,2017-07-03
Citizen Bank International Limited,57,374,370,374,9968,3701037,372,2,2017-07-04
Citizen Bank International Limited,52,383,375,383,8382,3161522,374,9,2017-07-05
Citizen Bank International Limited,107,391,380,390,27926,10799475,383,7,2017-07-06
Citizen Bank International Limited,198,408,393,400,33780,13523055,390,10,2017-07-09
Citizen Bank International Limited,76,401,392,398,19465,7737359,400,-2,2017-07-10
Citizen Bank International Limited,66,400,390,400,14369,5681033,398,2,2017-07-11
Citizen Bank International Limited,70,404,392,404,10786,4305684,400,4,2017-07-12
Citizen Bank International Limited,108,407,400,403,21615,8748122,404,-1,2017-07-13
Citizen Bank International Limited,57,406,400,402,8893,3585704,403,-1,2017-07-16
Citizen Bank International Limited,62,406,394,406,8903,3587129,402,4,2017-07-17
Citizen Bank International Limited,66,411,405,409,9418,3837824,406,3,2017-07-18
Citizen Bank International Limited,137,395,382,386,51220,19941851,383,3,2017-08-03
Citizen Bank International Limited,91,412,403,412,24167,9870544,409,3,2017-07-19
Citizen Bank International Limited,69,410,406,408,17016,6944987,412,-4,2017-07-20
Citizen Bank International Limited,184,400,389,393,43921,17265987,408,-15,2017-07-23
Citizen Bank International Limited,109,390,385,388,19018,7358020,393,-5,2017-07-24
Citizen Bank International Limited,84,393,381,384,12759,4932354,388,-4,2017-07-25
Citizen Bank International Limited,162,385,379,384,27472,10450873,384,0,2017-07-26
Citizen Bank International Limited,108,386,379,380,22159,8446335,384,-4,2017-07-27
Citizen Bank International Limited,102,383,375,378,23049,8759034,380,-2,2017-07-30
Citizen Bank International Limited,115,390,380,382,19291,7394083,378,4,2017-07-31
Citizen Bank International Limited,81,383,379,379,12108,4614641,382,-3,2017-08-01
Citizen Bank International Limited,139,388,380,383,26552,10215288,379,4,2017-08-02
Citizen Bank International Limited,125,392,385,391,30233,11761485,386,5,2017-08-06
Citizen Bank International Limited,114,393,390,392,26173,10229055,391,1,2017-08-07
Citizen Bank International Limited,105,393,387,387,16965,6619347,392,-5,2017-08-09
Citizen Bank International Limited,129,388,380,381,23758,9112878,387,-6,2017-08-10
Citizen Bank International Limited,96,388,375,377,16613,6264929,381,-4,2017-08-13
Citizen Bank International Limited,96,380,370,375,23542,8819831,377,-2,2017-08-15
Citizen Bank International Limited,95,380,370,380,19404,7242674,375,5,2017-08-16
Citizen Bank International Limited,87,380,372,380,17650,6611474,380,0,2017-08-17
Citizen Bank International Limited,145,382,371,375,20236,7601875,380,-5,2017-08-20
Citizen Bank International Limited,161,378,372,375,26015,9749191,375,0,2017-08-21
Citizen Bank International Limited,214,380,372,380,40684,15329369,375,5,2017-08-22
Citizen Bank International Limited,214,383,375,378,51989,19664455,380,-2,2017-08-23
Citizen Bank International Limited,231,380,372,377,140495,52582116,378,-1,2017-08-24
Citizen Bank International Limited,602,382,375,375,113354,42778088,377,-2,2017-08-27
Citizen Bank International Limited,127,324,310,314,25080,7850052,323,-9,2017-08-28
Citizen Bank International Limited,145,316,301,302,21421,6565587,314,-12,2017-08-30
Citizen Bank International Limited,149,306,300,300,22580,6823437,302,-2,2017-08-31
Citizen Bank International Limited,132,303,294,294,27409,8167938,300,-6,2017-09-04
Citizen Bank International Limited,118,305,290,295,15945,4690159,294,1,2017-09-06
Citizen Bank International Limited,95,298,292,297,15285,4518014,295,2,2017-09-07
Citizen Bank International Limited,127,302,290,293,21759,6355822,297,-4,2017-09-10
Citizen Bank International Limited,84,295,290,295,17166,5027571,293,2,2017-09-11
Citizen Bank International Limited,81,295,290,292,16205,4726330,295,-3,2017-09-12
Citizen Bank International Limited,72,293,290,291,9829,2860127,292,-1,2017-09-13
Citizen Bank International Limited,111,305,291,299,19913,5925818,291,8,2017-09-14
Citizen Bank International Limited,107,311,298,302,13144,3980597,299,3,2017-09-17
Citizen Bank International Limited,64,305,299,301,8233,2481042,302,-1,2017-09-18
Citizen Bank International Limited,86,302,294,294,12147,3631569,301,-7,2017-09-20
Citizen Bank International Limited,53,300,293,296,6975,2065197,300,-4,2017-10-09
Citizen Bank International Limited,46,302,295,300,8596,2581601,294,6,2017-09-24
Citizen Bank International Limited,47,306,300,302,6454,1950647,300,2,2017-09-25
Citizen Bank International Limited,65,309,304,306,9836,3011410,302,4,2017-09-26
Citizen Bank International Limited,36,308,300,305,5140,1567971,306,-1,2017-10-03
Citizen Bank International Limited,34,305,299,303,12838,3874350,305,-2,2017-10-04
Citizen Bank International Limited,69,303,290,300,10084,2963653,303,-3,2017-10-08
Citizen Bank International Limited,47,300,292,295,5999,1777851,296,-1,2017-10-10
Citizen Bank International Limited,82,298,290,293,13126,3851473,295,-2,2017-10-11
Citizen Bank International Limited,47,296,292,293,10153,2988921,293,0,2017-10-12
Citizen Bank International Limited,67,297,289,289,12491,3652687,293,-4,2017-10-15
Citizen Bank International Limited,101,303,292,303,31751,9410249,289,14,2017-10-16
Citizen Bank International Limited,110,313,303,307,23980,7383386,303,4,2017-10-17
Citizen Bank International Limited,48,313,304,308,12958,4008537,307,1,2017-10-18
Citizen Bank International Limited,67,322,308,315,12918,4073069,308,7,2017-10-22
Citizen Bank International Limited,69,316,305,311,15602,4824054,315,-4,2017-10-23
Citizen Bank International Limited,58,312,306,310,8957,2764562,311,-1,2017-10-24
Citizen Bank International Limited,63,308,303,305,11816,3602544,310,-5,2017-10-25
Citizen Bank International Limited,56,303,299,300,12661,3799208,305,-5,2017-10-29
Citizen Bank International Limited,84,304,298,300,17176,5159841,300,0,2017-10-30
Citizen Bank International Limited,35,300,297,298,8941,2667354,300,-2,2017-10-31
Citizen Bank International Limited,72,298,294,296,13660,4030441,298,-2,2017-11-01
Citizen Bank International Limited,62,298,294,295,18567,5507018,296,-1,2017-11-02
Citizen Bank International Limited,82,295,290,295,18873,5518081,295,0,2017-11-05
Citizen Bank International Limited,85,296,290,295,16097,4706594,295,0,2017-11-06
Citizen Bank International Limited,48,298,290,293,8135,2392607,295,-2,2017-11-07
Citizen Bank International Limited,61,290,285,290,14387,4164494,293,-3,2017-11-08
Citizen Bank International Limited,70,294,280,290,7666,2215513,290,0,2017-11-09
Citizen Bank International Limited,59,294,287,294,8471,2467127,290,4,2017-11-12
Citizen Bank International Limited,65,298,292,297,12087,3576941,294,3,2017-11-13
Citizen Bank International Limited,84,301,295,299,17702,5290840,297,2,2017-11-14
Citizen Bank International Limited,100,300,290,290,27462,8048490,299,-9,2017-11-15
Citizen Bank International Limited,35,296,292,293,4085,1197832,290,3,2017-11-16
Citizen Bank International Limited,31,293,290,291,9326,2711000,293,-2,2017-11-19
Citizen Bank International Limited,40,293,288,292,7327,2131357,291,1,2017-11-20
Citizen Bank International Limited,29,294,292,292,4032,1179306,292,0,2017-11-21
Citizen Bank International Limited,52,295,290,293,8329,2430983,292,1,2017-11-22
Citizen Bank International Limited,76,297,285,295,75891,21823175,293,2,2017-11-23
Citizen Bank International Limited,73,303,293,302,17869,5335330,295,7,2017-11-26
Citizen Bank International Limited,107,304,297,304,47844,14487486,302,2,2017-11-27
Citizen Bank International Limited,86,309,299,304,19262,5834061,304,0,2017-11-28
Citizen Bank International Limited,96,307,302,304,22878,6976207,304,0,2017-11-29
Citizen Bank International Limited,68,305,299,302,20013,6034654,304,-2,2017-11-30
Citizen Bank International Limited,50,308,297,299,11266,3381040,302,-3,2017-12-04
Citizen Bank International Limited,57,293,290,291,16735,4863378,293,-2,2017-12-20
Citizen Bank International Limited,63,301,297,298,45698,13661549,299,-1,2017-12-05
Citizen Bank International Limited,71,305,297,305,14839,4453161,298,7,2017-12-06
Citizen Bank International Limited,50,307,298,298,9716,2926727,305,-7,2017-12-10
Citizen Bank International Limited,46,303,296,300,11629,3451261,298,2,2017-12-11
Citizen Bank International Limited,49,304,294,294,8347,2463921,300,-6,2017-12-12
Citizen Bank International Limited,47,299,290,298,28977,8466492,294,4,2017-12-13
Citizen Bank International Limited,42,302,295,298,14128,4209012,298,0,2017-12-14
Citizen Bank International Limited,60,300,292,295,18164,5350078,298,-3,2017-12-17
Citizen Bank International Limited,66,297,292,294,19708,5797410,295,-1,2017-12-18
Citizen Bank International Limited,27,295,292,293,5252,1539858,294,-1,2017-12-19
Citizen Bank International Limited,27,293,290,291,5051,1468963,291,0,2017-12-21
Citizen Bank International Limited,53,294,290,291,9598,2801964,291,0,2017-12-24
Citizen Bank International Limited,46,293,287,288,13631,3932095,291,-3,2017-12-26
Citizen Bank International Limited,65,289,283,286,11637,3328796,288,-2,2017-12-27
Citizen Bank International Limited,75,285,279,282,24513,6893658,286,-4,2017-12-28
Citizen Bank International Limited,64,282,278,280,14598,4084121,282,-2,2017-12-31
Citizen Bank International Limited,72,290,280,287,24608,7021112,280,7,2018-01-01
Citizen Bank International Limited,79,291,285,290,20398,5902750,287,3,2018-01-02
Citizen Bank International Limited,32,292,285,286,7468,2145872,290,-4,2018-01-03
Citizen Bank International Limited,55,288,282,285,10628,3023070,286,-1,2018-01-04
Citizen Bank International Limited,41,290,285,288,5433,1568724,285,3,2018-01-07
Citizen Bank International Limited,56,290,287,290,8771,2536039,288,2,2018-01-08
Citizen Bank International Limited,52,291,280,290,40858,11508399,290,0,2018-01-09
Citizen Bank International Limited,59,290,287,290,11259,3248272,290,0,2018-01-10
Citizen Bank International Limited,69,294,282,285,17788,5069732,290,-5,2018-01-14
Citizen Bank International Limited,43,288,280,283,7728,2185848,285,-2,2018-01-16
Citizen Bank International Limited,118,283,280,280,36278,10176277,283,-3,2018-01-17
Citizen Bank International Limited,80,281,278,280,17488,4891594,280,0,2018-01-21
Citizen Bank International Limited,42,280,277,279,11532,3205870,280,-1,2018-01-22
Citizen Bank International Limited,69,279,272,272,14487,3992851,279,-7,2018-01-23
Citizen Bank International Limited,71,273,267,270,18068,4882504,272,-2,2018-01-24
Citizen Bank International Limited,61,275,263,275,24111,6442314,270,5,2018-01-25
Citizen Bank International Limited,72,280,272,280,28460,7789478,275,5,2018-01-28
Citizen Bank International Limited,60,280,274,274,10648,2936958,280,-6,2018-01-29
Citizen Bank International Limited,53,275,273,275,8368,2293672,274,1,2018-01-31
Citizen Bank International Limited,59,276,273,273,14026,3845732,275,-2,2018-02-01
Citizen Bank International Limited,60,277,268,273,12072,3309267,273,0,2018-02-04
Citizen Bank International Limited,29,275,270,272,4921,1338140,273,-1,2018-02-05
Citizen Bank International Limited,19,274,270,273,4480,1213629,272,1,2018-02-06
Citizen Bank International Limited,40,275,268,270,14894,4024505,273,-3,2018-02-07
Citizen Bank International Limited,21,275,270,275,5479,1491421,270,5,2018-02-08
Citizen Bank International Limited,45,280,275,275,7324,2021656,277,-2,2018-02-25
Citizen Bank International Limited,35,275,270,273,5691,1549747,275,-2,2018-02-11
Citizen Bank International Limited,40,273,271,273,9630,2612988,273,0,2018-02-12
Citizen Bank International Limited,51,276,273,275,7188,1970989,273,2,2018-02-14
Citizen Bank International Limited,105,290,271,288,41583,11540569,275,13,2018-02-15
Citizen Bank International Limited,95,292,283,285,22504,6441828,288,-3,2018-02-18
Citizen Bank International Limited,39,288,276,283,7718,2160766,285,-2,2018-02-20
Citizen Bank International Limited,25,280,277,277,5432,1507387,283,-6,2018-02-21
Citizen Bank International Limited,37,282,274,277,6751,1868612,277,0,2018-02-22
Citizen Bank International Limited,42,280,271,271,9801,2666867,275,-4,2018-02-26
Citizen Bank International Limited,52,274,270,270,11834,3213113,271,-1,2018-02-27
Citizen Bank International Limited,51,271,269,270,10705,2888511,270,0,2018-02-28
Citizen Bank International Limited,54,267,256,264,10325,2708111,270,-6,2018-03-04
Citizen Bank International Limited,66,268,256,263,24189,6258233,264,-1,2018-03-05
Citizen Bank International Limited,72,268,258,266,17112,4490021,263,3,2018-03-06
Citizen Bank International Limited,47,270,264,268,7864,2097658,266,2,2018-03-07
Citizen Bank International Limited,48,268,259,263,7783,2026792,268,-5,2018-03-11
Citizen Bank International Limited,42,266,255,265,7388,1929922,263,2,2018-03-12
Citizen Bank International Limited,25,270,262,265,5895,1552288,265,0,2018-03-13
Citizen Bank International Limited,23,270,261,270,5682,1507521,265,5,2018-03-14
Citizen Bank International Limited,44,272,267,268,7238,1943345,270,-2,2018-03-15
Citizen Bank International Limited,46,272,263,263,6343,1681004,268,-5,2018-03-18
Citizen Bank International Limited,44,264,259,260,12414,3236950,263,-3,2018-03-19
Citizen Bank International Limited,40,264,257,260,6138,1585702,260,0,2018-03-20
Citizen Bank International Limited,62,259,250,255,15633,3972791,260,-5,2018-03-21
Citizen Bank International Limited,70,259,251,257,18472,4672061,255,2,2018-03-22
Citizen Bank International Limited,73,252,245,248,15172,3751677,257,-9,2018-03-26
Citizen Bank International Limited,88,267,236,250,22842,5636331,248,2,2018-03-27
Citizen Bank International Limited,82,259,243,251,37083,9199944,250,1,2018-03-28
Citizen Bank International Limited,48,261,251,256,9475,2408249,251,5,2018-03-29
Citizen Bank International Limited,67,253,246,250,9484,2376900,256,-6,2018-04-01
Citizen Bank International Limited,21,255,250,255,3351,853061,250,5,2018-04-02
Citizen Bank International Limited,53,255,250,253,12578,3172513,255,-2,2018-04-03
Citizen Bank International Limited,71,258,252,255,14092,3598613,253,2,2018-04-04
Citizen Bank International Limited,104,262,255,258,38753,9965961,255,3,2018-04-05
Citizen Bank International Limited,149,272,255,268,43827,11449071,258,10,2018-04-08
Citizen Bank International Limited,167,272,263,264,31607,8423729,268,-4,2018-04-09
Citizen Bank International Limited,71,266,257,259,13495,3497225,264,-5,2018-04-10
Citizen Bank International Limited,57,263,256,260,8482,2198976,259,1,2018-04-11
Citizen Bank International Limited,101,265,257,260,22750,5891194.9,260,0,2018-04-12
Citizen Bank International Limited,59,262,253,262,9909,2544694,260,2,2018-04-15
Citizen Bank International Limited,70,265,256,262,12543,3267866,262,0,2018-04-16
Citizen Bank International Limited,103,266,257,261,24787,6508704,262,-1,2018-04-17
Citizen Bank International Limited,145,275,263,265,46522,12468942,261,4,2018-04-18
Citizen Bank International Limited,186,277,261,275,42163,11540986,265,10,2018-04-19
Citizen Bank International Limited,289,297,280,294,71090,20461058,275,19,2018-04-22
Citizen Bank International Limited,268,300,280,285,77847,22689919,294,-9,2018-04-23
Citizen Bank International Limited,114,287,277,281,24475,6858357,285,-4,2018-04-24
Citizen Bank International Limited,86,285,277,282,16805,4704411,281,1,2018-04-25
Citizen Bank International Limited,105,279,270,270,24733,6773295,282,-12,2018-04-26
Citizen Bank International Limited,95,273,263,269,16652,4460738,270,-1,2018-04-29
Citizen Bank International Limited,67,273,267,270,8738,2348408,269,1,2018-05-02
Citizen Bank International Limited,83,278,266,273,13952,3796421,270,3,2018-05-03
Citizen Bank International Limited,48,272,268,268,8378,2260127,273,-5,2018-05-06
Citizen Bank International Limited,95,268,265,265,14737,3917639,268,-3,2018-05-07
Citizen Bank International Limited,55,274,264,274,7984,2135777,265,9,2018-05-08
Citizen Bank International Limited,42,275,267,269,4798,1296625,274,-5,2018-05-09
Citizen Bank International Limited,58,270,266,267,5325,1421281,269,-2,2018-05-10
Citizen Bank International Limited,80,267,263,263,9105,2411003,267,-4,2018-05-14
Citizen Bank International Limited,34,267,261,262,6778,1779279,263,-1,2018-05-15
Citizen Bank International Limited,38,266,263,266,5640,1496325,262,4,2018-05-16
Citizen Bank International Limited,49,268,265,268,12060,3216654,266,2,2018-05-17
Citizen Bank International Limited,35,270,265,266,5008,1337233,268,-2,2018-05-20
Citizen Bank International Limited,38,266,263,264,5355,1412694,266,-2,2018-05-21
Citizen Bank International Limited,34,269,262,263,4736,1250811,264,-1,2018-05-22
Citizen Investment Trust,5,4350,4300,4300,250,1080500,4340,-40,2016-05-23
Citizen Investment Trust,10,4400,4300,4400,1012,4384425,4300,100,2016-05-24
Citizen Investment Trust,9,4400,4290,4300,675,2911268,4400,-100,2016-05-25
Citizen Investment Trust,9,4386,4230,4386,1051,4496000,4300,86,2016-05-26
Citizen Investment Trust,18,4415,4330,4351,1417,6206110,4386,-35,2016-05-29
Citizen Investment Trust,21,4488,4350,4488,3428,15097766,4351,137,2016-05-30
Citizen Investment Trust,10,4420,4350,4400,1167,5091803,4488,-88,2016-05-31
Citizen Investment Trust,5,4410,4350,4410,383,1669480,4400,10,2016-06-01
Citizen Investment Trust,4,4400,4350,4350,260,1135000,4410,-60,2016-06-02
Citizen Investment Trust,5,4300,4264,4275,399,1711175,4350,-75,2016-06-05
Citizen Investment Trust,1,4300,4300,4300,100,430000,4275,25,2016-06-06
Citizen Investment Trust,2,4386,4360,4360,59,258254,4300,60,2016-06-07
Citizen Investment Trust,10,4400,4350,4350,1169,5099960,4435,-85,2016-06-23
Citizen Investment Trust,1,4400,4400,4400,20,88000,4360,40,2016-06-08
Citizen Investment Trust,16,4400,4350,4400,1760,7737050,4400,0,2016-06-09
Citizen Investment Trust,8,4450,4350,4400,598,2619000,4400,0,2016-06-12
Citizen Investment Trust,15,4400,4350,4400,1093,4796700,4400,0,2016-06-13
Citizen Investment Trust,9,4473,4400,4400,812,3594106,4400,0,2016-06-14
Citizen Investment Trust,9,4450,4405,4410,1188,5260570,4400,10,2016-06-15
Citizen Investment Trust,15,4450,4390,4430,1150,5072380,4410,20,2016-06-16
Citizen Investment Trust,3,4420,4400,4400,50,220800,4430,-30,2016-06-19
Citizen Investment Trust,7,4399,4350,4399,567,2472690,4400,-1,2016-06-20
Citizen Investment Trust,12,4410,4350,4350,1750,7617330,4399,-49,2016-06-21
Citizen Investment Trust,28,4450,4390,4435,4023,17745600,4350,85,2016-06-22
Citizen Investment Trust,15,4437,4400,4400,2516,11074986,4350,50,2016-06-26
Citizen Investment Trust,20,4520,4450,4500,2507,11256747,4400,100,2016-06-27
Citizen Investment Trust,20,4520,4425,4501,2628,11828907,4500,1,2016-06-28
Citizen Investment Trust,12,4510,4425,4510,698,3141230,4501,9,2016-06-29
Citizen Investment Trust,25,4600,4500,4600,2971,13469890,4510,90,2016-06-30
Citizen Investment Trust,25,5060,4600,4960,2029,9614149,4600,360,2016-07-03
Citizen Investment Trust,113,5456,5000,5440,11207,60176151,4960,480,2016-07-04
Citizen Investment Trust,26,5610,5250,5300,1559,8545660,5440,-140,2016-07-05
Citizen Investment Trust,20,5400,5146,5320,1036,5450102,5300,20,2016-07-06
Citizen Investment Trust,3,5390,5300,5390,170,910000,5320,70,2016-07-10
Citizen Investment Trust,6,5385,5350,5350,2696,14509210,5390,-40,2016-07-11
Citizen Investment Trust,29,5315,5050,5200,2480,12909560,5350,-150,2016-07-12
Citizen Investment Trust,10,5290,5050,5115,722,3717605,5200,-85,2016-07-13
Citizen Investment Trust,11,5250,5145,5145,850,4436450,5115,30,2016-07-14
Citizen Investment Trust,12,5230,5140,5210,1035,5365255,5145,65,2016-07-17
Citizen Investment Trust,3,5222,5120,5222,350,1815400,5210,12,2016-07-18
Citizen Investment Trust,13,5300,5201,5270,1253,6582843,5222,48,2016-07-19
Citizen Investment Trust,12,5250,5200,5250,1195,6257300,5270,-20,2016-07-20
Citizen Investment Trust,3,5250,5250,5250,130,682500,5250,0,2016-07-21
Citizen Investment Trust,15,5280,5200,5280,1049,5472430,5250,30,2016-07-25
Citizen Investment Trust,13,5375,5210,5280,1041,5482030,5280,0,2016-07-26
Citizen Investment Trust,7,5289,5201,5220,682,3562920,5280,-60,2016-07-27
Citizen Investment Trust,10,5360,5200,5301,2923,15297350,5220,81,2016-07-28
Citizen Investment Trust,12,5301,5200,5200,730,3826160,5301,-101,2016-07-31
Citizen Investment Trust,11,5220,5175,5220,867,4511015,5200,20,2016-08-01
Citizen Investment Trust,17,5250,5150,5250,1129,5857793,5220,30,2016-08-02
Citizen Investment Trust,13,5215,5125,5125,636,3287950,5250,-125,2016-08-03
Citizen Investment Trust,19,5095,4950,5000,938,4688610,5125,-125,2016-08-04
Citizen Investment Trust,21,5100,4991,5030,1855,9288710,5000,30,2016-08-07
Citizen Investment Trust,13,4930,4832,4832,712,3465830,5030,-198,2016-08-08
Citizen Investment Trust,1,4928,4928,4928,50,246400,4832,96,2016-08-09
Citizen Investment Trust,21,5026,4900,4950,1049,5176417,4928,22,2016-08-10
Citizen Investment Trust,3,5020,4925,4925,300,1489500,4950,-25,2016-08-11
Citizen Investment Trust,6,4876,4850,4860,577,2809820,4925,-65,2016-08-14
Citizen Investment Trust,11,4901,4706,4901,521,2479571,4860,41,2016-08-15
Citizen Investment Trust,5,4895,4770,4895,270,1297750,4860,35,2016-08-31
Citizen Investment Trust,11,4900,4803,4900,652,3175988,4901,-1,2016-08-16
Citizen Investment Trust,26,4905,4850,4850,1771,8648051,4900,-50,2016-08-17
Citizen Investment Trust,17,4877,4710,4730,869,4159074,4850,-120,2016-08-21
Citizen Investment Trust,38,4750,4500,4580,1899,8675662,4730,-150,2016-08-22
Citizen Investment Trust,34,4600,4430,4500,2240,10063440,4580,-80,2016-08-23
Citizen Investment Trust,30,4620,4482,4620,2759,12540402,4500,120,2016-08-24
Citizen Investment Trust,12,4800,4675,4800,657,3085420,4620,180,2016-08-28
Citizen Investment Trust,10,4870,4800,4870,638,3085935,4800,70,2016-08-29
Citizen Investment Trust,14,4869,4840,4860,1154,5597014,4870,-10,2016-08-30
Citizen Investment Trust,9,4990,4860,4899,208,1018910,4895,4,2016-09-01
Citizen Investment Trust,10,4899,4850,4851,548,2665665,4899,-48,2016-09-04
Citizen Investment Trust,5,4885,4850,4885,388,1886050,4851,34,2016-09-05
Citizen Investment Trust,13,4970,4850,4925,486,2379165,4885,40,2016-09-06
Citizen Investment Trust,2,4915,4900,4915,555,2726325,4925,-10,2016-09-07
Citizen Investment Trust,18,4855,4800,4805,1579,7614372,4915,-110,2016-09-08
Citizen Investment Trust,7,4800,4770,4800,542,2597240,4805,-5,2016-09-11
Citizen Investment Trust,9,4800,4765,4765,623,2983865,4800,-35,2016-09-12
Citizen Investment Trust,18,4798,4755,4765,747,3562107,4765,0,2016-09-14
Citizen Investment Trust,22,4765,4745,4755,341113,1200790365,4765,-10,2016-09-18
Citizen Investment Trust,4,4725,4675,4675,320,1502750,4755,-80,2016-09-20
Citizen Investment Trust,18,4715,4631,4660,1427,6683740,4675,-15,2016-09-21
Citizen Investment Trust,8,4615,4585,4590,643,2954840,4660,-70,2016-09-22
Citizen Investment Trust,8,4560,4430,4500,564,2531130,4590,-90,2016-09-25
Citizen Investment Trust,4,4599,4580,4599,159,730461,4500,99,2016-09-26
Citizen Investment Trust,14,4770,4580,4580,593,2747170,4599,-19,2016-09-27
Citizen Investment Trust,6,4589,4500,4589,465,2122375,4580,9,2016-09-28
Citizen Investment Trust,4,4599,4550,4561,192,877170,4589,-28,2016-09-29
Citizen Investment Trust,4,4600,4550,4600,142,646600,4561,39,2016-10-02
Citizen Investment Trust,6,4710,4670,4710,282,1321960,4600,110,2016-10-03
Citizen Investment Trust,7,4765,4700,4700,950,4499950,4710,-10,2016-10-04
Citizen Investment Trust,5,4743,4650,4743,206,967781,4700,43,2016-10-05
Citizen Investment Trust,12,4800,4710,4750,460,2186020,4743,7,2016-10-06
Citizen Investment Trust,6,4680,4655,4680,383,1788665,4750,-70,2016-10-16
Citizen Investment Trust,8,4660,4601,4660,362,1676720,4680,-20,2016-10-17
Citizen Investment Trust,2,4660,4655,4660,48,223615,4660,0,2016-10-18
Citizen Investment Trust,7,4641,4550,4641,239,1104985,4660,-19,2016-10-19
Citizen Investment Trust,3,4601,4600,4601,247,1136347,4641,-40,2016-10-20
Citizen Investment Trust,9,4610,4550,4570,542,2480075,4601,-31,2016-10-23
Citizen Investment Trust,12,4620,4500,4605,726,3333845,4570,35,2016-10-24
Citizen Investment Trust,6,4600,4550,4600,463,2117920,4605,-5,2016-10-25
Citizen Investment Trust,5,4600,4550,4600,528,2407740,4600,0,2016-10-26
Citizen Investment Trust,7,4600,4565,4565,217,995890,4600,-35,2016-10-27
Citizen Investment Trust,2,4645,4553,4553,301,1384345,4565,-12,2016-11-03
Citizen Investment Trust,8,4570,4550,4570,303,1381300,4553,17,2016-11-07
Citizen Investment Trust,3,4570,4550,4550,62,282500,4570,-20,2016-11-08
Citizen Investment Trust,2,4480,4465,4465,100,447250,4550,-85,2016-11-09
Citizen Investment Trust,8,4465,4360,4400,601,2640020,4465,-65,2016-11-10
Citizen Investment Trust,8,4450,4400,4450,291,1283320,4400,50,2016-11-13
Citizen Investment Trust,9,4620,4450,4518,284,1290064,4450,68,2016-11-14
Citizen Investment Trust,9,4595,4500,4511,438,1988775,4518,-7,2016-11-15
Citizen Investment Trust,10,4601,4500,4525,236,1071300,4511,14,2016-11-16
Citizen Investment Trust,2,4490,4435,4435,110,488400,4525,-90,2016-11-17
Citizen Investment Trust,31,4430,4100,4100,1459,6177458,4435,-335,2016-11-20
Citizen Investment Trust,19,4250,4030,4250,1166,4790430,4100,150,2016-11-21
Citizen Investment Trust,13,4200,4090,4090,843,3479740,4250,-160,2016-11-22
Citizen Investment Trust,21,4015,3929,4000,1090,4341330,4090,-90,2016-11-23
Citizen Investment Trust,27,4131,3900,4080,1732,6915067,4000,80,2016-11-24
Citizen Investment Trust,26,4000,3769,3850,1277,4904677,4080,-230,2016-11-27
Citizen Investment Trust,22,3990,3560,3990,989,3701020,3850,140,2016-11-28
Citizen Investment Trust,41,4140,3865,4058,2706,10657968,3990,68,2016-11-29
Citizen Investment Trust,43,4233,4000,4233,3320,13528641,4058,175,2016-11-30
Citizen Investment Trust,18,4260,4150,4155,1834,7646210,4233,-78,2016-12-01
Citizen Investment Trust,20,4160,4010,4010,1120,4566634,4155,-145,2016-12-04
Citizen Investment Trust,15,4010,3950,3950,902,3578095,4010,-60,2016-12-05
Citizen Investment Trust,11,4109,4027,4049,499,2022768,3950,99,2016-12-06
Citizen Investment Trust,15,4129,3980,3980,477,1922974,4049,-69,2016-12-07
Citizen Investment Trust,3,3987,3910,3987,86,337160,3980,7,2016-12-08
Citizen Investment Trust,3,3921,3908,3920,244,955962,3987,-67,2016-12-11
Citizen Investment Trust,6,3920,3845,3920,234,902634,3920,0,2016-12-12
Citizen Investment Trust,5,3940,3900,3920,357,1395100,3920,0,2016-12-14
Citizen Investment Trust,17,3945,3900,3945,719,2811475,3920,25,2016-12-15
Citizen Investment Trust,15,3930,3900,3912,1010,3953670,3945,-33,2016-12-18
Citizen Investment Trust,16,3950,3900,3915,1119,4402630,3912,3,2016-12-19
Citizen Investment Trust,9,3910,3830,3841,1181,4564580,3915,-74,2016-12-20
Citizen Investment Trust,28,3869,3715,3798,2535,9593843,3841,-43,2016-12-21
Citizen Investment Trust,11,3798,3725,3753,403,1517585,3798,-45,2016-12-22
Citizen Investment Trust,11,3700,3605,3605,591,2165230,3753,-148,2016-12-26
Citizen Investment Trust,41,3605,3470,3470,1595,5597990,3605,-135,2016-12-27
Citizen Investment Trust,28,3595,3405,3500,1601,5587430,3470,30,2016-12-28
Citizen Investment Trust,8,3750,3569,3740,115,420215,3500,240,2016-12-29
Citizen Investment Trust,12,3740,3690,3700,750,2778400,3740,-40,2017-01-01
Citizen Investment Trust,18,3730,3690,3705,1138,4211120,3700,5,2017-01-02
Citizen Investment Trust,2,3715,3715,3715,76,282340,3705,10,2017-01-03
Citizen Investment Trust,10,3720,3675,3680,930,3446750,3715,-35,2017-01-04
Citizen Investment Trust,11,3700,3681,3681,520,1918593,3680,1,2017-01-05
Citizen Investment Trust,9,3680,3625,3635,744,2707243,3681,-46,2017-01-08
Citizen Investment Trust,2,3699,3698,3699,300,1109500,3635,64,2017-01-09
Citizen Investment Trust,3,3774,3700,3745,209,778800,3699,46,2017-01-10
Citizen Investment Trust,11,3875,3760,3875,623,2369805,3745,130,2017-01-11
Citizen Investment Trust,11,3899,3800,3899,340,1298950,3875,24,2017-01-12
Citizen Investment Trust,8,3899,3835,3860,240,926950,3899,-39,2017-01-15
Citizen Investment Trust,5,3890,3860,3875,164,633490,3860,15,2017-01-16
Citizen Investment Trust,7,3875,3820,3820,420,1610300,3875,-55,2017-01-17
Citizen Investment Trust,4,3820,3745,3790,42,159150,3820,-30,2017-01-18
Citizen Investment Trust,14,3865,3785,3850,480,1829805,3790,60,2017-01-19
Citizen Investment Trust,7,3800,3724,3800,552,2084920,3850,-50,2017-01-22
Citizen Investment Trust,1,3876,3876,3876,10,38760,3800,76,2017-01-23
Citizen Investment Trust,9,3800,3724,3724,501,1878450,3876,-152,2017-01-24
Citizen Investment Trust,19,3650,3504,3504,830,2970990,3724,-220,2017-01-25
Citizen Investment Trust,51,3504,3401,3445,3494,12064180,3504,-59,2017-01-26
Citizen Investment Trust,63,3380,3101,3101,2627,8474580,3445,-344,2017-01-30
Citizen Investment Trust,38,3290,3039,3210,1795,5623658,3101,109,2017-01-31
Citizen Investment Trust,22,3380,3175,3380,1256,4106178,3210,170,2017-02-01
Citizen Investment Trust,32,3447,3265,3280,1925,6373275,3380,-100,2017-02-02
Citizen Investment Trust,13,3350,3251,3255,578,1896650,3280,-25,2017-02-05
Citizen Investment Trust,35,3230,3160,3160,1985,6314932,3255,-95,2017-02-06
Citizen Investment Trust,8,3160,3105,3160,361,1130705,3160,0,2017-02-07
Citizen Investment Trust,34,3159,3050,3080,1564,4819470,3160,-80,2017-02-08
Citizen Investment Trust,36,3098,2930,3020,1965,5947730,3080,-60,2017-02-09
Citizen Investment Trust,39,3000,2922,2943,1952,5780331,3020,-77,2017-02-12
Citizen Investment Trust,65,3009,2860,2920,3873,11240094,2943,-23,2017-02-13
Citizen Investment Trust,63,2965,2850,2900,4526,13103947,2920,-20,2017-02-14
Citizen Investment Trust,45,3005,2911,3005,2951,8789690,2900,105,2017-02-15
Citizen Investment Trust,49,3120,3000,3120,3068,9412769,3005,115,2017-02-16
Citizen Investment Trust,51,3432,3100,3365,3013,9530991,3120,245,2017-02-19
Citizen Investment Trust,54,3498,3211,3300,3444,11426059,3365,-65,2017-02-20
Citizen Investment Trust,46,3366,3133,3233,3123,10201880,3300,-67,2017-02-21
Citizen Investment Trust,13,3260,3166,3200,870,2794830,3233,-33,2017-02-22
Citizen Investment Trust,6,3230,3180,3180,310,986700,3200,-20,2017-02-23
Citizen Investment Trust,39,3151,3000,3090,2529,7808466,3180,-90,2017-02-26
Citizen Investment Trust,26,3105,3046,3094,3969,12141585,3090,4,2017-02-28
Citizen Investment Trust,13,3130,3050,3068,768,2372886,3094,-26,2017-03-01
Citizen Investment Trust,11,3130,3080,3120,729,2268150,3068,52,2017-03-02
Citizen Investment Trust,30,3220,3140,3180,1567,4981781,3120,60,2017-03-05
Citizen Investment Trust,33,3450,3270,3447,2341,7906003,3371,76,2017-03-21
Citizen Investment Trust,20,3209,3145,3150,1195,3788315,3180,-30,2017-03-06
Citizen Investment Trust,12,3150,3112,3150,903,2839384,3150,0,2017-03-07
Citizen Investment Trust,6,3200,3150,3150,231,732250,3150,0,2017-03-09
Citizen Investment Trust,4,3190,3150,3150,250,788700,3150,0,2017-03-13
Citizen Investment Trust,12,3160,3140,3140,1121,3530680,3150,-10,2017-03-14
Citizen Investment Trust,6,3200,3199,3200,270,863980,3140,60,2017-03-15
Citizen Investment Trust,5,3200,3190,3199,404,1291700,3200,-1,2017-03-16
Citizen Investment Trust,23,3272,3190,3251,1436,4624803,3199,52,2017-03-19
Citizen Investment Trust,50,3390,3299,3371,4032,13516996,3251,120,2017-03-20
Citizen Investment Trust,26,3656,3450,3502,1443,5101511,3447,55,2017-03-22
Citizen Investment Trust,28,3560,3450,3515,2136,7496238,3502,13,2017-03-23
Citizen Investment Trust,47,3794,3580,3700,2917,10748939,3515,185,2017-03-26
Citizen Investment Trust,36,4003,3774,4003,2105,8226275,3700,303,2017-03-28
Citizen Investment Trust,59,4083,3870,3870,3276,12923178,4003,-133,2017-03-29
Citizen Investment Trust,37,3960,3800,3960,2321,9046360,3870,90,2017-03-30
Citizen Investment Trust,10,4080,4039,4060,1180,4783670,3960,100,2017-04-02
Citizen Investment Trust,18,4223,3920,3925,1470,5987220,4060,-135,2017-04-03
Citizen Investment Trust,22,4045,3881,3935,2122,8354030,3925,10,2017-04-04
Citizen Investment Trust,17,4000,3900,3935,1082,4261985,3935,0,2017-04-06
Citizen Investment Trust,23,4013,3960,3970,877,3490507,3935,35,2017-04-09
Citizen Investment Trust,21,4020,3971,4000,1420,5666276,3970,30,2017-04-10
Citizen Investment Trust,24,4079,4000,4039,3153,12740990,4000,39,2017-04-11
Citizen Investment Trust,47,4130,4020,4022,4451,18046238,4039,-17,2017-04-12
Citizen Investment Trust,30,4005,3940,3969,2513,9988996,4022,-53,2017-04-13
Citizen Investment Trust,15,3975,3900,3900,920,3608535,3969,-69,2017-04-16
Citizen Investment Trust,30,3874,3734,3855,1911,7275429,3900,-45,2017-04-18
Citizen Investment Trust,18,3990,3920,3950,887,3500465,3855,95,2017-04-19
Citizen Investment Trust,14,4029,3900,3900,792,3147358,3950,-50,2017-04-20
Citizen Investment Trust,15,4051,3978,3995,1294,5202382,3900,95,2017-04-23
Citizen Investment Trust,32,4040,4000,4001,2000,8043645,3995,6,2017-04-24
Citizen Investment Trust,28,4010,3980,3980,1630,6512754,4001,-21,2017-04-25
Citizen Investment Trust,17,4000,3960,4000,761,3022340,3980,20,2017-04-26
Citizen Investment Trust,23,4048,4000,4044,3515,14155515,4000,44,2017-04-27
Citizen Investment Trust,14,4044,3965,3975,780,3126195,4044,-69,2017-04-30
Citizen Investment Trust,10,4050,3896,3950,247,982300,3975,-25,2017-05-02
Citizen Investment Trust,23,4030,3952,4000,1427,5709365,3950,50,2017-05-03
Citizen Investment Trust,7,4000,3989,3989,400,1597366,4000,-11,2017-05-04
Citizen Investment Trust,23,3989,3905,3905,1335,5237430,3989,-84,2017-05-07
Citizen Investment Trust,2,3980,3950,3980,67,266060,3905,75,2017-05-08
Citizen Investment Trust,6,3985,3975,3980,2359,9393455,3980,0,2017-05-09
Citizen Investment Trust,14,4030,3980,4030,2829,11321600,3980,50,2017-05-11
Citizen Investment Trust,26,4100,4025,4090,1509,6107568,4030,60,2017-05-15
Citizen Investment Trust,16,4090,4022,4030,1387,5591217,4090,-60,2017-05-16
Citizen Investment Trust,7,4020,4001,4020,382,1532582,4030,-10,2017-05-17
Citizen Investment Trust,16,4100,4020,4100,823,3358913,4020,80,2017-05-18
Citizen Investment Trust,25,4090,4000,4050,1705,6876959,4100,-50,2017-05-21
Citizen Investment Trust,8,4065,4050,4065,474,1922028,4050,15,2017-05-22
Citizen Investment Trust,28,4170,4065,4170,2329,9621852,4065,105,2017-05-23
Citizen Investment Trust,25,4200,4100,4200,1481,6132757,4170,30,2017-05-24
Citizen Investment Trust,7,4260,4131,4131,336,1405570,4200,-69,2017-05-28
Citizen Investment Trust,19,4190,4110,4190,1542,6385653,4131,59,2017-05-30
Citizen Investment Trust,22,4150,4111,4150,2444,10119025,4190,-40,2017-05-31
Citizen Investment Trust,18,4170,4130,4130,876,3628880,4150,-20,2017-06-01
Citizen Investment Trust,8,4150,4100,4150,203,837530,4130,20,2017-06-04
Citizen Investment Trust,12,4170,4130,4145,522,2162174,4150,-5,2017-06-05
Citizen Investment Trust,11,4190,4135,4190,682,2850016,4145,45,2017-06-06
Citizen Investment Trust,17,4210,4121,4190,917,3840881,4190,0,2017-06-07
Citizen Investment Trust,15,4150,4100,4150,607,2501256,4190,-40,2017-06-08
Citizen Investment Trust,24,4131,4050,4099,1930,7905887,4150,-51,2017-06-11
Citizen Investment Trust,8,4080,4025,4080,434,1749984,4099,-19,2017-06-12
Citizen Investment Trust,8,4138,4080,4106,811,3333587,4080,26,2017-06-13
Citizen Investment Trust,8,4131,4050,4081,403,1648815,4106,-25,2017-06-14
Citizen Investment Trust,21,4150,4100,4101,811,3344001,4081,20,2017-06-15
Citizen Investment Trust,11,4120,4062,4120,740,3030788,4101,19,2017-06-18
Citizen Investment Trust,9,4100,4038,4038,325,1320160,4120,-82,2017-06-19
Citizen Investment Trust,14,4110,4060,4060,1054,4321450,4038,22,2017-06-20
Citizen Investment Trust,19,4109,4040,4075,980,4000406,4060,15,2017-06-21
Citizen Investment Trust,12,4125,4090,4095,807,3311628,4075,20,2017-06-22
Citizen Investment Trust,15,4175,4085,4100,928,3804355,4095,5,2017-06-25
Citizen Investment Trust,17,4110,4035,4070,1981,8085965,4100,-30,2017-06-27
Citizen Investment Trust,13,4104,4070,4100,1513,6191190,4070,30,2017-06-28
Citizen Investment Trust,10,4070,4030,4030,777,3139210,4100,-70,2017-07-02
Citizen Investment Trust,28,4030,4000,4008,2818,11280632,4030,-22,2017-07-03
Citizen Investment Trust,15,4016,4000,4015,2511,10060605,4008,7,2017-07-04
Citizen Investment Trust,5,4090,4000,4040,410,1649286,4015,25,2017-07-05
Citizen Investment Trust,2,4075,4065,4065,20,81400,4040,25,2017-07-06
Citizen Investment Trust,31,4110,4010,4080,2489,10146965,4065,15,2017-07-09
Citizen Investment Trust,13,4081,4040,4041,971,3929667,4080,-39,2017-07-10
Citizen Investment Trust,10,4099,4040,4099,690,2809506,4041,58,2017-07-11
Citizen Investment Trust,91,4098,3900,3927,4740,18825953,4099,-172,2017-07-12
Citizen Investment Trust,46,3880,3852,3880,2418,9347039,3927,-47,2017-07-13
Citizen Investment Trust,13,3980,3900,3980,540,2138899,3880,100,2017-07-16
Citizen Investment Trust,10,4045,4000,4000,380,1524800,3980,20,2017-07-17
Citizen Investment Trust,21,4050,3980,3980,635,2541344,4000,-20,2017-07-18
Citizen Investment Trust,106,4857,4570,4650,7583,35284769,4490,160,2017-08-03
Citizen Investment Trust,7,4035,3920,3920,479,1891340,3980,-60,2017-07-19
Citizen Investment Trust,20,3975,3942,3950,3545,13988828,3920,30,2017-07-20
Citizen Investment Trust,8,3921,3901,3906,375,1466610,3950,-44,2017-07-23
Citizen Investment Trust,9,3960,3910,3960,458,1808444,3906,54,2017-07-24
Citizen Investment Trust,12,4000,3970,3995,698,2787314,3960,35,2017-07-25
Citizen Investment Trust,24,4020,3970,4000,1726,6903678,3995,5,2017-07-26
Citizen Investment Trust,6,4001,4000,4000,313,1252050,4000,0,2017-07-27
Citizen Investment Trust,7,4025,4000,4001,341,1369375,4000,1,2017-07-30
Citizen Investment Trust,41,4171,4040,4070,3095,12587585,4001,69,2017-07-31
Citizen Investment Trust,25,4145,4100,4125,2561,10549758,4070,55,2017-08-01
Citizen Investment Trust,53,4500,4167,4490,4610,19750966,4125,365,2017-08-02
Citizen Investment Trust,67,4651,4510,4581,4801,21993891,4650,-69,2017-08-06
Citizen Investment Trust,148,4750,4630,4740,14399,67295243,4581,159,2017-08-07
Citizen Investment Trust,79,4770,4695,4700,8353,39587758,4740,-40,2017-08-09
Citizen Investment Trust,206,4750,4600,4730,14132,66432213,4700,30,2017-08-10
Citizen Investment Trust,88,4100,3920,3978,4331,17221348,3882,96,2017-08-13
Citizen Investment Trust,26,3980,3922,3950,1902,7505808,3978,-28,2017-08-15
Citizen Investment Trust,19,3965,3921,3921,1313,5171977,3950,-29,2017-08-16
Citizen Investment Trust,22,3950,3900,3905,3093,12157575,3921,-16,2017-08-17
Citizen Investment Trust,27,3900,3865,3867,1560,6040980,3905,-38,2017-08-20
Citizen Investment Trust,9,3875,3850,3875,265,1022175,3867,8,2017-08-21
Citizen Investment Trust,28,3885,3820,3851,2999,11527259,3875,-24,2017-08-22
Citizen Investment Trust,29,3860,3830,3835,1258,4830025,3851,-16,2017-08-23
Citizen Investment Trust,17,3885,3800,3850,770,2950320,3835,15,2017-08-24
Citizen Investment Trust,16,3850,3825,3825,915,3504985,3850,-25,2017-08-27
Citizen Investment Trust,22,3801,3770,3778,1074,4065067,3825,-47,2017-08-28
Citizen Investment Trust,23,3800,3731,3741,917,3440410,3778,-37,2017-08-30
Citizen Investment Trust,27,3750,3667,3680,1200,4426545,3741,-61,2017-08-31
Citizen Investment Trust,33,3745,3600,3683,2069,7556024,3680,3,2017-09-04
Citizen Investment Trust,7,3756,3681,3682,261,963655,3683,-1,2017-09-06
Citizen Investment Trust,12,3652,3640,3640,860,3138235,3682,-42,2017-09-07
Citizen Investment Trust,41,3640,3540,3579,2445,8704590,3640,-61,2017-09-10
Citizen Investment Trust,19,3590,3525,3570,1584,5620430,3579,-9,2017-09-11
Citizen Investment Trust,54,3515,3440,3440,3626,12643224,3570,-130,2017-09-12
Citizen Investment Trust,16,3549,3450,3549,2048,7181629,3440,109,2017-09-13
Citizen Investment Trust,22,3729,3550,3729,1211,4352420,3549,180,2017-09-14
Citizen Investment Trust,34,3800,3700,3700,1978,7376060,3729,-29,2017-09-17
Citizen Investment Trust,30,3700,3640,3659,1598,5869396,3700,-41,2017-09-18
Citizen Investment Trust,11,3670,3651,3670,837,3064520,3659,11,2017-09-20
Citizen Investment Trust,11,3625,3580,3611,610,2197120,3650,-39,2017-10-09
Citizen Investment Trust,12,3710,3670,3710,885,3273930,3670,40,2017-09-24
Citizen Investment Trust,16,3745,3700,3745,1280,4743650,3710,35,2017-09-25
Citizen Investment Trust,14,3755,3735,3750,1204,4512326,3745,5,2017-09-26
Citizen Investment Trust,3,3800,3770,3770,2169,8177630,3750,20,2017-10-03
Citizen Investment Trust,1,3750,3750,3750,50,187500,3770,-20,2017-10-04
Citizen Investment Trust,8,3700,3600,3650,448,1631000,3750,-100,2017-10-08
Citizen Investment Trust,18,3736,3625,3665,1101,4033175,3611,54,2017-10-10
Citizen Investment Trust,21,3679,3640,3679,1470,5381496,3665,14,2017-10-11
Citizen Investment Trust,17,3698,3656,3679,1634,5999956,3679,0,2017-10-12
Citizen Investment Trust,18,3700,3679,3700,34555,106637450,3679,21,2017-10-15
Citizen Investment Trust,12,3750,3699,3720,1142,4235928,3700,20,2017-10-16
Citizen Investment Trust,11,3750,3701,3701,544,2022299,3720,-19,2017-10-17
Citizen Investment Trust,10,3770,3730,3769,771,2902285,3701,68,2017-10-18
Citizen Investment Trust,17,3820,3700,3800,1226,4636510,3769,31,2017-10-22
Citizen Investment Trust,3,3760,3740,3740,191,716740,3800,-60,2017-10-23
Citizen Investment Trust,10,3740,3710,3716,720,2677080,3740,-24,2017-10-24
Citizen Investment Trust,20,3725,3700,3707,1463,5424760,3716,-9,2017-10-25
Citizen Investment Trust,15,3734,3685,3690,1077,3980606,3707,-17,2017-10-29
Citizen Investment Trust,17,3685,3661,3661,1480,5432850,3661,0,2017-10-31
Citizen Investment Trust,13,3665,3650,3660,943,3450066,3661,-1,2017-11-01
Citizen Investment Trust,10,3680,3650,3675,941,3446025,3660,15,2017-11-02
Citizen Investment Trust,18,3675,3650,3660,1887,6913850,3675,-15,2017-11-05
Citizen Investment Trust,44,3750,3645,3750,8729,32500998,3660,90,2017-11-06
Citizen Investment Trust,5,3750,3670,3670,205,763250,3750,-80,2017-11-07
Citizen Investment Trust,23,3630,3561,3630,1587,5681530,3670,-40,2017-11-08
Citizen Investment Trust,17,3630,3560,3575,1250,4471160,3630,-55,2017-11-09
Citizen Investment Trust,14,3590,3550,3590,1195,4273950,3575,15,2017-11-12
Citizen Investment Trust,18,3661,3590,3661,6630,23819270,3590,71,2017-11-13
Citizen Investment Trust,21,3690,3640,3642,1175,4296960,3661,-19,2017-11-14
Citizen Investment Trust,23,3590,3570,3570,2170,7763555,3642,-72,2017-11-15
Citizen Investment Trust,22,3600,3550,3552,3317,11786925,3570,-18,2017-11-16
Citizen Investment Trust,4,3537,3535,3535,290,1025210,3552,-17,2017-11-19
Citizen Investment Trust,18,3560,3519,3520,1167,4112555,3535,-15,2017-11-20
Citizen Investment Trust,14,3555,3515,3515,953,3360815,3520,-5,2017-11-21
Citizen Investment Trust,11,3530,3512,3521,628,2212444,3515,6,2017-11-22
Citizen Investment Trust,10,3590,3521,3590,1792,6349900,3521,69,2017-11-23
Citizen Investment Trust,72,3800,3590,3610,4502,16521275,3590,20,2017-11-26
Citizen Investment Trust,33,3690,3640,3640,1599,5871220,3610,30,2017-11-27
Citizen Investment Trust,16,3650,3635,3635,923,3360679,3640,-5,2017-11-28
Citizen Investment Trust,15,3700,3635,3650,1250,4556685,3635,15,2017-11-29
Citizen Investment Trust,18,3650,3610,3625,1161,4218131,3650,-25,2017-11-30
Citizen Investment Trust,15,3630,3600,3615,1124,4060928,3625,-10,2017-12-04
Citizen Investment Trust,14,3640,3615,3625,578,2094710,3621,4,2017-12-20
Citizen Investment Trust,15,3630,3600,3601,752,2710899,3615,-14,2017-12-05
Citizen Investment Trust,10,3650,3601,3650,540,1958780,3601,49,2017-12-06
Citizen Investment Trust,13,3650,3610,3610,900,3274990,3650,-40,2017-12-10
Citizen Investment Trust,5,3611,3610,3610,235,848410,3610,0,2017-12-11
Citizen Investment Trust,12,3610,3590,3590,1054,3800868,3610,-20,2017-12-12
Citizen Investment Trust,11,3599,3585,3599,755,2711860,3590,9,2017-12-13
Citizen Investment Trust,2,3623,3552,3623,161,572582,3599,24,2017-12-14
Citizen Investment Trust,8,3601,3595,3600,874,3145439,3623,-23,2017-12-17
Citizen Investment Trust,36,3655,3600,3650,3575,13040755,3600,50,2017-12-18
Citizen Investment Trust,25,3650,3621,3621,2237,8118136,3650,-29,2017-12-19
Citizen Investment Trust,34,3615,3590,3610,1775,6394149,3625,-15,2017-12-21
Citizen Investment Trust,19,3640,3600,3610,1112,4015245,3610,0,2017-12-24
Citizen Investment Trust,26,3552,3511,3511,1603,5679913,3610,-99,2017-12-26
Citizen Investment Trust,44,3599,3485,3495,3094,10865247,3511,-16,2017-12-27
Citizen Investment Trust,38,3515,3460,3485,2320,8091819,3495,-10,2017-12-28
Citizen Investment Trust,52,3503,3455,3489,5474,19086313,3485,4,2017-12-31
Citizen Investment Trust,41,3554,3490,3554,2672,9465168,3489,65,2018-01-01
Citizen Investment Trust,20,3565,3530,3530,1415,5015356,3554,-24,2018-01-02
Citizen Investment Trust,14,3505,3497,3505,633,2216239,3530,-25,2018-01-03
Citizen Investment Trust,15,3600,3535,3565,651,2314758,3520,45,2018-01-07
Citizen Investment Trust,15,3600,3580,3590,1762,6333771,3565,25,2018-01-08
Citizen Investment Trust,10,3610,3580,3580,600,2154980,3590,-10,2018-01-09
Citizen Investment Trust,10,3575,3499,3575,2201,7750519,3580,-5,2018-01-10
Citizen Investment Trust,7,3610,3515,3515,267,953340,3575,-60,2018-01-14
Citizen Investment Trust,13,3535,3500,3516,740,2602204,3515,1,2018-01-16
Citizen Investment Trust,23,3535,3500,3500,1425,4990290,3516,-16,2018-01-17
Citizen Investment Trust,20,3600,3491,3522,1490,5275789,3500,22,2018-01-21
Citizen Investment Trust,15,3530,3510,3510,744,2615935,3522,-12,2018-01-22
Citizen Investment Trust,7,3501,3480,3500,1227,4293380,3510,-10,2018-01-23
Citizen Investment Trust,12,3510,3480,3500,985,3439800,3500,0,2018-01-24
Citizen Investment Trust,27,3525,3480,3500,1133,3960381,3500,0,2018-01-25
Citizen Investment Trust,8,3501,3480,3483,460,1608140,3500,-17,2018-01-28
Citizen Investment Trust,12,3511,3443,3480,631,2204230,3483,-3,2018-01-29
Citizen Investment Trust,18,3489,3465,3480,1469,5105180,3480,0,2018-01-31
Citizen Investment Trust,16,3499,3480,3499,407,1417210,3480,19,2018-02-01
Citizen Investment Trust,24,3510,3500,3510,3556,12454755,3499,11,2018-02-04
Citizen Investment Trust,12,3500,3490,3500,404,1412670,3510,-10,2018-02-05
Citizen Investment Trust,7,3480,3471,3472,346,1202026,3500,-28,2018-02-06
Citizen Investment Trust,30,3456,3430,3430,1685,5809558,3472,-42,2018-02-07
Citizen Investment Trust,13,3450,3430,3450,890,3067980,3430,20,2018-02-08
Citizen Investment Trust,9,3410,3400,3405,501,1706180,3455,-50,2018-02-25
Citizen Investment Trust,10,3550,3450,3450,367,1270866,3450,0,2018-02-11
Citizen Investment Trust,8,3465,3460,3460,284,982976,3450,10,2018-02-12
Citizen Investment Trust,8,3460,3431,3451,135,464462,3460,-9,2018-02-14
Citizen Investment Trust,17,3520,3491,3501,757,2652731,3451,50,2018-02-15
Citizen Investment Trust,12,3550,3500,3500,398,1400695,3501,-1,2018-02-18
Citizen Investment Trust,23,3470,3426,3430,1386,4756271,3470,-40,2018-02-21
Citizen Investment Trust,8,3455,3400,3455,366,1258668,3430,25,2018-02-22
Citizen Investment Trust,12,3382,3337,3337,671,2256210,3405,-68,2018-02-26
Citizen Investment Trust,13,3400,3350,3365,840,2831415,3337,28,2018-02-27
Citizen Investment Trust,36,3400,3287,3325,7256,23983066,3365,-40,2018-02-28
Citizen Investment Trust,42,3275,3155,3200,1781,5704737,3325,-125,2018-03-04
Citizen Investment Trust,23,3190,3152,3152,2075,6566112,3200,-48,2018-03-05
Citizen Investment Trust,44,3150,3000,3065,2726,8344207,3152,-87,2018-03-06
Citizen Investment Trust,52,3115,3004,3050,5683,17304192,3065,-15,2018-03-07
Citizen Investment Trust,26,3014,2990,3000,1242,3727680,3050,-50,2018-03-11
Citizen Investment Trust,40,3010,2950,2950,2472,7353002,3000,-50,2018-03-12
Citizen Investment Trust,41,3000,2947,3000,2683,7960044,2950,50,2018-03-13
Citizen Investment Trust,9,2970,2950,2960,1297,3836260,3000,-40,2018-03-14
Citizen Investment Trust,29,2956,2930,2930,2314,6814250,2960,-30,2018-03-15
Citizen Investment Trust,31,2950,2900,2900,2667,7772288,2930,-30,2018-03-18
Citizen Investment Trust,12,2998,2842,2998,10499,29878360,2900,98,2018-03-19
Citizen Investment Trust,53,3040,2860,2861,2585,7431430,2998,-137,2018-03-20
Citizen Investment Trust,67,2840,2731,2755,4006,11085915,2861,-106,2018-03-21
Citizen Investment Trust,49,2834,2734,2770,3227,8934244,2755,15,2018-03-22
Citizen Investment Trust,92,2720,2617,2617,4456,11793899,2770,-153,2018-03-26
Citizen Investment Trust,47,2697,2530,2651,2735,7139875,2617,34,2018-03-27
Citizen Investment Trust,61,2727,2627,2650,3068,8204647,2651,-1,2018-03-28
Citizen Investment Trust,30,2740,2680,2710,2527,6811466,2650,60,2018-03-29
Citizen Investment Trust,29,2700,2620,2680,1791,4765073,2710,-30,2018-04-01
Citizen Investment Trust,19,2680,2630,2650,974,2585580,2680,-30,2018-04-02
Citizen Investment Trust,47,2660,2642,2650,4810,12740389,2650,0,2018-04-03
Citizen Investment Trust,72,2754,2680,2749,3813,10338320,2650,99,2018-04-04
Citizen Investment Trust,70,2389,2298,2340,2606,6075676,2253,87,2018-04-05
Citizen Investment Trust,54,2470,2340,2450,2048,4926150,2340,110,2018-04-08
Citizen Investment Trust,84,2555,2475,2500,3837,9679019,2450,50,2018-04-09
Citizen Investment Trust,25,2550,2430,2450,1541,3812710,2500,-50,2018-04-10
Citizen Investment Trust,14,2480,2402,2480,225,551334,2450,30,2018-04-11
Citizen Investment Trust,31,2529,2500,2500,1360,3411750,2480,20,2018-04-12
Citizen Investment Trust,26,2550,2480,2549,1036,2606585,2500,49,2018-04-15
Citizen Investment Trust,16,2599,2550,2571,666,1717506,2549,22,2018-04-16
Citizen Investment Trust,54,2670,2600,2670,10393,27267241,2571,99,2018-04-17
Citizen Investment Trust,62,2765,2690,2760,4476,12194984,2670,90,2018-04-18
Citizen Investment Trust,44,2780,2725,2741,3594,9906573,2760,-19,2018-04-19
Citizen Investment Trust,48,2845,2785,2807,3332,9335666,2741,66,2018-04-22
Citizen Investment Trust,74,2863,2750,2750,6750,18903038,2807,-57,2018-04-23
Citizen Investment Trust,30,2774,2710,2710,1071,2934749,2750,-40,2018-04-24
Citizen Investment Trust,22,2763,2710,2710,1392,3831705,2710,0,2018-04-25
Citizen Investment Trust,17,2741,2610,2650,1256,3329812,2710,-60,2018-04-26
Citizen Investment Trust,50,2649,2597,2606,3000,7836035,2650,-44,2018-04-29
Citizen Investment Trust,18,2675,2586,2675,909,2379234,2606,69,2018-05-02
Citizen Investment Trust,33,2700,2646,2646,4298,11464914,2675,-29,2018-05-03
Citizen Investment Trust,36,2646,2594,2600,1794,4669434,2646,-46,2018-05-06
Citizen Investment Trust,6,2639,2600,2630,3113,8095318,2600,30,2018-05-07
Citizen Investment Trust,10,2670,2610,2670,2710,7103500,2630,40,2018-05-08
Citizen Investment Trust,12,2675,2640,2650,610,1616595,2670,-20,2018-05-09
Citizen Investment Trust,1,2635,2635,2635,19,50065,2650,-15,2018-05-10
Citizen Investment Trust,14,2650,2610,2635,1106,2904982,2635,0,2018-05-14
Citizen Investment Trust,3,2645,2615,2645,220,575850,2635,10,2018-05-15
Citizen Investment Trust,12,2650,2600,2640,2379,6209255,2645,-5,2018-05-16
Citizen Investment Trust,9,2665,2638,2639,304,803475,2640,-1,2018-05-17
Citizen Investment Trust,12,2650,2625,2626,806,2133594,2639,-13,2018-05-20
Citizen Investment Trust,101,2745,2650,2725,8925,24193096,2626,99,2018-05-21
Citizen Investment Trust,67,2770,2730,2730,3605,9911731,2725,5,2018-05-22
Citizens Bank Internatioal Limited Promoter Share,5,335,321,335,55000,18357000,315,20,2016-06-12
Citizens Bank Internatioal Limited Promoter Share,2,329,323,323,98208,31748184,335,-12,2016-07-13
Citizens Bank Internatioal Limited Promoter Share,1,323,323,323,995,321385,323,0,2016-07-20
Citizens Bank Internatioal Limited Promoter Share,3,323,323,323,63000,20349000,323,0,2016-08-16
Citizens Bank Internatioal Limited Promoter Share,1,325,325,325,16836,5471700,323,2,2016-08-30
Citizens Bank Internatioal Limited Promoter Share,3,325,325,325,111580,36263500,325,0,2016-12-04
Citizens Bank Internatioal Limited Promoter Share,1,325,325,325,29200,9490000,325,0,2017-01-10
Citizens Bank Internatioal Limited Promoter Share,1,325,325,325,26460,8599500,325,0,2017-01-19
Citizens Bank Internatioal Limited Promoter Share,3,325,325,325,18570,6035250,325,0,2017-02-01
Citizens Bank Internatioal Limited Promoter Share,1,325,325,325,14045,4564625,325,0,2017-07-24
Citizens Bank Internatioal Limited Promoter Share,1,325,325,325,14497,4711525,325,0,2017-08-24
Citizens Bank Internatioal Limited Promoter Share,4,157,150,150,62176,9326520,160,-10,2018-01-21
Citizens Mutual Fund -1,1,10,10,10,1000,10000,0,10,2018-04-24
Citizens Mutual Fund -1,3,9.8,9.8,9.8,1000,9800,10,-0.199999999999999,2018-04-29
Citizens Mutual Fund -1,3,9.79,9.6,9.79,700,6777,9.8,-0.010000000000002,2018-05-02
Citizens Mutual Fund -1,1,9.85,9.85,9.85,1000,9850,9.79,0.060000000000001,2018-05-03
Citizens Mutual Fund -1,3,9.65,9.51,9.51,7900,75255,9.85,-0.34,2018-05-06
Citizens Mutual Fund -1,3,9.51,9.32,9.51,1100,10276,9.51,0,2018-05-08
Citizens Mutual Fund -1,2,9.33,9.3,9.3,1000,9315,9.51,-0.209999999999999,2018-05-09
Citizens Mutual Fund -1,2,9.32,9.31,9.32,1000,9315,9.3,0.02,2018-05-10
Citizens Mutual Fund -1,1,9.35,9.35,9.35,500,4675,9.32,0.029999999999999,2018-05-16
Citizens Mutual Fund -1,1,9.35,9.35,9.35,200,1870,9.35,0,2018-05-22
City Express Finance Co. Limited,9,0,0,0,204840,11266200,97,-97,2017-05-28
City Express Finance Co. Limited,2,98,98,98,800,78400,97,1,2017-06-25
City Express Finance Co. Limited,1,99,99,99,5160,510840,98,1,2017-07-04
City Express Finance Co. Limited,3,104,100,104,30,3060,99,5,2017-07-10
City Express Finance Co. Limited,8,114,106,114,330,37000,104,10,2017-07-11
City Express Finance Co. Limited,6,125,116,125,60,7250,114,11,2017-07-12
City Express Finance Co. Limited,6,137,127,137,60,7920,125,12,2017-07-13
City Express Finance Co. Limited,16,150,139,150,2340,350640,137,13,2017-07-16
City Express Finance Co. Limited,22,159,139,141,1940,280820,150,-9,2017-07-17
City Express Finance Co. Limited,13,155,143,155,1760,267260,141,14,2017-07-18
City Express Finance Co. Limited,16,280,260,280,2390,668700,255,25,2017-08-03
City Express Finance Co. Limited,14,163,157,160,950,151260,155,5,2017-07-19
City Express Finance Co. Limited,12,165,157,165,4580,738650,160,5,2017-07-20
City Express Finance Co. Limited,21,181,168,181,5260,947200,165,16,2017-07-23
City Express Finance Co. Limited,8,190,184,184,520,97060,181,3,2017-07-24
City Express Finance Co. Limited,4,181,178,178,260,46940,184,-6,2017-07-25
City Express Finance Co. Limited,12,190,175,187,4170,745710,178,9,2017-07-26
City Express Finance Co. Limited,7,185,178,178,2250,406500,187,-9,2017-07-27
City Express Finance Co. Limited,13,195,181,195,1710,328110,178,17,2017-07-30
City Express Finance Co. Limited,18,214,198,211,3770,782740,195,16,2017-07-31
City Express Finance Co. Limited,22,232,215,232,7030,1601390,211,21,2017-08-01
City Express Finance Co. Limited,12,255,236,255,3010,753910,232,23,2017-08-02
City Express Finance Co. Limited,4,290,280,280,1250,356500,280,0,2017-08-06
City Express Finance Co. Limited,8,275,252,252,1070,287210,280,-28,2017-08-07
City Express Finance Co. Limited,6,247,235,235,270,63690,252,-17,2017-08-09
City Express Finance Co. Limited,30,231,212,212,5230,1139700,235,-23,2017-08-10
City Express Finance Co. Limited,13,232,216,217,2290,513560,212,5,2017-08-13
City Express Finance Co. Limited,17,230,213,230,5890,1287600,217,13,2017-08-15
City Express Finance Co. Limited,19,229,218,218,4750,1054510,230,-12,2017-08-16
City Express Finance Co. Limited,25,230,206,226,8200,1761800,218,8,2017-08-17
City Express Finance Co. Limited,17,246,226,234,5200,1214480,226,8,2017-08-20
City Express Finance Co. Limited,3,233,230,233,30,6960,234,-1,2017-08-21
City Express Finance Co. Limited,7,240,226,226,940,219780,233,-7,2017-08-22
City Express Finance Co. Limited,2,225,222,225,240,53700,226,-1,2017-08-23
City Express Finance Co. Limited,6,221,213,213,400,86360,225,-12,2017-08-24
City Express Finance Co. Limited,6,227,213,227,330,72010,213,14,2017-08-27
City Express Finance Co. Limited,10,203,193,193,620,121140,207,-14,2017-09-24
City Express Finance Co. Limited,2,193,190,193,120,23070,193,0,2017-09-25
City Express Finance Co. Limited,2,190,190,190,220,41800,193,-3,2017-10-03
City Express Finance Co. Limited,10,187,181,181,2210,407790,190,-9,2017-10-04
City Express Finance Co. Limited,2,182,180,182,60,10820,181,1,2017-10-10
City Express Finance Co. Limited,2,179,176,176,280,49880,182,-6,2017-10-11
City Express Finance Co. Limited,7,176,171,171,620,107420,176,-5,2017-10-12
City Express Finance Co. Limited,2,170,170,170,400,68000,171,-1,2017-10-15
City Express Finance Co. Limited,6,179,173,179,2410,421160,170,9,2017-10-16
City Express Finance Co. Limited,8,189,180,186,990,184770,179,7,2017-11-01
City Express Finance Co. Limited,23,189,187,187,96970,11574700,186,1,2017-11-02
City Express Finance Co. Limited,3,189,186,186,190,35370,187,-1,2017-11-05
City Express Finance Co. Limited,1,189,189,189,120,22680,186,3,2017-11-14
City Express Finance Co. Limited,1,192,192,192,20,3840,189,3,2017-11-16
City Express Finance Co. Limited,8,195,188,188,270,51790,192,-4,2017-11-19
City Express Finance Co. Limited,3,191,191,191,350,66850,188,3,2017-11-20
City Express Finance Co. Limited,4,194,191,191,460,88500,191,0,2017-11-21
City Express Finance Co. Limited,6,191,188,188,740,139570,191,-3,2017-11-22
City Express Finance Co. Limited,1,188,188,188,300,56400,188,0,2017-11-23
City Express Finance Co. Limited,3,191,190,191,610,116010,188,3,2017-11-26
City Express Finance Co. Limited,3,189,186,186,300,56430,191,-5,2017-11-27
City Express Finance Co. Limited,5,183,180,180,3700,671400,186,-6,2017-11-28
City Express Finance Co. Limited,4,183,177,183,1180,210540,180,3,2017-11-29
City Express Finance Co. Limited,1,180,180,180,200,36000,183,-3,2017-12-04
City Express Finance Co. Limited,1,209,209,209,22,4598,205,4,2017-12-20
City Express Finance Co. Limited,9,180,177,179,3970,711108,180,-1,2017-12-05
City Express Finance Co. Limited,10,186,177,184,3240,592410,179,5,2017-12-06
City Express Finance Co. Limited,2,184,184,184,1050,193200,184,0,2017-12-10
City Express Finance Co. Limited,1,187,187,187,500,93500,184,3,2017-12-11
City Express Finance Co. Limited,12,205,185,205,2990,574190,187,18,2017-12-13
City Express Finance Co. Limited,15,225,209,225,1162,260374,205,20,2017-12-14
City Express Finance Co. Limited,9,221,210,210,1240,266760,225,-15,2017-12-17
City Express Finance Co. Limited,3,206,199,199,260,52570,210,-11,2017-12-18
City Express Finance Co. Limited,11,205,197,205,7220,1443460,199,6,2017-12-19
City Express Finance Co. Limited,4,205,201,201,600,122800,209,-8,2017-12-21
City Express Finance Co. Limited,1,205,205,205,100,20500,201,4,2017-12-24
City Express Finance Co. Limited,3,205,201,201,80,16280,205,-4,2017-12-27
City Express Finance Co. Limited,2,198,195,195,20,3930,201,-6,2018-01-02
City Express Finance Co. Limited,3,193,190,190,510,98400,195,-5,2018-01-03
City Express Finance Co. Limited,4,202,198,202,1020,202510,196,6,2018-01-10
City Express Finance Co. Limited,1,206,206,206,500,103000,202,4,2018-01-14
City Express Finance Co. Limited,7,206,200,200,1930,391780,206,-6,2018-01-16
City Express Finance Co. Limited,2,200,200,200,100,20000,200,0,2018-01-17
City Express Finance Co. Limited,2,200,196,196,232,46272,204,-8,2018-01-22
City Express Finance Co. Limited,5,195,191,195,2030,395060,196,-1,2018-01-25
City Express Finance Co. Limited,3,198,198,198,390,77220,195,3,2018-01-28
City Express Finance Co. Limited,2,198,195,195,1030,200940,198,-3,2018-01-29
City Express Finance Co. Limited,10,192,186,189,1020,193590,195,-6,2018-02-04
City Express Finance Co. Limited,1,187,187,187,100,18700,189,-2,2018-02-06
City Express Finance Co. Limited,1,190,190,190,10,1900,187,3,2018-02-07
City Express Finance Co. Limited,1,187,187,187,100,18700,190,-3,2018-02-11
City Express Finance Co. Limited,1,188,188,188,100,18800,187,1,2018-02-18
City Express Finance Co. Limited,4,190,187,187,832,155740,187,0,2018-04-22
City Express Finance Co. Limited,2,190,189,190,780,147520,187,3,2018-04-23
City Express Finance Co. Limited,3,196,195,195,120,23410,193,2,2018-04-25
City Express Finance Co. Limited,7,206,198,198,230,45900,195,3,2018-04-26
City Express Finance Co. Limited,2,198,195,195,570,112260,198,-3,2018-04-29
City Express Finance Co. Limited,1,192,192,192,20,3840,195,-3,2018-05-06
City Express Finance Co. Limited,1,189,189,189,50,9450,192,-3,2018-05-07
City Express Finance Co. Limited,2,189,186,189,60,11190,189,0,2018-05-17
City Express Finance Co. Ltd. Promoter Share,4,0,0,0,247500,11397500,0,0,2017-03-29
City Express Finance Co. Ltd. Promoter Share,2,105,105,105,35000,3675000,105,0,2017-05-21
City Express Finance Co. Ltd. Promoter Share,2,105,105,105,30000,3150000,105,0,2017-05-22
City Express Finance Co. Ltd. Promoter Share,6,103,100,100,313110,31662750,105,-5,2017-07-17
City Express Finance Co. Ltd. Promoter Share,1,100,100,100,82500,8250000,100,0,2017-07-18
City Express Finance Co. Ltd. Promoter Share,1,100,100,100,60000,6000000,100,0,2018-03-26
City Express Finance Co. Ltd. Promoter Share,15,100,100,100,53700,5370000,100,0,2018-03-27
Civil Bank Ltd,6,280,260,280,61,16580,255,25,2016-10-25
Civil Bank Ltd,5,306,285,306,6736,2016570,280,26,2016-10-26
Civil Bank Ltd,6,336,312,336,10204,3369960,306,30,2016-10-27
Civil Bank Ltd,879,369,336,354,316495,110461355,336,18,2016-11-03
Civil Bank Ltd,515,358,338,342,152931,52565755,354,-12,2016-11-07
Civil Bank Ltd,481,345,329,330,179106,59586407,342,-12,2016-11-08
Civil Bank Ltd,323,335,309,321,123188,39249094,330,-9,2016-11-09
Civil Bank Ltd,417,329,311,322,129113,41296912,321,1,2016-11-10
Civil Bank Ltd,280,321,316,317,127247,40471675,322,-5,2016-11-13
Civil Bank Ltd,294,321,311,321,83676,26664859,317,4,2016-11-14
Civil Bank Ltd,293,324,321,323,96574,31130191,321,2,2016-11-15
Civil Bank Ltd,167,325,318,321,40898,13065252,323,-2,2016-11-16
Civil Bank Ltd,531,318,293,299,169494,51001405,321,-22,2016-11-17
Civil Bank Ltd,322,300,272,280,155324,43595399,299,-19,2016-11-20
Civil Bank Ltd,217,289,269,280,76928,21473713,280,0,2016-11-21
Civil Bank Ltd,217,280,272,274,68321,18761205,280,-6,2016-11-22
Civil Bank Ltd,203,279,260,265,70741,18918774,274,-9,2016-11-23
Civil Bank Ltd,219,283,260,263,89158,23778631,265,-2,2016-11-24
Civil Bank Ltd,187,265,247,249,84584,21416887,263,-14,2016-11-27
Civil Bank Ltd,193,263,233,255,61407,14921078,249,6,2016-11-28
Civil Bank Ltd,205,270,242,265,74509,19138519,255,10,2016-11-29
Civil Bank Ltd,262,279,261,270,73938,19972183,265,5,2016-11-30
Civil Bank Ltd,219,280,263,272,78140,21167895,270,2,2016-12-01
Civil Bank Ltd,94,273,260,263,20859,5585267,272,-9,2016-12-04
Civil Bank Ltd,91,270,261,263,21589,5687495,263,0,2016-12-05
Civil Bank Ltd,82,268,258,265,12670,3353427,263,2,2016-12-06
Civil Bank Ltd,72,267,263,264,12006,3180284,265,-1,2016-12-07
Civil Bank Ltd,87,264,254,260,27636,7146140,264,-4,2016-12-08
Civil Bank Ltd,98,264,253,256,23960,6123747,260,-4,2016-12-11
Civil Bank Ltd,76,257,249,256,19171,4862731,256,0,2016-12-12
Civil Bank Ltd,119,258,250,254,36877,9350169,256,-2,2016-12-14
Civil Bank Ltd,94,259,252,259,31178,7974848,254,5,2016-12-15
Civil Bank Ltd,80,260,254,258,20971,5389157,259,-1,2016-12-18
Civil Bank Ltd,106,263,250,256,28120,7177032,258,-2,2016-12-19
Civil Bank Ltd,75,261,250,254,28883,7287621,256,-2,2016-12-20
Civil Bank Ltd,124,255,249,250,59493,14920108,254,-4,2016-12-21
Civil Bank Ltd,73,253,249,250,37256,9332645,250,0,2016-12-22
Civil Bank Ltd,93,250,245,246,18956,4694565,250,-4,2016-12-26
Civil Bank Ltd,137,248,237,240,46041,11083646,246,-6,2016-12-27
Civil Bank Ltd,77,247,235,246,24139,5801090,240,6,2016-12-28
Civil Bank Ltd,97,253,245,249,25097,6238587,246,3,2016-12-29
Civil Bank Ltd,78,257,252,256,23115,5877227,249,7,2017-01-01
Civil Bank Ltd,62,262,253,258,14707,3792279,256,2,2017-01-02
Civil Bank Ltd,93,258,245,254,28444,7150432,258,-4,2017-01-03
Civil Bank Ltd,42,256,245,254,71649,17876324,254,0,2017-01-04
Civil Bank Ltd,91,255,246,254,47902,11963849,254,0,2017-01-05
Civil Bank Ltd,57,250,245,250,21271,5293841,254,-4,2017-01-08
Civil Bank Ltd,93,255,248,251,33106,8272597,250,1,2017-01-09
Civil Bank Ltd,51,255,249,252,16952,4257303,251,1,2017-01-10
Civil Bank Ltd,66,254,250,251,36286,9087675,252,-1,2017-01-11
Civil Bank Ltd,47,253,250,252,16713,4194179,251,1,2017-01-12
Civil Bank Ltd,47,255,249,249,11743,2941043,252,-3,2017-01-15
Civil Bank Ltd,51,250,246,249,13964,3462792,249,0,2017-01-16
Civil Bank Ltd,45,250,246,250,6137,1530625,249,1,2017-01-17
Civil Bank Ltd,60,255,246,249,20802,5225565,250,-1,2017-01-18
Civil Bank Ltd,64,257,247,250,17989,4488946,249,1,2017-01-19
Civil Bank Ltd,52,250,246,247,21699,5372320,250,-3,2017-01-22
Civil Bank Ltd,41,250,245,248,9789,2410143,247,1,2017-01-23
Civil Bank Ltd,69,247,240,240,19784,4810368,248,-8,2017-01-24
Civil Bank Ltd,77,244,233,240,26043,6145503,240,0,2017-01-25
Civil Bank Ltd,55,239,230,235,23894,5593261,240,-5,2017-01-26
Civil Bank Ltd,90,233,217,218,25348,5625703,235,-17,2017-01-30
Civil Bank Ltd,67,230,209,220,19773,4284065,218,2,2017-01-31
Civil Bank Ltd,63,236,218,236,20037,4602202,220,16,2017-02-01
Civil Bank Ltd,68,248,230,235,17465,4098249,236,-1,2017-02-02
Civil Bank Ltd,31,239,223,230,10714,2462083,235,-5,2017-02-05
Civil Bank Ltd,35,233,225,232,9096,2084315,230,2,2017-02-06
Civil Bank Ltd,63,233,223,228,14111,3202691,232,-4,2017-02-07
Civil Bank Ltd,48,229,220,224,12847,2862785,228,-4,2017-02-08
Civil Bank Ltd,65,223,218,218,9643,2130063,224,-6,2017-02-09
Civil Bank Ltd,121,218,198,206,39004,7911130,218,-12,2017-02-12
Civil Bank Ltd,100,213,198,213,34122,6961597,206,7,2017-02-13
Civil Bank Ltd,43,214,203,214,9359,1954745,213,1,2017-02-14
Civil Bank Ltd,91,223,208,223,21584,4609936,214,9,2017-02-15
Civil Bank Ltd,81,231,216,223,22771,5039142,223,0,2017-02-16
Civil Bank Ltd,80,226,216,225,16400,3622359,223,2,2017-02-19
Civil Bank Ltd,97,230,215,215,26141,5795391,225,-10,2017-02-20
Civil Bank Ltd,87,220,211,215,63913,13609002,215,0,2017-02-21
Civil Bank Ltd,63,217,210,213,23525,5025248,215,-2,2017-02-22
Civil Bank Ltd,88,215,209,213,24718,5204184,213,0,2017-02-23
Civil Bank Ltd,45,215,210,213,12393,2624114,213,0,2017-02-26
Civil Bank Ltd,45,215,207,208,8842,1850629,213,-5,2017-02-28
Civil Bank Ltd,20,215,211,215,4217,898232,208,7,2017-03-01
Civil Bank Ltd,42,216,209,216,10028,2136441,215,1,2017-03-02
Civil Bank Ltd,52,218,212,215,15348,3300108,216,-1,2017-03-05
Civil Bank Ltd,160,234,219,230,72318,16275666,230,0,2017-03-21
Civil Bank Ltd,116,227,216,221,31405,6951844,215,6,2017-03-06
Civil Bank Ltd,61,219,213,217,14533,3131080,221,-4,2017-03-07
Civil Bank Ltd,60,218,214,215,14272,3076971,217,-2,2017-03-09
Civil Bank Ltd,34,216,211,215,7588,1625791,215,0,2017-03-13
Civil Bank Ltd,40,215,211,212,10986,2340923,215,-3,2017-03-14
Civil Bank Ltd,37,214,210,212,8122,1718404,212,0,2017-03-15
Civil Bank Ltd,39,216,211,213,14449,3062351,212,1,2017-03-16
Civil Bank Ltd,58,218,211,217,21029,4511438,213,4,2017-03-19
Civil Bank Ltd,170,236,220,230,76786,17465982,217,13,2017-03-20
Civil Bank Ltd,260,244,224,230,115003,26679817,230,0,2017-03-22
Civil Bank Ltd,123,230,222,226,45797,10325216,230,-4,2017-03-23
Civil Bank Ltd,234,238,221,233,121856,28079198,226,7,2017-03-26
Civil Bank Ltd,208,256,233,256,88561,22422936,233,23,2017-03-28
Civil Bank Ltd,376,281,257,257,139638,37424826,256,1,2017-03-29
Civil Bank Ltd,375,275,257,273,128469,34450443,257,16,2017-03-30
Civil Bank Ltd,168,300,268,298,59045,16924432,273,25,2017-04-02
Civil Bank Ltd,329,316,273,280,125295,36197873,298,-18,2017-04-03
Civil Bank Ltd,242,293,270,276,105404,29343834,280,-4,2017-04-04
Civil Bank Ltd,158,280,272,277,52909,14591115,276,1,2017-04-06
Civil Bank Ltd,161,285,274,275,45581,12652106,277,-2,2017-04-09
Civil Bank Ltd,128,279,271,277,47701,13149082,275,2,2017-04-10
Civil Bank Ltd,256,296,280,291,133873,38666036,277,14,2017-04-11
Civil Bank Ltd,261,300,282,282,100139,29002888,291,-9,2017-04-12
Civil Bank Ltd,236,289,279,280,82052,23241467,282,-2,2017-04-13
Civil Bank Ltd,163,284,269,269,65455,17996528,280,-11,2017-04-16
Civil Bank Ltd,105,270,260,270,27603,7360249,269,1,2017-04-18
Civil Bank Ltd,82,280,266,273,36761,9950395,270,3,2017-04-19
Civil Bank Ltd,80,280,267,271,19432,5300105,273,-2,2017-04-20
Civil Bank Ltd,104,295,273,276,51747,14416105,271,5,2017-04-23
Civil Bank Ltd,110,281,270,274,43642,12012011,276,-2,2017-04-24
Civil Bank Ltd,118,280,272,275,27809,7703251,274,1,2017-04-25
Civil Bank Ltd,102,275,269,269,28615,7761042,275,-6,2017-04-26
Civil Bank Ltd,123,276,260,275,38179,10403854,269,6,2017-04-27
Civil Bank Ltd,115,280,265,267,29712,8037709,275,-8,2017-04-30
Civil Bank Ltd,116,282,260,271,54027,14521043,267,4,2017-05-02
Civil Bank Ltd,122,276,266,266,33129,8947088,271,-5,2017-05-03
Civil Bank Ltd,95,269,260,260,22273,5837876,259,1,2017-05-04
Civil Bank Ltd,73,261,255,259,26380,6804954,260,-1,2017-05-07
Civil Bank Ltd,89,263,254,259,86513,22096376,259,0,2017-05-08
Civil Bank Ltd,71,262,254,261,41823,10749487,259,2,2017-05-09
Civil Bank Ltd,119,259,250,258,55352,14109512,261,-3,2017-05-11
Civil Bank Ltd,62,258,252,253,44018,11128287,258,-5,2017-05-15
Civil Bank Ltd,77,263,252,258,41672,10717572,253,5,2017-05-16
Civil Bank Ltd,99,267,258,261,41590,10916741,258,3,2017-05-17
Civil Bank Ltd,71,264,255,260,24857,6397244,261,-1,2017-05-18
Civil Bank Ltd,62,268,255,258,28159,7241212,260,-2,2017-05-21
Civil Bank Ltd,38,257,253,255,15111,3861619,258,-3,2017-05-22
Civil Bank Ltd,40,264,250,256,14697,3749391,255,1,2017-05-23
Civil Bank Ltd,57,258,251,255,22892,5828176,256,-1,2017-05-24
Civil Bank Ltd,69,260,250,252,37516,9464155,255,-3,2017-05-28
Civil Bank Ltd,71,255,249,250,27982,7028136,252,-2,2017-05-30
Civil Bank Ltd,57,256,247,253,20620,5167672,250,3,2017-05-31
Civil Bank Ltd,63,253,249,250,29106,7277009,253,-3,2017-06-01
Civil Bank Ltd,62,251,245,248,21339,5274038,250,-2,2017-06-04
Civil Bank Ltd,52,252,248,250,26077,6508535,248,2,2017-06-05
Civil Bank Ltd,96,255,241,253,298407,72664713,250,3,2017-06-06
Civil Bank Ltd,106,261,249,251,63739,16053157,253,-2,2017-06-07
Civil Bank Ltd,67,251,249,249,42455,10615254,251,-2,2017-06-08
Civil Bank Ltd,77,254,245,247,31252,7788604,249,-2,2017-06-11
Civil Bank Ltd,41,260,241,247,12154,3029356,247,0,2017-06-12
Civil Bank Ltd,59,250,247,248,16019,3984184,247,1,2017-06-13
Civil Bank Ltd,48,251,245,251,42066,10400292,248,3,2017-06-14
Civil Bank Ltd,60,254,246,248,13950,3479607,251,-3,2017-06-15
Civil Bank Ltd,46,250,240,242,17095,4148362,248,-6,2017-06-18
Civil Bank Ltd,51,240,235,237,22494,5368723,242,-5,2017-06-19
Civil Bank Ltd,33,242,235,236,14093,3352485,237,-1,2017-06-20
Civil Bank Ltd,45,240,234,240,11083,2634317,236,4,2017-06-21
Civil Bank Ltd,36,246,240,241,8541,2065750,240,1,2017-06-22
Civil Bank Ltd,41,247,240,247,11337,2745588,241,6,2017-06-25
Civil Bank Ltd,46,247,240,240,19696,4769521,247,-7,2017-06-27
Civil Bank Ltd,42,241,236,240,13168,3154256,240,0,2017-06-28
Civil Bank Ltd,47,242,236,237,10842,2579541,240,-3,2017-07-02
Civil Bank Ltd,37,240,235,237,13030,3081914,237,0,2017-07-03
Civil Bank Ltd,35,240,235,235,6249,1477012,237,-2,2017-07-04
Civil Bank Ltd,46,240,234,240,11012,2607634,235,5,2017-07-05
Civil Bank Ltd,71,247,235,246,45859,10980228,240,6,2017-07-06
Civil Bank Ltd,76,250,240,247,29717,7305460,246,1,2017-07-09
Civil Bank Ltd,71,245,239,240,36214,8730623,247,-7,2017-07-10
Civil Bank Ltd,50,245,239,241,21568,5209492,240,1,2017-07-11
Civil Bank Ltd,38,245,240,244,17112,4149550,241,3,2017-07-12
Civil Bank Ltd,41,246,240,246,11574,2813171,244,2,2017-07-13
Civil Bank Ltd,38,248,242,248,6647,1624219,246,2,2017-07-16
Civil Bank Ltd,161,260,248,260,59578,15142165,248,12,2017-07-17
Civil Bank Ltd,157,270,259,270,55447,14688982,260,10,2017-07-18
Civil Bank Ltd,87,260,253,253,34046,8678312,255,-2,2017-08-03
Civil Bank Ltd,133,272,261,264,48181,12793473,270,-6,2017-07-19
Civil Bank Ltd,96,264,260,260,28451,7435069,264,-4,2017-07-20
Civil Bank Ltd,92,264,257,264,34220,8893991,260,4,2017-07-23
Civil Bank Ltd,86,269,258,258,25842,6724840,264,-6,2017-07-24
Civil Bank Ltd,100,263,256,259,24720,6387786,258,1,2017-07-25
Civil Bank Ltd,70,269,255,255,23741,6091693,259,-4,2017-07-26
Civil Bank Ltd,69,258,252,253,17659,4486441,255,-2,2017-07-27
Civil Bank Ltd,79,259,250,250,21239,5358690,253,-3,2017-07-30
Civil Bank Ltd,75,257,250,257,25079,6377007,250,7,2017-07-31
Civil Bank Ltd,55,260,254,256,19548,5024952,257,-1,2017-08-01
Civil Bank Ltd,75,258,253,255,21095,5386345,256,-1,2017-08-02
Civil Bank Ltd,91,258,251,253,23399,5979463,253,0,2017-08-06
Civil Bank Ltd,50,256,252,253,11606,2940146,253,0,2017-08-07
Civil Bank Ltd,52,254,249,250,8868,2224602,253,-3,2017-08-09
Civil Bank Ltd,72,255,247,249,25351,6319630,250,-1,2017-08-10
Civil Bank Ltd,64,253,246,248,11322,2826155,249,-1,2017-08-13
Civil Bank Ltd,35,250,244,247,17303,4286844,248,-1,2017-08-15
Civil Bank Ltd,64,254,245,252,17526,4404871,247,5,2017-08-16
Civil Bank Ltd,64,252,247,250,16448,4082220,252,-2,2017-08-17
Civil Bank Ltd,64,250,244,244,24252,5947362,250,-6,2017-08-20
Civil Bank Ltd,47,246,240,243,10451,2546638,244,-1,2017-08-21
Civil Bank Ltd,61,245,236,241,15904,3839066,243,-2,2017-08-22
Civil Bank Ltd,49,245,239,241,20015,4818574,241,0,2017-08-23
Civil Bank Ltd,59,245,239,242,16976,3917777,241,1,2017-08-24
Civil Bank Ltd,61,245,239,240,19132,4618007,242,-2,2017-08-27
Civil Bank Ltd,77,243,232,240,19048,4540584,240,0,2017-08-28
Civil Bank Ltd,90,241,235,238,29026,6891750,240,-2,2017-08-30
Civil Bank Ltd,70,240,234,237,16171,3808215,238,-1,2017-08-31
Civil Bank Ltd,96,237,227,230,36778,8530050,237,-7,2017-09-04
Civil Bank Ltd,114,237,229,232,33292,7699268,230,2,2017-09-06
Civil Bank Ltd,109,235,229,230,38379,8826456,232,-2,2017-09-07
Civil Bank Ltd,117,228,223,225,45670,10296698,230,-5,2017-09-10
Civil Bank Ltd,80,227,221,223,26627,5951751,225,-2,2017-09-11
Civil Bank Ltd,76,225,220,224,25554,5700932,223,1,2017-09-12
Civil Bank Ltd,82,224,220,221,34007,7523063,224,-3,2017-09-13
Civil Bank Ltd,102,230,220,230,25084,5653293,221,9,2017-09-14
Civil Bank Ltd,62,234,222,230,9318,2130570,230,0,2017-09-17
Civil Bank Ltd,66,231,226,227,14169,3236631,230,-3,2017-09-18
Civil Bank Ltd,32,226,221,226,5263,1178025,227,-1,2017-10-09
Civil Bank Ltd,45,229,223,229,19840,4480958,226,3,2017-09-24
Civil Bank Ltd,36,234,227,230,11710,2709725,230,0,2017-09-26
Civil Bank Ltd,16,233,225,233,3778,871666,230,3,2017-10-03
Civil Bank Ltd,34,237,227,227,16356,3759622,233,-6,2017-10-04
Civil Bank Ltd,78,227,219,227,45784,10087260,227,0,2017-10-08
Civil Bank Ltd,38,227,222,223,8470,1894366,226,-3,2017-10-10
Civil Bank Ltd,39,227,222,227,9390,2116444,223,4,2017-10-11
Civil Bank Ltd,38,229,225,225,8195,1853690,227,-2,2017-10-12
Civil Bank Ltd,35,230,223,230,4561,1026629,225,5,2017-10-15
Civil Bank Ltd,72,240,231,232,20135,4717295,239,-7,2017-10-17
Civil Bank Ltd,99,245,229,240,53438,12642700,232,8,2017-10-18
Civil Bank Ltd,162,250,238,242,44153,10740125,240,2,2017-10-22
Civil Bank Ltd,66,245,240,243,11639,2814834,242,1,2017-10-23
Civil Bank Ltd,68,243,239,240,12299,2960490,243,-3,2017-10-24
Civil Bank Ltd,90,244,236,237,18813,4489590,240,-3,2017-10-25
Civil Bank Ltd,66,239,232,232,20502,4812372,237,-5,2017-10-29
Civil Bank Ltd,66,238,233,233,14653,3434336,235,-2,2017-10-31
Civil Bank Ltd,70,236,231,235,11443,2682965,233,2,2017-11-01
Civil Bank Ltd,64,235,231,233,13856,3230306,235,-2,2017-11-02
Civil Bank Ltd,199,234,225,230,82661,18844357,227,3,2017-11-06
Civil Bank Ltd,114,235,230,230,25715,5951660,230,0,2017-11-07
Civil Bank Ltd,78,230,227,228,13660,3124899,230,-2,2017-11-08
Civil Bank Ltd,64,231,226,229,14017,3210311,228,1,2017-11-09
Civil Bank Ltd,57,232,227,231,14653,3367213,229,2,2017-11-12
Civil Bank Ltd,146,236,230,236,37107,8656971,231,5,2017-11-13
Civil Bank Ltd,264,242,234,240,64059,15253061,236,4,2017-11-14
Civil Bank Ltd,228,245,235,239,54102,12920518,240,-1,2017-11-15
Civil Bank Ltd,145,241,234,234,33870,7973507,239,-5,2017-11-16
Civil Bank Ltd,203,235,226,227,65984,15012062,234,-7,2017-11-19
Civil Bank Ltd,366,231,225,227,112036,25352904,227,0,2017-11-20
Civil Bank Ltd,151,192,182,189,29954,5659348,191,-2,2017-11-21
Civil Bank Ltd,102,193,186,192,33346,6368740,189,3,2017-11-22
Civil Bank Ltd,64,198,195,198,12654,2486467,196,2,2017-11-26
Civil Bank Ltd,89,198,195,197,23953,4710352,198,-1,2017-11-27
Civil Bank Ltd,51,197,193,197,12391,2422488,197,0,2017-11-28
Civil Bank Ltd,55,200,195,198,17219,3389862,197,1,2017-11-29
Civil Bank Ltd,73,198,194,195,20231,3953803,198,-3,2017-11-30
Civil Bank Ltd,50,198,194,194,6140,1197676,195,-1,2017-12-04
Civil Bank Ltd,43,193,189,191,19814,3773120,190,1,2017-12-20
Civil Bank Ltd,43,197,195,195,9928,1941494,196,-1,2017-12-11
Civil Bank Ltd,36,195,192,193,10544,2040031,195,-2,2017-12-12
Civil Bank Ltd,59,193,190,190,17577,3362916,195,-5,2017-12-19
Civil Bank Ltd,57,192,188,191,19873,3773809,191,0,2017-12-21
Civil Bank Ltd,49,192,187,187,15055,2860556,191,-4,2017-12-24
Civil Bank Ltd,74,190,185,185,16919,3146086,187,-2,2017-12-26
Civil Bank Ltd,61,185,179,183,22663,4128666,185,-2,2017-12-27
Civil Bank Ltd,55,184,177,182,17365,3139100,183,-1,2017-12-28
Civil Bank Ltd,46,180,177,178,21690,3871565,182,-4,2017-12-31
Civil Bank Ltd,49,184,178,182,13393,2420172,178,4,2018-01-01
Civil Bank Ltd,36,184,179,180,6741,1219798,181,-1,2018-01-07
Civil Bank Ltd,80,187,180,183,30785,5644511,180,3,2018-01-08
Civil Bank Ltd,36,187,183,185,10865,2007755,185,0,2018-01-10
Civil Bank Ltd,62,184,179,180,19920,3600292,185,-5,2018-01-14
Civil Bank Ltd,47,180,177,179,16357,2923092,180,-1,2018-01-16
Civil Bank Ltd,50,179,177,178,14323,2556272,179,-1,2018-01-17
Civil Bank Ltd,28,179,175,177,5454,966522,175,2,2018-01-23
Civil Bank Ltd,32,180,175,179,10111,1799444,177,2,2018-01-24
Civil Bank Ltd,34,183,176,179,4207,748476,177,2,2018-01-29
Civil Bank Ltd,34,180,177,179,5679,1013958,179,0,2018-01-31
Civil Bank Ltd,47,179,177,179,8424,1501878,179,0,2018-02-01
Civil Bank Ltd,39,179,173,177,43791,7615121,179,-2,2018-02-05
Civil Bank Ltd,27,177,175,175,37613,6653233,177,-2,2018-02-06
Civil Bank Ltd,60,176,172,174,58854,10187134,175,-1,2018-02-07
Civil Bank Ltd,86,175,168,174,63191,10763111,174,0,2018-02-08
Civil Bank Ltd,35,176,171,173,5719,990953,173,0,2018-02-25
Civil Bank Ltd,28,175,172,174,3683,638652,174,0,2018-02-11
Civil Bank Ltd,49,173,171,172,10436,1795090,174,-2,2018-02-12
Civil Bank Ltd,53,175,171,175,13861,2382407,172,3,2018-02-14
Civil Bank Ltd,81,182,175,175,31438,5597218,179,-4,2018-02-18
Civil Bank Ltd,29,174,171,173,4334,744624,171,2,2018-02-21
Civil Bank Ltd,49,175,171,173,16582,2881295,173,0,2018-02-22
Civil Bank Ltd,42,174,171,171,7236,1243346,173,-2,2018-02-26
Civil Bank Ltd,31,174,171,171,9817,1681811,171,0,2018-02-27
Civil Bank Ltd,86,160,152,155,29777,4600325,161,-6,2018-03-04
Civil Bank Ltd,108,158,149,150,45553,6902411,155,-5,2018-03-05
Civil Bank Ltd,81,156,150,155,19728,2997997,150,5,2018-03-06
Civil Bank Ltd,115,159,153,157,28242,4417102,155,2,2018-03-07
Civil Bank Ltd,84,156,150,150,20422,3099467,157,-7,2018-03-11
Civil Bank Ltd,71,153,149,149,15881,2385066,150,-1,2018-03-12
Civil Bank Ltd,52,153,150,153,9320,1404471,149,4,2018-03-13
Civil Bank Ltd,51,153,150,153,11888,1804471,153,0,2018-03-14
Civil Bank Ltd,48,158,152,154,13443,2059561,153,1,2018-03-15
Civil Bank Ltd,59,154,150,153,15302,2319349,154,-1,2018-03-18
Civil Bank Ltd,69,154,149,150,23360,3519843,153,-3,2018-03-19
Civil Bank Ltd,98,150,147,148,23714,3514831,150,-2,2018-03-20
Civil Bank Ltd,119,150,143,144,35159,5089609,148,-4,2018-03-21
Civil Bank Ltd,103,147,142,143,33895,4887146,144,-1,2018-03-22
Civil Bank Ltd,91,144,137,140,27189,3792068,143,-3,2018-03-26
Civil Bank Ltd,111,149,142,144,25921,3763620,145,-1,2018-03-28
Civil Bank Ltd,43,147,142,145,6784,981938,146,-1,2018-04-01
Civil Bank Ltd,45,145,142,145,11461,1647661,145,0,2018-04-02
Civil Bank Ltd,37,147,143,145,10713,1554231,145,0,2018-04-03
Civil Bank Ltd,42,149,144,149,14250,2100540,145,4,2018-04-04
Civil Bank Ltd,40,157,151,152,9022,1378202,155,-3,2018-04-10
Civil Bank Ltd,23,155,150,152,3328,505692,152,0,2018-04-11
Civil Bank Ltd,44,156,151,151,10287,1572057,152,-1,2018-04-12
Civil Bank Ltd,27,155,149,155,10729,1637341,151,4,2018-04-15
Civil Bank Ltd,71,160,152,155,27794,4368315,154,1,2018-04-17
Civil Bank Ltd,82,170,155,158,41903,6697363,155,3,2018-04-18
Civil Bank Ltd,154,173,167,170,60028,10214406,165,5,2018-04-22
Civil Bank Ltd,76,173,165,168,35196,5885276,169,-1,2018-04-25
Civil Bank Ltd,50,170,163,163,20271,3350296,168,-5,2018-04-26
Civil Bank Ltd,56,166,162,166,15976,2623390,165,1,2018-05-02
Civil Bank Ltd,84,171,163,166,26572,4453757,166,0,2018-05-03
Civil Bank Ltd,60,167,163,167,12445,2046103,166,1,2018-05-06
Civil Bank Ltd,51,166,164,165,13817,2269524,167,-2,2018-05-07
Civil Bank Ltd,57,168,161,168,577886,93100946,165,3,2018-05-08
Civil Bank Ltd,75,169,165,169,24030,3999308,168,1,2018-05-09
Civil Bank Ltd,40,170,165,166,9795,1629767,169,-3,2018-05-10
Civil Bank Ltd,48,169,163,168,11219,1844083,166,2,2018-05-14
Civil Bank Ltd,19,166,164,164,4540,749090,168,-4,2018-05-15
Civil Bank Ltd,32,167,164,167,12225,2026604,164,3,2018-05-16
Civil Bank Ltd,54,169,163,163,15129,2491847,166,-3,2018-05-20
Civil Bank Ltd,36,165,162,165,6486,1059189,163,2,2018-05-21
Civil Bank Ltd,32,165,162,165,5322,868847,165,0,2018-05-22
Civil Bank Ltd Promoter Share,1,128,128,128,809632,103632896,130,-2,2016-06-05
Civil Bank Ltd Promoter Share,13,135,135,135,43846,5919210,135,0,2016-11-27
Civil Bank Ltd Promoter Share,1,135,135,135,10738,1449630,135,0,2016-11-29
Civil Bank Ltd Promoter Share,3,135,135,135,48784,6585840,135,0,2016-12-04
Civil Bank Ltd Promoter Share,3,135,135,135,13664,1844640,135,0,2016-12-06
Civil Bank Ltd Promoter Share,1,135,135,135,9760,1317600,135,0,2016-12-07
Civil Bank Ltd Promoter Share,2,135,135,135,9760,1317600,135,0,2016-12-08
Civil Bank Ltd Promoter Share,1,135,135,135,4880,658800,135,0,2016-12-11
Civil Bank Ltd Promoter Share,1,135,135,135,2440,329400,135,0,2016-12-12
Civil Bank Ltd Promoter Share,2,135,135,135,10260,1385100,135,0,2016-12-21
Civil Bank Ltd Promoter Share,2,135,135,135,9760,1317600,135,0,2016-12-28
Civil Bank Ltd Promoter Share,1,135,135,135,4880,658800,135,0,2017-01-02
Civil Bank Ltd Promoter Share,3,135,135,135,15640,2111400,135,0,2017-01-04
Civil Bank Ltd Promoter Share,1,135,135,135,4880,658800,135,0,2017-01-05
Civil Bank Ltd Promoter Share,2,135,135,135,9760,1317600,135,0,2017-01-08
Civil Bank Ltd Promoter Share,2,135,135,135,5232,706320,135,0,2017-01-09
Civil Bank Ltd Promoter Share,1,135,135,135,4880,658800,135,0,2017-01-10
Civil Bank Ltd Promoter Share,3,135,135,135,16490,2226150,135,0,2017-01-11
Civil Bank Ltd Promoter Share,4,135,135,135,108341,14626035,135,0,2017-01-12
Civil Bank Ltd Promoter Share,3,135,135,135,19520,2635200,135,0,2017-01-15
Civil Bank Ltd Promoter Share,1,135,135,135,9760,1317600,135,0,2017-01-17
Civil Bank Ltd Promoter Share,1,135,135,135,4880,658800,135,0,2017-01-22
Civil Bank Ltd Promoter Share,1,135,135,135,9760,1317600,135,0,2017-01-23
Civil Bank Ltd Promoter Share,4,135,135,135,65394,8828190,135,0,2017-01-24
Civil Bank Ltd Promoter Share,1,135,135,135,4880,658800,135,0,2017-01-25
Civil Bank Ltd Promoter Share,1,135,135,135,6344,856440,135,0,2017-01-31
Civil Bank Ltd Promoter Share,2,135,135,135,9760,1317600,135,0,2017-02-08
Civil Bank Ltd Promoter Share,1,135,135,135,1952,263520,135,0,2017-02-12
Civil Bank Ltd Promoter Share,1,135,135,135,4880,658800,135,0,2017-02-23
Civil Bank Ltd Promoter Share,2,135,135,135,14640,1976400,135,0,2017-03-16
Civil Bank Ltd Promoter Share,2,135,135,135,5600,756000,135,0,2017-03-19
Civil Bank Ltd Promoter Share,4,137,135,135,19880,2713800,135,0,2017-04-04
Civil Bank Ltd Promoter Share,1,135,135,135,976,131760,135,0,2017-04-12
Civil Bank Ltd Promoter Share,1,135,135,135,9679,1306665,135,0,2017-04-18
Civil Bank Ltd Promoter Share,2,135,135,135,6832,922320,135,0,2017-04-19
Civil Bank Ltd Promoter Share,3,135,135,135,73300,9895500,135,0,2017-04-26
Civil Bank Ltd Promoter Share,3,135,135,135,42046,5676210,135,0,2017-04-27
Civil Bank Ltd Promoter Share,21,137,133,135,197117,26579179,135,0,2017-05-02
Civil Bank Ltd Promoter Share,2,135,135,135,9760,1317600,135,0,2017-06-13
Civil Bank Ltd Promoter Share,3,135,135,135,17080,2305800,135,0,2017-06-14
Civil Bank Ltd Promoter Share,1,135,135,135,2928,395280,135,0,2017-06-15
Civil Bank Ltd Promoter Share,1,135,135,135,15422,2081970,135,0,2017-06-21
Civil Bank Ltd Promoter Share,1,135,135,135,976,131760,135,0,2017-07-23
Civil Bank Ltd Promoter Share,2,131,131,131,6768,886608,131,0,2017-08-31
Civil Bank Ltd Promoter Share,1,131,131,131,10915,1429865,131,0,2017-09-04
Civil Bank Ltd Promoter Share,2,131,131,131,8830,1156730,131,0,2017-11-14
Civil Bank Ltd Promoter Share,11,131,131,131,70440,9227640,131,0,2017-11-20
Civil Laghubitta Bittiya Sanstha Ltd.,96,1508,1462,1475,2885,4259395,1450,25,2016-05-23
Civil Laghubitta Bittiya Sanstha Ltd.,37,1500,1441,1471,2965,4344775,1475,-4,2016-05-24
Civil Laghubitta Bittiya Sanstha Ltd.,42,1470,1430,1451,3430,4989865,1471,-20,2016-05-25
Civil Laghubitta Bittiya Sanstha Ltd.,40,1475,1410,1475,2810,4061505,1451,24,2016-05-26
Civil Laghubitta Bittiya Sanstha Ltd.,11,1460,1410,1460,377,545310,1475,-15,2016-05-29
Civil Laghubitta Bittiya Sanstha Ltd.,16,1460,1431,1455,1481,2153299,1460,-5,2016-05-30
Civil Laghubitta Bittiya Sanstha Ltd.,16,1454,1426,1432,1097,1579865,1455,-23,2016-05-31
Civil Laghubitta Bittiya Sanstha Ltd.,23,1460,1417,1460,1031,1471055,1432,28,2016-06-01
Civil Laghubitta Bittiya Sanstha Ltd.,47,1460,1400,1450,1940,2796555,1460,-10,2016-06-02
Civil Laghubitta Bittiya Sanstha Ltd.,4,1425,1366,1366,310,432250,1450,-84,2016-06-05
Civil Laghubitta Bittiya Sanstha Ltd.,23,1420,1340,1420,1275,1773950,1366,54,2016-06-06
Civil Laghubitta Bittiya Sanstha Ltd.,35,1450,1400,1407,2385,3414780,1420,-13,2016-06-07
Civil Laghubitta Bittiya Sanstha Ltd.,48,1820,1784,1819,1867,3383438,1800,19,2016-06-23
Civil Laghubitta Bittiya Sanstha Ltd.,18,1440,1390,1410,331,466280,1407,3,2016-06-08
Civil Laghubitta Bittiya Sanstha Ltd.,36,1453,1400,1411,944,1348394,1410,1,2016-06-09
Civil Laghubitta Bittiya Sanstha Ltd.,24,1460,1385,1435,1269,1839695,1411,24,2016-06-12
Civil Laghubitta Bittiya Sanstha Ltd.,51,1578,1420,1578,3763,5584670,1435,143,2016-06-13
Civil Laghubitta Bittiya Sanstha Ltd.,79,1735,1580,1735,5323,8867550,1578,157,2016-06-14
Civil Laghubitta Bittiya Sanstha Ltd.,55,1730,1650,1720,2226,3818309,1735,-15,2016-06-15
Civil Laghubitta Bittiya Sanstha Ltd.,54,1860,1665,1860,2410,4167220,1720,140,2016-06-16
Civil Laghubitta Bittiya Sanstha Ltd.,45,1900,1811,1811,2140,3987220,1860,-49,2016-06-19
Civil Laghubitta Bittiya Sanstha Ltd.,23,1775,1706,1715,875,1508800,1811,-96,2016-06-20
Civil Laghubitta Bittiya Sanstha Ltd.,44,1755,1715,1721,1861,3230580,1715,6,2016-06-21
Civil Laghubitta Bittiya Sanstha Ltd.,26,1810,1750,1800,1045,1864815,1721,79,2016-06-22
Civil Laghubitta Bittiya Sanstha Ltd.,29,1800,1715,1780,1770,3097310,1819,-39,2016-06-26
Civil Laghubitta Bittiya Sanstha Ltd.,43,1770,1680,1722,3479,6030745,1780,-58,2016-06-27
Civil Laghubitta Bittiya Sanstha Ltd.,40,1734,1690,1715,1695,2891300,1722,-7,2016-06-28
Civil Laghubitta Bittiya Sanstha Ltd.,38,1808,1725,1799,3710,6483880,1715,84,2016-06-29
Civil Laghubitta Bittiya Sanstha Ltd.,15,1809,1740,1775,640,1136390,1799,-24,2016-06-30
Civil Laghubitta Bittiya Sanstha Ltd.,69,1952,1775,1952,3769,7071213,1775,177,2016-07-03
Civil Laghubitta Bittiya Sanstha Ltd.,47,2000,1809,1860,1670,3212055,1952,-92,2016-07-04
Civil Laghubitta Bittiya Sanstha Ltd.,41,1850,1773,1820,2630,4772245,1860,-40,2016-07-05
Civil Laghubitta Bittiya Sanstha Ltd.,38,1800,1690,1750,3199,5667962,1820,-70,2016-07-06
Civil Laghubitta Bittiya Sanstha Ltd.,55,1785,1695,1700,6052,10450581,1750,-50,2016-07-10
Civil Laghubitta Bittiya Sanstha Ltd.,38,1780,1675,1725,3745,6468925,1700,25,2016-07-11
Civil Laghubitta Bittiya Sanstha Ltd.,18,1780,1667,1667,1640,2759465,1725,-58,2016-07-12
Civil Laghubitta Bittiya Sanstha Ltd.,45,1670,1520,1625,2800,4516000,1667,-42,2016-07-13
Civil Laghubitta Bittiya Sanstha Ltd.,76,1787,1593,1593,9206,15633450,1625,-32,2016-07-14
Civil Laghubitta Bittiya Sanstha Ltd.,7,1562,1434,1434,200,303840,1593,-159,2016-07-17
Civil Laghubitta Bittiya Sanstha Ltd.,100,1406,1291,1350,7632,10330640,1434,-84,2016-07-18
Civil Laghubitta Bittiya Sanstha Ltd.,37,1370,1260,1276,1949,2537004,1350,-74,2016-07-19
Civil Laghubitta Bittiya Sanstha Ltd.,48,1276,1210,1210,3786,4684290,1276,-66,2016-07-20
Civil Laghubitta Bittiya Sanstha Ltd.,38,1285,1200,1285,2765,3434425,1210,75,2016-07-21
Civil Laghubitta Bittiya Sanstha Ltd.,33,1406,1286,1406,1820,2458880,1285,121,2016-07-25
Civil Laghubitta Bittiya Sanstha Ltd.,38,1450,1410,1420,2259,3217791,1406,14,2016-07-26
Civil Laghubitta Bittiya Sanstha Ltd.,10,1395,1368,1380,990,1365280,1420,-40,2016-07-27
Civil Laghubitta Bittiya Sanstha Ltd.,34,1380,1275,1337,1740,2323730,1380,-43,2016-07-28
Civil Laghubitta Bittiya Sanstha Ltd.,42,1393,1304,1310,3649,4938791,1337,-27,2016-07-31
Civil Laghubitta Bittiya Sanstha Ltd.,31,1340,1284,1340,1771,2315965,1310,30,2016-08-01
Civil Laghubitta Bittiya Sanstha Ltd.,26,1330,1300,1325,1580,2081955,1340,-15,2016-08-02
Civil Laghubitta Bittiya Sanstha Ltd.,18,1310,1274,1310,515,666255,1325,-15,2016-08-03
Civil Laghubitta Bittiya Sanstha Ltd.,17,1336,1260,1280,640,824425,1310,-30,2016-08-04
Civil Laghubitta Bittiya Sanstha Ltd.,24,1303,1250,1250,1791,2278545,1280,-30,2016-08-07
Civil Laghubitta Bittiya Sanstha Ltd.,1,1225,1225,1225,87,106575,1250,-25,2016-08-08
Civil Laghubitta Bittiya Sanstha Ltd.,27,1254,1216,1221,1975,2447870,1225,-4,2016-08-10
Civil Laghubitta Bittiya Sanstha Ltd.,40,1244,1200,1229,4465,5485685,1221,8,2016-08-11
Civil Laghubitta Bittiya Sanstha Ltd.,30,1210,1150,1165,1485,1738025,1229,-64,2016-08-14
Civil Laghubitta Bittiya Sanstha Ltd.,29,1155,1096,1139,1256,1417863,1165,-26,2016-08-15
Civil Laghubitta Bittiya Sanstha Ltd.,19,1248,1192,1200,525,634915,1216,-16,2016-08-31
Civil Laghubitta Bittiya Sanstha Ltd.,18,1183,1110,1110,657,746510,1139,-29,2016-08-16
Civil Laghubitta Bittiya Sanstha Ltd.,16,1180,1095,1160,1580,1780190,1110,50,2016-08-17
Civil Laghubitta Bittiya Sanstha Ltd.,27,1229,1150,1150,1314,1571307,1160,-10,2016-08-21
Civil Laghubitta Bittiya Sanstha Ltd.,10,1130,1105,1115,435,484535,1150,-35,2016-08-22
Civil Laghubitta Bittiya Sanstha Ltd.,21,1137,1100,1110,691,773961,1115,-5,2016-08-23
Civil Laghubitta Bittiya Sanstha Ltd.,21,1196,1115,1170,1505,1717280,1110,60,2016-08-24
Civil Laghubitta Bittiya Sanstha Ltd.,15,1193,1140,1193,890,1041650,1170,23,2016-08-28
Civil Laghubitta Bittiya Sanstha Ltd.,9,1200,1170,1170,260,305390,1193,-23,2016-08-29
Civil Laghubitta Bittiya Sanstha Ltd.,17,1216,1150,1216,2230,2616570,1170,46,2016-08-30
Civil Laghubitta Bittiya Sanstha Ltd.,14,1200,1169,1170,435,510335,1200,-30,2016-09-01
Civil Laghubitta Bittiya Sanstha Ltd.,10,1190,1147,1185,510,601005,1170,15,2016-09-04
Civil Laghubitta Bittiya Sanstha Ltd.,7,1171,1165,1170,265,308980,1185,-15,2016-09-05
Civil Laghubitta Bittiya Sanstha Ltd.,14,1205,1172,1172,370,443050,1170,2,2016-09-06
Civil Laghubitta Bittiya Sanstha Ltd.,24,1208,1172,1180,925,1098360,1172,8,2016-09-07
Civil Laghubitta Bittiya Sanstha Ltd.,21,1200,1170,1186,675,802195,1180,6,2016-09-08
Civil Laghubitta Bittiya Sanstha Ltd.,6,1200,1176,1176,385,454775,1186,-10,2016-09-11
Civil Laghubitta Bittiya Sanstha Ltd.,10,1200,1171,1171,1240,1466890,1176,-5,2016-09-12
Civil Laghubitta Bittiya Sanstha Ltd.,16,1195,1148,1195,365,429300,1171,24,2016-09-14
Civil Laghubitta Bittiya Sanstha Ltd.,28,1200,1174,1179,1028,1218581,1195,-16,2016-09-18
Civil Laghubitta Bittiya Sanstha Ltd.,17,1180,1142,1142,465,540305,1179,-37,2016-09-20
Civil Laghubitta Bittiya Sanstha Ltd.,24,1236,1122,1202,2497,2993762,1142,60,2016-09-21
Civil Laghubitta Bittiya Sanstha Ltd.,8,1200,1170,1170,619,735450,1202,-32,2016-09-22
Civil Laghubitta Bittiya Sanstha Ltd.,16,1150,1085,1101,595,660545,1170,-69,2016-09-25
Civil Laghubitta Bittiya Sanstha Ltd.,15,1170,1095,1170,525,587040,1101,69,2016-09-26
Civil Laghubitta Bittiya Sanstha Ltd.,9,1204,1150,1150,1310,1565790,1170,-20,2016-09-27
Civil Laghubitta Bittiya Sanstha Ltd.,20,1155,1130,1130,595,677975,1150,-20,2016-09-28
Civil Laghubitta Bittiya Sanstha Ltd.,14,1113,1090,1113,775,858490,1130,-17,2016-09-29
Civil Laghubitta Bittiya Sanstha Ltd.,15,1091,1030,1040,1135,1195150,1113,-73,2016-10-02
Civil Laghubitta Bittiya Sanstha Ltd.,40,1050,996,1000,2390,2403985,1040,-40,2016-10-03
Civil Laghubitta Bittiya Sanstha Ltd.,23,1004,982,995,1635,1623170,1000,-5,2016-10-04
Civil Laghubitta Bittiya Sanstha Ltd.,7,1045,995,1045,104,106130,995,50,2016-10-05
Civil Laghubitta Bittiya Sanstha Ltd.,19,1071,1015,1050,420,434745,1045,5,2016-10-06
Civil Laghubitta Bittiya Sanstha Ltd.,11,1060,1025,1040,220,227745,1050,-10,2016-10-16
Civil Laghubitta Bittiya Sanstha Ltd.,4,1040,1020,1030,40,41300,1040,-10,2016-10-27
Civil Laghubitta Bittiya Sanstha Ltd.,14,1010,990,1010,170,170190,1030,-20,2016-11-03
Civil Laghubitta Bittiya Sanstha Ltd.,14,1020,985,1000,295,295915,1010,-10,2016-11-07
Civil Laghubitta Bittiya Sanstha Ltd.,6,1010,986,1000,555,555965,1000,0,2016-11-08
Civil Laghubitta Bittiya Sanstha Ltd.,6,1000,998,998,190,189950,1000,-2,2016-11-09
Civil Laghubitta Bittiya Sanstha Ltd.,26,995,904,921,1142,1061695,998,-77,2016-11-10
Civil Laghubitta Bittiya Sanstha Ltd.,13,910,900,910,610,551530,921,-11,2016-11-13
Civil Laghubitta Bittiya Sanstha Ltd.,19,920,900,900,1425,1284390,910,-10,2016-11-14
Civil Laghubitta Bittiya Sanstha Ltd.,5,900,858,858,550,481980,900,-42,2016-11-15
Civil Laghubitta Bittiya Sanstha Ltd.,27,841,774,780,960,766895,858,-78,2016-11-16
Civil Laghubitta Bittiya Sanstha Ltd.,22,807,736,736,1345,1023475,780,-44,2016-11-17
Civil Laghubitta Bittiya Sanstha Ltd.,25,736,686,690,1351,944606,736,-46,2016-11-20
Civil Laghubitta Bittiya Sanstha Ltd.,25,717,677,706,4544,3147310,690,16,2016-11-21
Civil Laghubitta Bittiya Sanstha Ltd.,19,731,692,730,4221,3019197,706,24,2016-11-22
Civil Laghubitta Bittiya Sanstha Ltd.,29,744,707,720,1465,1057475,730,-10,2016-11-23
Civil Laghubitta Bittiya Sanstha Ltd.,15,715,668,705,1335,904170,720,-15,2016-11-24
Civil Laghubitta Bittiya Sanstha Ltd.,8,705,680,690,325,225115,705,-15,2016-11-27
Civil Laghubitta Bittiya Sanstha Ltd.,6,683,670,683,210,142750,690,-7,2016-11-28
Civil Laghubitta Bittiya Sanstha Ltd.,29,717,660,717,3200,2186980,683,34,2016-11-29
Civil Laghubitta Bittiya Sanstha Ltd.,23,788,715,788,1499,1111815,717,71,2016-11-30
Civil Laghubitta Bittiya Sanstha Ltd.,47,866,775,800,4011,3254666,788,12,2016-12-01
Civil Laghubitta Bittiya Sanstha Ltd.,14,785,736,736,1325,1004710,800,-64,2016-12-04
Civil Laghubitta Bittiya Sanstha Ltd.,21,722,708,712,295,211115,736,-24,2016-12-05
Civil Laghubitta Bittiya Sanstha Ltd.,25,743,706,715,255,184235,712,3,2016-12-06
Civil Laghubitta Bittiya Sanstha Ltd.,11,755,721,740,330,245040,715,25,2016-12-07
Civil Laghubitta Bittiya Sanstha Ltd.,24,730,715,720,1640,1180950,740,-20,2016-12-08
Civil Laghubitta Bittiya Sanstha Ltd.,35,735,713,735,704,507025,720,15,2016-12-11
Civil Laghubitta Bittiya Sanstha Ltd.,10,725,715,722,1090,785840,735,-13,2016-12-12
Civil Laghubitta Bittiya Sanstha Ltd.,13,725,702,710,1130,803075,722,-12,2016-12-14
Civil Laghubitta Bittiya Sanstha Ltd.,8,737,700,723,330,237990,710,13,2016-12-15
Civil Laghubitta Bittiya Sanstha Ltd.,13,730,695,730,410,289045,723,7,2016-12-18
Civil Laghubitta Bittiya Sanstha Ltd.,7,730,716,720,440,316240,730,-10,2016-12-19
Civil Laghubitta Bittiya Sanstha Ltd.,16,711,680,693,1490,1049660,720,-27,2016-12-20
Civil Laghubitta Bittiya Sanstha Ltd.,11,700,667,700,489,333355,693,7,2016-12-21
Civil Laghubitta Bittiya Sanstha Ltd.,17,690,660,662,605,403800,700,-38,2016-12-22
Civil Laghubitta Bittiya Sanstha Ltd.,9,710,671,710,220,150650,662,48,2016-12-26
Civil Laghubitta Bittiya Sanstha Ltd.,6,710,696,696,110,77260,710,-14,2016-12-27
Civil Laghubitta Bittiya Sanstha Ltd.,14,717,683,700,1040,730985,696,4,2016-12-28
Civil Laghubitta Bittiya Sanstha Ltd.,30,717,690,717,825,579815,700,17,2016-12-29
Civil Laghubitta Bittiya Sanstha Ltd.,5,710,701,705,620,437660,717,-12,2017-01-01
Civil Laghubitta Bittiya Sanstha Ltd.,1,715,715,715,10,7150,705,10,2017-01-02
Civil Laghubitta Bittiya Sanstha Ltd.,5,703,670,683,90,61960,715,-32,2017-01-03
Civil Laghubitta Bittiya Sanstha Ltd.,15,701,671,700,520,357350,683,17,2017-01-04
Civil Laghubitta Bittiya Sanstha Ltd.,8,692,686,686,95,65570,700,-14,2017-01-05
Civil Laghubitta Bittiya Sanstha Ltd.,13,698,685,695,905,629185,686,9,2017-01-09
Civil Laghubitta Bittiya Sanstha Ltd.,4,715,700,701,41,28948,695,6,2017-01-10
Civil Laghubitta Bittiya Sanstha Ltd.,3,687,674,677,40,27200,701,-24,2017-01-11
Civil Laghubitta Bittiya Sanstha Ltd.,17,679,666,679,170,115300,677,2,2017-01-16
Civil Laghubitta Bittiya Sanstha Ltd.,2,670,670,670,40,26800,679,-9,2017-01-18
Civil Laghubitta Bittiya Sanstha Ltd.,1,660,660,660,15,9900,670,-10,2017-01-19
Civil Laghubitta Bittiya Sanstha Ltd.,11,654,641,650,220,143145,660,-10,2017-01-22
Civil Laghubitta Bittiya Sanstha Ltd.,4,663,642,642,45,29410,650,-8,2017-01-24
Civil Laghubitta Bittiya Sanstha Ltd.,8,654,640,645,160,103155,642,3,2017-01-25
Civil Laghubitta Bittiya Sanstha Ltd.,14,640,621,630,726,459435,645,-15,2017-01-26
Civil Laghubitta Bittiya Sanstha Ltd.,12,618,584,584,1010,606805,630,-46,2017-01-30
Civil Laghubitta Bittiya Sanstha Ltd.,9,573,559,559,415,234940,584,-25,2017-01-31
Civil Laghubitta Bittiya Sanstha Ltd.,9,592,555,592,90,51270,559,33,2017-02-01
Civil Laghubitta Bittiya Sanstha Ltd.,4,603,591,591,80,47530,592,-1,2017-02-02
Civil Laghubitta Bittiya Sanstha Ltd.,7,650,602,650,130,81120,591,59,2017-02-05
Civil Laghubitta Bittiya Sanstha Ltd.,2,640,628,628,110,70280,650,-22,2017-02-06
Civil Laghubitta Bittiya Sanstha Ltd.,11,628,592,600,165,100370,628,-28,2017-02-07
Civil Laghubitta Bittiya Sanstha Ltd.,10,600,577,578,140,81710,600,-22,2017-02-08
Civil Laghubitta Bittiya Sanstha Ltd.,36,578,533,540,1360,742225,578,-38,2017-02-09
Civil Laghubitta Bittiya Sanstha Ltd.,13,540,530,531,320,170445,540,-9,2017-02-12
Civil Laghubitta Bittiya Sanstha Ltd.,9,531,504,515,345,177700,531,-16,2017-02-13
Civil Laghubitta Bittiya Sanstha Ltd.,17,520,507,520,422,218180,515,5,2017-02-14
Civil Laghubitta Bittiya Sanstha Ltd.,32,561,530,545,570,311620,520,25,2017-02-15
Civil Laghubitta Bittiya Sanstha Ltd.,20,570,546,556,355,195990,545,11,2017-02-16
Civil Laghubitta Bittiya Sanstha Ltd.,2,550,540,550,20,10900,530,20,2017-02-19
Civil Laghubitta Bittiya Sanstha Ltd.,18,605,561,605,1123,673200,550,55,2017-02-20
Civil Laghubitta Bittiya Sanstha Ltd.,31,665,617,665,1901,1249840,605,60,2017-02-21
Civil Laghubitta Bittiya Sanstha Ltd.,9,678,660,665,876,586143,665,0,2017-02-22
Civil Laghubitta Bittiya Sanstha Ltd.,5,665,652,660,50,33070,665,-5,2017-02-23
Civil Laghubitta Bittiya Sanstha Ltd.,3,647,630,630,50,31820,660,-30,2017-02-26
Civil Laghubitta Bittiya Sanstha Ltd.,6,630,618,630,215,134500,630,0,2017-03-01
Civil Laghubitta Bittiya Sanstha Ltd.,16,642,622,632,640,404310,630,2,2017-03-02
Civil Laghubitta Bittiya Sanstha Ltd.,2,644,640,640,225,144860,632,8,2017-03-05
Civil Laghubitta Bittiya Sanstha Ltd.,4,694,668,694,90,61030,655,39,2017-03-21
Civil Laghubitta Bittiya Sanstha Ltd.,6,655,646,647,275,178820,640,7,2017-03-06
Civil Laghubitta Bittiya Sanstha Ltd.,1,635,635,635,100,63500,647,-12,2017-03-07
Civil Laghubitta Bittiya Sanstha Ltd.,4,644,620,644,135,85290,635,9,2017-03-09
Civil Laghubitta Bittiya Sanstha Ltd.,1,635,635,635,10,6350,644,-9,2017-03-13
Civil Laghubitta Bittiya Sanstha Ltd.,2,630,630,630,20,12600,635,-5,2017-03-14
Civil Laghubitta Bittiya Sanstha Ltd.,2,642,640,642,110,70600,630,12,2017-03-15
Civil Laghubitta Bittiya Sanstha Ltd.,4,648,640,640,235,152050,642,-2,2017-03-16
Civil Laghubitta Bittiya Sanstha Ltd.,6,655,650,655,270,175900,640,15,2017-03-19
Civil Laghubitta Bittiya Sanstha Ltd.,14,763,694,763,645,486715,694,69,2017-03-22
Civil Laghubitta Bittiya Sanstha Ltd.,50,839,763,839,4729,3856607,763,76,2017-03-23
Civil Laghubitta Bittiya Sanstha Ltd.,30,922,855,915,1635,1494340,839,76,2017-03-26
Civil Laghubitta Bittiya Sanstha Ltd.,13,991,930,991,803,754320,915,76,2017-03-28
Civil Laghubitta Bittiya Sanstha Ltd.,32,1010,921,921,2125,2012300,991,-70,2017-03-29
Civil Laghubitta Bittiya Sanstha Ltd.,40,950,885,913,4790,4451839,921,-8,2017-03-30
Civil Laghubitta Bittiya Sanstha Ltd.,5,1002,931,1002,80,77615,913,89,2017-04-02
Civil Laghubitta Bittiya Sanstha Ltd.,50,1042,951,1025,4810,4891890,1002,23,2017-04-03
Civil Laghubitta Bittiya Sanstha Ltd.,79,1050,987,1000,4717,4810545,1025,-25,2017-04-04
Civil Laghubitta Bittiya Sanstha Ltd.,61,1040,1000,1002,1835,1862670,1000,2,2017-04-06
Civil Laghubitta Bittiya Sanstha Ltd.,7,985,972,974,875,855015,1002,-28,2017-04-09
Civil Laghubitta Bittiya Sanstha Ltd.,41,1071,970,1071,2425,2563925,974,97,2017-04-10
Civil Laghubitta Bittiya Sanstha Ltd.,63,1178,1092,1178,2766,3195893,1071,107,2017-04-11
Civil Laghubitta Bittiya Sanstha Ltd.,78,1295,1178,1270,4811,6187765,1178,92,2017-04-12
Civil Laghubitta Bittiya Sanstha Ltd.,85,1352,1224,1325,6190,8039970,1270,55,2017-04-13
Civil Laghubitta Bittiya Sanstha Ltd.,53,1351,1215,1239,3015,3849430,1325,-86,2017-04-16
Civil Laghubitta Bittiya Sanstha Ltd.,38,1225,1123,1177,1986,2308513,1239,-62,2017-04-18
Civil Laghubitta Bittiya Sanstha Ltd.,61,1294,1157,1294,3571,4433603,1177,117,2017-04-19
Civil Laghubitta Bittiya Sanstha Ltd.,87,1395,1315,1360,6160,8315567,1294,66,2017-04-20
Civil Laghubitta Bittiya Sanstha Ltd.,32,1405,1334,1345,3375,4662865,1360,-15,2017-04-23
Civil Laghubitta Bittiya Sanstha Ltd.,43,1370,1297,1345,2545,3373795,1345,0,2017-04-24
Civil Laghubitta Bittiya Sanstha Ltd.,43,1350,1300,1311,3704,4907252,1345,-34,2017-04-25
Civil Laghubitta Bittiya Sanstha Ltd.,63,1398,1306,1397,3608,4856668,1311,86,2017-04-26
Civil Laghubitta Bittiya Sanstha Ltd.,34,1400,1348,1362,1405,1932355,1397,-35,2017-04-27
Civil Laghubitta Bittiya Sanstha Ltd.,32,1370,1309,1360,2348,3167146,1362,-2,2017-04-30
Civil Laghubitta Bittiya Sanstha Ltd.,67,1407,1333,1407,3450,4719290,1360,47,2017-05-02
Civil Laghubitta Bittiya Sanstha Ltd.,91,1448,1370,1405,4262,6029405,1407,-2,2017-05-03
Civil Laghubitta Bittiya Sanstha Ltd.,65,1425,1378,1400,3292,4606205,1405,-5,2017-05-04
Civil Laghubitta Bittiya Sanstha Ltd.,48,1390,1345,1375,1800,2457720,1400,-25,2017-05-07
Civil Laghubitta Bittiya Sanstha Ltd.,23,1402,1360,1395,385,530720,1375,20,2017-05-08
Civil Laghubitta Bittiya Sanstha Ltd.,1,1368,1368,1368,10,13680,1395,-27,2017-05-09
Civil Laghubitta Bittiya Sanstha Ltd.,14,1395,1350,1350,720,979660,1368,-18,2017-05-11
Civil Laghubitta Bittiya Sanstha Ltd.,6,1387,1360,1380,105,144265,1350,30,2017-05-15
Civil Laghubitta Bittiya Sanstha Ltd.,25,1383,1353,1364,1292,1772275,1380,-16,2017-05-16
Civil Laghubitta Bittiya Sanstha Ltd.,10,1368,1363,1365,205,279805,1364,1,2017-05-17
Civil Laghubitta Bittiya Sanstha Ltd.,19,1365,1330,1357,1395,1872065,1365,-8,2017-05-18
Civil Laghubitta Bittiya Sanstha Ltd.,16,1357,1330,1335,1295,1739570,1357,-22,2017-05-21
Civil Laghubitta Bittiya Sanstha Ltd.,14,1347,1311,1347,1246,1648031,1335,12,2017-05-22
Civil Laghubitta Bittiya Sanstha Ltd.,10,1373,1303,1346,200,265860,1347,-1,2017-05-23
Civil Laghubitta Bittiya Sanstha Ltd.,9,1346,1320,1343,1197,1590857,1346,-3,2017-05-24
Civil Laghubitta Bittiya Sanstha Ltd.,19,1350,1280,1305,1147,1485102,1343,-38,2017-05-28
Civil Laghubitta Bittiya Sanstha Ltd.,24,1300,1279,1299,830,1071620,1305,-6,2017-05-30
Civil Laghubitta Bittiya Sanstha Ltd.,5,1350,1299,1350,330,434290,1299,51,2017-05-31
Civil Laghubitta Bittiya Sanstha Ltd.,5,1340,1300,1300,200,262800,1350,-50,2017-06-01
Civil Laghubitta Bittiya Sanstha Ltd.,1,1300,1300,1300,10,13000,1300,0,2017-06-04
Civil Laghubitta Bittiya Sanstha Ltd.,28,1314,1201,1314,605,782790,1300,14,2017-06-05
Civil Laghubitta Bittiya Sanstha Ltd.,31,1364,1304,1364,1302,1754225,1314,50,2017-06-06
Civil Laghubitta Bittiya Sanstha Ltd.,22,1390,1323,1323,580,778025,1364,-41,2017-06-07
Civil Laghubitta Bittiya Sanstha Ltd.,35,1377,1297,1350,1795,2438892,1323,27,2017-06-08
Civil Laghubitta Bittiya Sanstha Ltd.,25,1358,1301,1309,1194,1570562,1350,-41,2017-06-11
Civil Laghubitta Bittiya Sanstha Ltd.,20,1327,1270,1300,1272,1672845,1309,-9,2017-06-12
Civil Laghubitta Bittiya Sanstha Ltd.,23,1336,1275,1290,306,396850,1300,-10,2017-06-13
Civil Laghubitta Bittiya Sanstha Ltd.,21,1320,1290,1300,998,1295495,1290,10,2017-06-14
Civil Laghubitta Bittiya Sanstha Ltd.,15,1339,1295,1320,328,433244,1300,20,2017-06-15
Civil Laghubitta Bittiya Sanstha Ltd.,5,1346,1295,1320,228,300195,1320,0,2017-06-18
Civil Laghubitta Bittiya Sanstha Ltd.,11,1315,1290,1315,356,460586,1320,-5,2017-06-19
Civil Laghubitta Bittiya Sanstha Ltd.,13,1325,1298,1298,569,751335,1315,-17,2017-06-20
Civil Laghubitta Bittiya Sanstha Ltd.,2,1273,1252,1252,25,31615,1298,-46,2017-06-21
Civil Laghubitta Bittiya Sanstha Ltd.,6,1302,1255,1302,155,195700,1252,50,2017-06-22
Civil Laghubitta Bittiya Sanstha Ltd.,17,1328,1295,1295,597,777040,1302,-7,2017-06-25
Civil Laghubitta Bittiya Sanstha Ltd.,10,1308,1273,1308,273,353470,1295,13,2017-06-27
Civil Laghubitta Bittiya Sanstha Ltd.,14,1320,1300,1318,420,549865,1308,10,2017-06-28
Civil Laghubitta Bittiya Sanstha Ltd.,5,1292,1292,1292,50,64600,1318,-26,2017-07-02
Civil Laghubitta Bittiya Sanstha Ltd.,13,1315,1290,1300,372,482830,1292,8,2017-07-03
Civil Laghubitta Bittiya Sanstha Ltd.,15,1340,1276,1340,761,998082,1300,40,2017-07-05
Civil Laghubitta Bittiya Sanstha Ltd.,20,1393,1320,1349,859,1162782,1340,9,2017-07-06
Civil Laghubitta Bittiya Sanstha Ltd.,38,1390,1250,1304,2452,3224094,1349,-45,2017-07-09
Civil Laghubitta Bittiya Sanstha Ltd.,21,1326,1259,1284,1255,1630535,1304,-20,2017-07-10
Civil Laghubitta Bittiya Sanstha Ltd.,16,1309,1280,1305,979,1263867,1284,21,2017-07-11
Civil Laghubitta Bittiya Sanstha Ltd.,14,1315,1286,1315,510,664859,1305,10,2017-07-12
Civil Laghubitta Bittiya Sanstha Ltd.,14,1310,1289,1302,210,273210,1315,-13,2017-07-13
Civil Laghubitta Bittiya Sanstha Ltd.,16,1325,1271,1271,235,305247,1302,-31,2017-07-16
Civil Laghubitta Bittiya Sanstha Ltd.,25,1310,1260,1291,822,1070638,1271,20,2017-07-17
Civil Laghubitta Bittiya Sanstha Ltd.,22,1326,1300,1305,619,813807,1291,14,2017-07-18
Civil Laghubitta Bittiya Sanstha Ltd.,31,1400,1365,1365,948,1304363,1400,-35,2017-08-03
Civil Laghubitta Bittiya Sanstha Ltd.,7,1325,1300,1320,775,1019310,1305,15,2017-07-19
Civil Laghubitta Bittiya Sanstha Ltd.,15,1310,1271,1300,1149,1469907,1320,-20,2017-07-20
Civil Laghubitta Bittiya Sanstha Ltd.,45,1331,1280,1280,1667,2161975,1330,-50,2017-07-24
Civil Laghubitta Bittiya Sanstha Ltd.,8,1295,1271,1273,415,536050,1280,-7,2017-07-25
Civil Laghubitta Bittiya Sanstha Ltd.,84,1362,1265,1362,4058,5416100,1273,89,2017-07-26
Civil Laghubitta Bittiya Sanstha Ltd.,27,1389,1324,1345,736,995423,1362,-17,2017-07-27
Civil Laghubitta Bittiya Sanstha Ltd.,15,1325,1320,1321,247,326612,1345,-24,2017-07-30
Civil Laghubitta Bittiya Sanstha Ltd.,40,1377,1331,1350,2049,2765792,1321,29,2017-07-31
Civil Laghubitta Bittiya Sanstha Ltd.,62,1410,1349,1401,4972,6864242,1350,51,2017-08-01
Civil Laghubitta Bittiya Sanstha Ltd.,53,1414,1351,1400,3071,4275481,1401,-1,2017-08-02
Civil Laghubitta Bittiya Sanstha Ltd.,23,1380,1360,1370,836,1142196,1390,-20,2017-08-07
Civil Laghubitta Bittiya Sanstha Ltd.,28,1382,1353,1353,1992,2726146,1370,-17,2017-08-09
Civil Laghubitta Bittiya Sanstha Ltd.,70,1330,1278,1318,4061,5345796,1344,-26,2017-08-15
Civil Laghubitta Bittiya Sanstha Ltd.,36,1330,1290,1319,2219,2924550,1318,1,2017-08-16
Civil Laghubitta Bittiya Sanstha Ltd.,22,1319,1307,1319,1505,1972186,1319,0,2017-08-17
Civil Laghubitta Bittiya Sanstha Ltd.,22,1300,1280,1300,335,434500,1321,-21,2017-08-21
Civil Laghubitta Bittiya Sanstha Ltd.,6,1325,1300,1325,181,235700,1300,25,2017-08-22
Civil Laghubitta Bittiya Sanstha Ltd.,27,1320,1281,1288,1692,2195499,1325,-37,2017-08-23
Civil Laghubitta Bittiya Sanstha Ltd.,7,1319,1300,1319,596,778830,1307,12,2017-08-28
Civil Laghubitta Bittiya Sanstha Ltd.,36,1316,1290,1292,1808,2365250,1319,-27,2017-08-30
Civil Laghubitta Bittiya Sanstha Ltd.,10,1304,1253,1253,678,851674,1330,-77,2017-09-10
Civil Laghubitta Bittiya Sanstha Ltd.,19,1326,1252,1319,556,711910,1253,66,2017-09-11
Civil Laghubitta Bittiya Sanstha Ltd.,4,1295,1270,1295,320,406880,1319,-24,2017-09-12
Civil Laghubitta Bittiya Sanstha Ltd.,1,1245,1245,1245,15,18675,1265,-20,2017-10-09
Civil Laghubitta Bittiya Sanstha Ltd.,12,1269,1203,1203,120,147760,1245,-42,2017-10-10
Civil Laghubitta Bittiya Sanstha Ltd.,9,1220,1185,1196,227,272040,1200,-4,2017-10-12
Civil Laghubitta Bittiya Sanstha Ltd.,5,1295,1265,1295,65,82785,1248,47,2017-10-17
Civil Laghubitta Bittiya Sanstha Ltd.,1,0,0,0,5,6350,1295,-1295,2017-10-23
Civil Laghubitta Bittiya Sanstha Ltd.,15,1215,1177,1200,3454,4143480,1210,-10,2017-11-01
Civil Laghubitta Bittiya Sanstha Ltd.,11,1200,1155,1155,640,762240,1200,-45,2017-11-02
Civil Laghubitta Bittiya Sanstha Ltd.,10,1060,1039,1039,250,261350,1070,-31,2017-11-07
Civil Laghubitta Bittiya Sanstha Ltd.,3,1000,990,1000,40,39700,1010,-10,2017-11-09
Civil Laghubitta Bittiya Sanstha Ltd.,2,1020,1020,1020,30,30600,1000,20,2017-11-13
Civil Laghubitta Bittiya Sanstha Ltd.,12,1106,1045,1045,984,1054744,1092,-47,2017-11-15
Civil Laghubitta Bittiya Sanstha Ltd.,2,1045,1045,1045,20,20900,1025,20,2017-11-19
Civil Laghubitta Bittiya Sanstha Ltd.,2,1050,1049,1049,20,20990,1070,-21,2017-11-30
Civil Laghubitta Bittiya Sanstha Ltd.,19,1039,981,1000,240,239150,1019,-19,2017-12-20
Civil Laghubitta Bittiya Sanstha Ltd.,2,1020,1019,1020,20,20390,1039,-19,2017-12-12
Civil Laghubitta Bittiya Sanstha Ltd.,18,945,907,908,283,259780,946,-38,2017-12-27
Civil Laghubitta Bittiya Sanstha Ltd.,1,926,926,926,10,9260,944,-18,2017-12-31
Civil Laghubitta Bittiya Sanstha Ltd.,4,962,944,962,90,86120,926,36,2018-01-01
Civil Laghubitta Bittiya Sanstha Ltd.,10,940,900,900,606,549300,928,-28,2018-01-08
Civil Laghubitta Bittiya Sanstha Ltd.,7,905,900,901,756,681056,901,0,2018-01-10
Civil Laghubitta Bittiya Sanstha Ltd.,32,899,871,881,320,282310,901,-20,2018-01-14
Civil Laghubitta Bittiya Sanstha Ltd.,8,870,854,862,320,277830,870,-8,2018-01-17
Civil Laghubitta Bittiya Sanstha Ltd.,7,850,832,850,77,64580,848,2,2018-01-23
Civil Laghubitta Bittiya Sanstha Ltd.,19,835,811,835,366,302020,826,9,2018-01-29
Civil Laghubitta Bittiya Sanstha Ltd.,6,847,830,837,60,50290,835,2,2018-01-31
Civil Laghubitta Bittiya Sanstha Ltd.,13,843,830,830,760,635550,837,-7,2018-02-01
Civil Laghubitta Bittiya Sanstha Ltd.,13,824,806,806,395,321545,825,-19,2018-02-05
Civil Laghubitta Bittiya Sanstha Ltd.,3,820,812,820,35,28515,828,-8,2018-02-08
Civil Laghubitta Bittiya Sanstha Ltd.,10,810,800,806,105,84310,816,-10,2018-02-25
Civil Laghubitta Bittiya Sanstha Ltd.,5,815,809,815,230,187040,825,-10,2018-02-12
Civil Laghubitta Bittiya Sanstha Ltd.,5,816,800,800,145,116460,815,-15,2018-02-14
Civil Laghubitta Bittiya Sanstha Ltd.,3,800,790,800,30,23890,801,-1,2018-02-21
Civil Laghubitta Bittiya Sanstha Ltd.,9,832,816,816,180,148250,800,16,2018-02-22
Civil Laghubitta Bittiya Sanstha Ltd.,3,795,790,790,95,75175,806,-16,2018-02-26
Civil Laghubitta Bittiya Sanstha Ltd.,2,790,780,790,60,47300,790,0,2018-02-27
Civil Laghubitta Bittiya Sanstha Ltd.,1,770,770,770,50,38500,785,-15,2018-03-04
Civil Laghubitta Bittiya Sanstha Ltd.,7,756,727,741,217,160859,770,-29,2018-03-05
Civil Laghubitta Bittiya Sanstha Ltd.,2,755,740,740,60,45150,741,-1,2018-03-06
Civil Laghubitta Bittiya Sanstha Ltd.,5,713,712,713,43,30646,726,-13,2018-03-12
Civil Laghubitta Bittiya Sanstha Ltd.,3,721,702,721,35,24835,713,8,2018-03-13
Civil Laghubitta Bittiya Sanstha Ltd.,11,725,695,695,615,437269,721,-26,2018-03-15
Civil Laghubitta Bittiya Sanstha Ltd.,2,708,708,708,110,77880,695,13,2018-03-18
Civil Laghubitta Bittiya Sanstha Ltd.,2,700,695,695,25,17425,708,-13,2018-03-19
Civil Laghubitta Bittiya Sanstha Ltd.,6,682,669,669,250,168355,695,-26,2018-03-21
Civil Laghubitta Bittiya Sanstha Ltd.,9,660,643,660,350,228700,669,-9,2018-03-22
Civil Laghubitta Bittiya Sanstha Ltd.,5,647,623,623,120,75990,660,-37,2018-03-26
Civil Laghubitta Bittiya Sanstha Ltd.,11,670,637,649,498,323909,625,24,2018-03-28
Civil Laghubitta Bittiya Sanstha Ltd.,3,661,648,648,40,26145,649,-1,2018-04-03
Civil Laghubitta Bittiya Sanstha Ltd.,1,660,660,660,10,6600,648,12,2018-04-04
Civil Laghubitta Bittiya Sanstha Ltd.,7,695,689,689,325,224615,702,-13,2018-04-10
Civil Laghubitta Bittiya Sanstha Ltd.,4,710,680,710,194,136542,689,21,2018-04-11
Civil Laghubitta Bittiya Sanstha Ltd.,8,738,724,724,290,210220,710,14,2018-04-12
Civil Laghubitta Bittiya Sanstha Ltd.,2,740,730,740,20,14700,724,16,2018-04-15
Civil Laghubitta Bittiya Sanstha Ltd.,11,848,816,816,545,451540,800,16,2018-04-17
Civil Laghubitta Bittiya Sanstha Ltd.,3,890,873,873,40,35090,891,-18,2018-04-25
Civil Laghubitta Bittiya Sanstha Ltd.,7,788,759,770,508,388795,804,-34,2018-05-02
Civil Laghubitta Bittiya Sanstha Ltd.,23,805,780,785,389,307581,805,-20,2018-05-07
Civil Laghubitta Bittiya Sanstha Ltd.,12,816,770,816,296,234010,785,31,2018-05-08
Civil Laghubitta Bittiya Sanstha Ltd.,11,829,808,808,196,160474,816,-8,2018-05-09
Civil Laghubitta Bittiya Sanstha Ltd.,26,805,777,795,673,530897,808,-13,2018-05-10
Civil Laghubitta Bittiya Sanstha Ltd.,1,790,790,790,33,26070,784,6,2018-05-15
Civil Laghubitta Bittiya Sanstha Ltd.,5,810,805,805,50,40300,805,0,2018-05-20
Civil Laghubitta Bittiya Sanstha Ltd.,10,815,790,815,436,348670,805,10,2018-05-21
Civil Laghubitta Bittiya Sanstha Ltd.,3,830,815,815,223,183925,815,0,2018-05-22
Corporate Development Bank Limited,6,145,141,141,480,68200,147,-6,2018-04-01
Corporate Development Bank Limited,1,139,139,139,40,5560,141,-2,2018-04-02
Corporate Development Bank Limited,2,139,137,137,120,16640,139,-2,2018-04-03
Corporate Development Bank Limited,17,119,116,117,1940,226875,120,-3,2018-04-10
Corporate Development Bank Limited,12,119,116,119,580,68580,117,2,2018-04-11
Corporate Development Bank Limited,20,126,116,126,990,120120,118,8,2018-04-15
Corporate Development Bank Limited,7,127,124,126,1095,138445,125,1,2018-04-17
Corporate Development Bank Limited,1,116,116,116,260,30160,118,-2,2018-05-15
Corporate Development Bank Limited,4,116,114,114,340,39280,116,-2,2018-05-20
Corporate Development Bank Limited,1,112,112,112,40,4480,114,-2,2018-05-21
Corporate Development Bank Ltd. Promoter Share,19,100,100,100,8800,880000,0,100,2017-06-15
Cosmos Development Bank Ltd.,2,514,514,514,186,95604,514,0,2016-05-23
Cosmos Development Bank Ltd.,1,520,520,520,16,8320,514,6,2016-05-24
Cosmos Development Bank Ltd.,4,510,490,499,1700,850700,520,-21,2016-05-25
Cosmos Development Bank Ltd.,6,510,490,510,494,247011,499,11,2016-05-26
Cosmos Development Bank Ltd.,3,500,500,500,600,300000,510,-10,2016-05-29
Cosmos Development Bank Ltd.,10,540,500,520,600,305970,500,20,2016-05-30
Cosmos Development Bank Ltd.,6,510,495,504,2434,1218180,520,-16,2016-05-31
Cosmos Development Bank Ltd.,8,535,514,530,1459,771697,504,26,2016-06-01
Cosmos Development Bank Ltd.,7,530,515,515,1832,952760,530,-15,2016-06-02
Cosmos Development Bank Ltd.,11,505,500,500,807,406435,515,-15,2016-06-05
Cosmos Development Bank Ltd.,23,520,500,500,1734,875160,500,0,2016-06-06
Cosmos Development Bank Ltd.,8,538,503,530,736,386531,500,30,2016-06-07
Cosmos Development Bank Ltd.,10,550,540,545,1055,575960,530,15,2016-06-08
Cosmos Development Bank Ltd.,8,566,545,566,772,426913,545,21,2016-06-09
Cosmos Development Bank Ltd.,3,587,577,580,80,46410,566,14,2016-06-12
Cosmos Development Bank Ltd.,2,591,585,591,34,19950,580,11,2016-06-13
Cosmos Development Bank Ltd.,1,600,600,600,11,6600,591,9,2016-06-14
Cosmos Development Bank Ltd.,5,630,610,610,740,457780,600,10,2016-06-15
Cosmos Development Bank Ltd.,1,600,600,600,100,60000,610,-10,2016-06-16
Cosmos Development Bank Ltd.,1,600,600,600,258,154800,600,0,2016-06-19
Cosmos Development Bank Ltd.,2,600,595,595,119,70985,600,-5,2016-06-20
Cosmos Development Bank Ltd.,3,600,595,595,237,141700,595,0,2016-06-21
Cosmos Development Bank Ltd.,3,610,600,610,218,131580,595,15,2016-06-22
Cosmos Development Bank Ltd.,15,646,610,646,1094,680324,610,36,2016-06-26
Cosmos Development Bank Ltd.,15,681,634,634,1655,1086201,646,-12,2016-06-27
Cosmos Development Bank Ltd.,19,637,606,606,2220,1388729,634,-28,2016-06-28
Cosmos Development Bank Ltd.,6,620,608,610,647,396588,606,4,2016-06-29
Cosmos Development Bank Ltd.,2,600,598,600,744,445820,610,-10,2016-06-30
Cosmos Development Bank Ltd.,7,636,600,635,588,369942,600,35,2016-07-03
Cosmos Development Bank Ltd.,5,647,630,635,561,356740,635,0,2016-07-04
Cosmos Development Bank Ltd.,18,647,625,647,4958,3145071,635,12,2016-07-05
Cosmos Development Bank Ltd.,2,635,623,623,148,93092,647,-24,2016-07-06
Cosmos Development Bank Ltd.,23,685,635,685,2175,1475305,623,62,2016-07-10
Cosmos Development Bank Ltd.,48,739,686,719,7490,5345797,685,34,2016-07-11
Cosmos Development Bank Ltd.,37,740,710,724,6441,4690411,719,5,2016-07-12
Cosmos Development Bank Ltd.,23,735,705,720,2357,1685198,724,-4,2016-07-13
Cosmos Development Bank Ltd.,37,734,710,730,3923,2849132,720,10,2016-07-14
Cosmos Development Bank Ltd.,57,765,725,746,7874,5838662,730,16,2016-07-17
Cosmos Development Bank Ltd.,8,465,431,465,1212,554665,423,42,2016-07-18
Cosmos Development Bank Ltd.,4,493,474,493,169,80570,465,28,2016-07-19
Cosmos Development Bank Ltd.,14,510,495,500,2217,1117425,493,7,2016-07-20
Cosmos Development Bank Ltd.,11,520,500,520,1771,897542,500,20,2016-07-21
Cosmos Development Bank Ltd.,6,525,520,525,854,446142,520,5,2016-07-25
Cosmos Development Bank Ltd.,5,535,525,535,525,279375,525,10,2016-07-27
Cosmos Development Bank Ltd.,1,525,525,525,17,8925,535,-10,2016-07-28
Cosmos Development Bank Ltd.,4,515,510,510,250,128250,525,-15,2016-07-31
Cosmos Development Bank Ltd.,3,426,426,426,450,191700,434,-8,2016-08-31
Cosmos Development Bank Ltd.,6,500,459,459,240,114740,510,-51,2016-08-24
Cosmos Development Bank Ltd.,2,450,442,442,180,79640,459,-17,2016-08-28
Cosmos Development Bank Ltd.,1,434,434,434,10,4340,442,-8,2016-08-29
Cosmos Development Bank Ltd.,9,420,412,415,599,249270,426,-11,2016-09-01
Cosmos Development Bank Ltd.,9,438,415,438,1019,434800,415,23,2016-09-04
Cosmos Development Bank Ltd.,8,480,445,480,1017,468741,438,42,2016-09-05
Cosmos Development Bank Ltd.,7,509,480,509,1431,709918,480,29,2016-09-06
Cosmos Development Bank Ltd.,2,518,508,508,200,102600,509,-1,2016-09-07
Cosmos Development Bank Ltd.,11,500,485,494,1533,756604,508,-14,2016-09-08
Cosmos Development Bank Ltd.,3,503,503,503,418,210254,494,9,2016-09-11
Cosmos Development Bank Ltd.,3,495,486,488,508,247081,503,-15,2016-09-12
Cosmos Development Bank Ltd.,3,489,480,489,122,59460,488,1,2016-09-14
Cosmos Development Bank Ltd.,2,480,471,471,116,54780,489,-18,2016-09-18
Cosmos Development Bank Ltd.,1,463,463,463,11,5093,471,-8,2016-09-20
Cosmos Development Bank Ltd.,2,457,455,457,110,50070,463,-6,2016-09-22
Cosmos Development Bank Ltd.,1,455,455,455,100,45500,457,-2,2016-09-26
Cosmos Development Bank Ltd.,4,446,435,435,414,181504,455,-20,2016-09-27
Cosmos Development Bank Ltd.,6,435,427,435,1206,518734,435,0,2016-09-29
Cosmos Development Bank Ltd.,10,478,443,478,1097,520455,435,43,2016-10-06
Cosmos Development Bank Ltd.,1,478,478,478,100,47800,478,0,2016-10-20
Cosmos Development Bank Ltd.,7,487,478,487,1477,710328,478,9,2016-10-23
Cosmos Development Bank Ltd.,3,478,469,469,419,197944,487,-18,2016-10-25
Cosmos Development Bank Ltd.,1,470,470,470,14,6580,469,1,2016-11-03
Cosmos Development Bank Ltd.,1,462,462,462,21,9702,470,-8,2016-11-08
Cosmos Development Bank Ltd.,1,460,460,460,250,115000,462,-2,2016-11-15
Cosmos Development Bank Ltd.,2,451,445,445,30,13410,460,-15,2016-11-20
Cosmos Development Bank Ltd.,1,444,444,444,220,97680,445,-1,2016-12-20
Cosmos Development Bank Ltd.,4,436,428,428,520,222720,444,-16,2016-12-27
Country Development Bank Ltd.,8,229,225,229,1746,397262,225,4,2016-05-23
Country Development Bank Ltd.,19,233,226,232,5286,1211296,229,3,2016-05-24
Country Development Bank Ltd.,18,232,226,231,7383,1685186,232,-1,2016-05-25
Country Development Bank Ltd.,11,232,226,232,1795,411236,231,1,2016-05-26
Country Development Bank Ltd.,1,229,229,229,52,11908,232,-3,2016-05-29
Country Development Bank Ltd.,14,229,221,229,3782,847689,229,0,2016-05-30
Country Development Bank Ltd.,11,229,225,225,4333,982415,229,-4,2016-05-31
Country Development Bank Ltd.,7,229,217,229,2812,623108,225,4,2016-06-01
Country Development Bank Ltd.,9,225,217,222,1327,297504,229,-7,2016-06-02
Country Development Bank Ltd.,14,220,211,214,1909,410706,222,-8,2016-06-05
Country Development Bank Ltd.,42,235,217,235,17633,4050986,214,21,2016-06-06
Deprosc Laghubitta Bittiya Sanstha Limited,44,2999,2870,2981,5930,17327690,2830,151,2016-05-24
Deprosc Laghubitta Bittiya Sanstha Limited,32,2980,2925,2969,3790,11223980,2981,-12,2016-05-25
Deprosc Laghubitta Bittiya Sanstha Limited,20,2970,2862,2901,1081,3163270,2969,-68,2016-05-26
Deprosc Laghubitta Bittiya Sanstha Limited,26,2930,2900,2905,3570,10388684,2901,4,2016-05-29
Deprosc Laghubitta Bittiya Sanstha Limited,17,2900,2881,2881,1593,4598610,2905,-24,2016-05-30
Deprosc Laghubitta Bittiya Sanstha Limited,13,2925,2881,2881,2406,6961600,2881,0,2016-05-31
Deprosc Laghubitta Bittiya Sanstha Limited,23,2870,2793,2855,5135,14514034,2881,-26,2016-06-01
Deprosc Laghubitta Bittiya Sanstha Limited,24,2850,2800,2850,5545,15630215,2855,-5,2016-06-02
Deprosc Laghubitta Bittiya Sanstha Limited,11,2870,2815,2845,1673,4734210,2815,30,2016-06-07
Deprosc Laghubitta Bittiya Sanstha Limited,14,3350,3300,3309,2152,7166200,3270,39,2016-06-23
Deprosc Laghubitta Bittiya Sanstha Limited,30,2958,2850,2900,8183,23642110,2845,55,2016-06-08
Deprosc Laghubitta Bittiya Sanstha Limited,26,2999,2910,2968,4936,14617056,2900,68,2016-06-09
Deprosc Laghubitta Bittiya Sanstha Limited,129,3200,3027,3190,16885,53602924,2968,222,2016-06-12
Deprosc Laghubitta Bittiya Sanstha Limited,127,3417,3250,3325,15507,51087053,3190,135,2016-06-13
Deprosc Laghubitta Bittiya Sanstha Limited,68,3400,3280,3300,9176,30410122,3325,-25,2016-06-14
Deprosc Laghubitta Bittiya Sanstha Limited,42,3310,3252,3274,4278,13999820,3300,-26,2016-06-15
Deprosc Laghubitta Bittiya Sanstha Limited,71,3400,3274,3356,9964,33435765,3274,82,2016-06-16
Deprosc Laghubitta Bittiya Sanstha Limited,21,3340,3295,3311,2673,8832330,3356,-45,2016-06-19
Deprosc Laghubitta Bittiya Sanstha Limited,3,3290,3260,3260,600,1957500,3311,-51,2016-06-21
Deprosc Laghubitta Bittiya Sanstha Limited,9,3366,3270,3270,775,2555320,3260,10,2016-06-22
Deprosc Laghubitta Bittiya Sanstha Limited,23,3309,3260,3263,4092,13388790,3309,-46,2016-06-26
Deprosc Laghubitta Bittiya Sanstha Limited,10,3263,3210,3210,1945,6306150,3263,-53,2016-06-27
Deprosc Laghubitta Bittiya Sanstha Limited,11,3339,3273,3273,1044,3430646,3210,63,2016-06-28
Deprosc Laghubitta Bittiya Sanstha Limited,14,3337,3281,3300,1988,6568170,3273,27,2016-06-29
Deprosc Laghubitta Bittiya Sanstha Limited,16,3320,3280,3300,1997,6570885,3300,0,2016-06-30
Deprosc Laghubitta Bittiya Sanstha Limited,95,3580,3250,3580,19412,65536288,3300,280,2016-07-03
Deprosc Laghubitta Bittiya Sanstha Limited,48,3700,3380,3380,5148,18433630,3580,-200,2016-07-04
Deprosc Laghubitta Bittiya Sanstha Limited,33,3460,3320,3400,5295,17845960,3380,20,2016-07-05
Deprosc Laghubitta Bittiya Sanstha Limited,29,3500,3400,3450,7680,26559415,3400,50,2016-07-06
Deprosc Laghubitta Bittiya Sanstha Limited,24,3500,3400,3400,4286,14738350,3450,-50,2016-07-10
Deprosc Laghubitta Bittiya Sanstha Limited,16,3400,3305,3305,1901,6383670,3400,-95,2016-07-11
Deprosc Laghubitta Bittiya Sanstha Limited,6,3300,3250,3285,628,2050750,3305,-20,2016-07-12
Deprosc Laghubitta Bittiya Sanstha Limited,7,3350,3290,3350,775,2567675,3285,65,2016-07-13
Deprosc Laghubitta Bittiya Sanstha Limited,28,3440,3300,3320,5460,18337360,3350,-30,2016-07-14
Deprosc Laghubitta Bittiya Sanstha Limited,25,3254,2988,2988,2432,7320100,3320,-332,2016-07-17
Deprosc Laghubitta Bittiya Sanstha Limited,68,2975,2815,2901,9595,27961563,2988,-87,2016-07-18
Deprosc Laghubitta Bittiya Sanstha Limited,29,2966,2880,2930,6987,20281369,2901,29,2016-07-19
Deprosc Laghubitta Bittiya Sanstha Limited,43,2930,2877,2880,6848,19744723,2930,-50,2016-07-20
Deprosc Laghubitta Bittiya Sanstha Limited,24,2998,2823,2951,2454,7173327,2880,71,2016-07-21
Deprosc Laghubitta Bittiya Sanstha Limited,22,3070,2980,3025,2725,8204684,2951,74,2016-07-25
Deprosc Laghubitta Bittiya Sanstha Limited,20,3150,3030,3120,2471,7618335,3025,95,2016-07-26
Deprosc Laghubitta Bittiya Sanstha Limited,15,3380,3178,3178,1119,3650411,3120,58,2016-07-27
Deprosc Laghubitta Bittiya Sanstha Limited,12,3241,3125,3177,2391,7537250,3178,-1,2016-07-28
Deprosc Laghubitta Bittiya Sanstha Limited,20,3220,3171,3180,3214,10259636,3177,3,2016-07-31
Deprosc Laghubitta Bittiya Sanstha Limited,9,3180,3120,3150,577,1812800,3180,-30,2016-08-01
Deprosc Laghubitta Bittiya Sanstha Limited,4,3150,3125,3140,579,1818375,3150,-10,2016-08-02
Deprosc Laghubitta Bittiya Sanstha Limited,18,3140,3050,3080,2283,7061160,3140,-60,2016-08-03
Deprosc Laghubitta Bittiya Sanstha Limited,20,3080,3001,3001,1782,5408244,3080,-79,2016-08-04
Deprosc Laghubitta Bittiya Sanstha Limited,14,3122,2951,2952,970,2933475,3001,-49,2016-08-07
Deprosc Laghubitta Bittiya Sanstha Limited,12,2900,2855,2855,947,2715847,2952,-97,2016-08-08
Deprosc Laghubitta Bittiya Sanstha Limited,15,3105,2912,3000,1300,3946790,2855,145,2016-08-10
Deprosc Laghubitta Bittiya Sanstha Limited,8,3060,2999,3060,480,1455380,3000,60,2016-08-11
Deprosc Laghubitta Bittiya Sanstha Limited,6,3050,2960,2960,472,1416000,3060,-100,2016-08-14
Deprosc Laghubitta Bittiya Sanstha Limited,19,2990,2850,2885,3095,8999025,2960,-75,2016-08-15
Deprosc Laghubitta Bittiya Sanstha Limited,8,3100,3050,3095,630,1938000,3025,70,2016-08-31
Deprosc Laghubitta Bittiya Sanstha Limited,7,2988,2929,2929,880,2596670,2885,44,2016-08-16
Deprosc Laghubitta Bittiya Sanstha Limited,12,2970,2945,2950,1900,5618130,2929,21,2016-08-17
Deprosc Laghubitta Bittiya Sanstha Limited,7,2980,2950,2950,750,2224500,2950,0,2016-08-21
Deprosc Laghubitta Bittiya Sanstha Limited,10,2950,2790,2790,1297,3691550,2950,-160,2016-08-22
Deprosc Laghubitta Bittiya Sanstha Limited,10,2830,2780,2820,1073,3017645,2790,30,2016-08-23
Deprosc Laghubitta Bittiya Sanstha Limited,10,2991,2827,2974,1557,4454410,2820,154,2016-08-24
Deprosc Laghubitta Bittiya Sanstha Limited,9,3000,2970,2970,879,2623775,2974,-4,2016-08-28
Deprosc Laghubitta Bittiya Sanstha Limited,10,3024,2935,3024,789,2337985,2970,54,2016-08-29
Deprosc Laghubitta Bittiya Sanstha Limited,15,3030,2976,3025,1299,3898060,3024,1,2016-08-30
Deprosc Laghubitta Bittiya Sanstha Limited,6,3125,3085,3085,790,2446850,3095,-10,2016-09-01
Deprosc Laghubitta Bittiya Sanstha Limited,8,3202,3100,3202,500,1562980,3085,117,2016-09-04
Deprosc Laghubitta Bittiya Sanstha Limited,12,3220,3175,3175,1152,3680885,3202,-27,2016-09-05
Deprosc Laghubitta Bittiya Sanstha Limited,7,3170,3055,3110,657,2041670,3175,-65,2016-09-06
Deprosc Laghubitta Bittiya Sanstha Limited,7,3100,3050,3100,540,1660600,3110,-10,2016-09-07
Deprosc Laghubitta Bittiya Sanstha Limited,6,3125,3100,3120,453,1412860,3100,20,2016-09-08
Deprosc Laghubitta Bittiya Sanstha Limited,2,3150,3130,3130,130,407500,3120,10,2016-09-11
Deprosc Laghubitta Bittiya Sanstha Limited,15,3150,3085,3135,958,2978375,3130,5,2016-09-12
Deprosc Laghubitta Bittiya Sanstha Limited,7,3150,3135,3135,520,1635500,3135,0,2016-09-14
Deprosc Laghubitta Bittiya Sanstha Limited,5,3100,3080,3080,490,1511200,3135,-55,2016-09-18
Deprosc Laghubitta Bittiya Sanstha Limited,16,3080,3000,3005,1250,3788800,3080,-75,2016-09-20
Deprosc Laghubitta Bittiya Sanstha Limited,9,3045,2950,3045,1020,3067350,3005,40,2016-09-21
Deprosc Laghubitta Bittiya Sanstha Limited,13,3080,3050,3080,1158,3551759,3045,35,2016-09-22
Deprosc Laghubitta Bittiya Sanstha Limited,30,3019,2825,2851,4494,12968561,3080,-229,2016-09-25
Deprosc Laghubitta Bittiya Sanstha Limited,3,2925,2850,2925,200,580350,2851,74,2016-09-26
Deprosc Laghubitta Bittiya Sanstha Limited,4,2983,2925,2925,300,881080,2925,0,2016-09-27
Deprosc Laghubitta Bittiya Sanstha Limited,5,2980,2880,2980,482,1423525,2925,55,2016-09-28
Deprosc Laghubitta Bittiya Sanstha Limited,1,2960,2960,2960,13,38480,2980,-20,2016-09-29
Deprosc Laghubitta Bittiya Sanstha Limited,1,2940,2940,2940,10,29400,2960,-20,2016-10-02
Deprosc Laghubitta Bittiya Sanstha Limited,5,2950,2900,2900,1210,3560800,2940,-40,2016-10-03
Deprosc Laghubitta Bittiya Sanstha Limited,15,2880,2750,2800,1140,3206150,2900,-100,2016-10-04
Deprosc Laghubitta Bittiya Sanstha Limited,12,2853,2812,2840,1000,2834300,2800,40,2016-10-05
Deprosc Laghubitta Bittiya Sanstha Limited,14,2953,2850,2885,880,2537590,2840,45,2016-10-06
Deprosc Laghubitta Bittiya Sanstha Limited,10,2830,2762,2822,441,1236922,2885,-63,2016-10-16
Deprosc Laghubitta Bittiya Sanstha Limited,7,2874,2849,2849,260,744040,2822,27,2016-10-17
Deprosc Laghubitta Bittiya Sanstha Limited,18,2860,2776,2849,1716,4776809,2849,0,2016-10-18
Deprosc Laghubitta Bittiya Sanstha Limited,13,2800,2761,2788,1269,3518770,2849,-61,2016-10-19
Deprosc Laghubitta Bittiya Sanstha Limited,2,2752,2751,2751,170,467770,2788,-37,2016-10-20
Deprosc Laghubitta Bittiya Sanstha Limited,6,2754,2700,2750,630,1726850,2751,-1,2016-10-24
Deprosc Laghubitta Bittiya Sanstha Limited,4,2700,2700,2700,500,1350000,2750,-50,2016-10-25
Deprosc Laghubitta Bittiya Sanstha Limited,10,2719,2650,2719,571,1531302,2700,19,2016-10-26
Deprosc Laghubitta Bittiya Sanstha Limited,8,2770,2675,2770,2600,6998250,2719,51,2016-10-27
Deprosc Laghubitta Bittiya Sanstha Limited,29,2880,2800,2850,2746,7811950,2770,80,2016-11-03
Deprosc Laghubitta Bittiya Sanstha Limited,18,2815,2800,2800,1950,5477920,2850,-50,2016-11-07
Deprosc Laghubitta Bittiya Sanstha Limited,10,2775,2740,2750,1025,2824900,2800,-50,2016-11-08
Deprosc Laghubitta Bittiya Sanstha Limited,3,2747,2695,2747,120,326000,2750,-3,2016-11-09
Deprosc Laghubitta Bittiya Sanstha Limited,12,2710,2640,2640,689,1841750,2747,-107,2016-11-10
Deprosc Laghubitta Bittiya Sanstha Limited,10,2725,2690,2690,1070,2884150,2640,50,2016-11-13
Deprosc Laghubitta Bittiya Sanstha Limited,6,2720,2700,2710,561,1517420,2690,20,2016-11-14
Deprosc Laghubitta Bittiya Sanstha Limited,13,2764,2705,2705,1623,4448980,2710,-5,2016-11-15
Deprosc Laghubitta Bittiya Sanstha Limited,22,2900,2731,2731,1648,4585358,2705,26,2016-11-16
Deprosc Laghubitta Bittiya Sanstha Limited,24,2750,2647,2663,2711,7295185,2731,-68,2016-11-17
Deprosc Laghubitta Bittiya Sanstha Limited,21,2620,2517,2570,2510,6464140,2663,-93,2016-11-20
Deprosc Laghubitta Bittiya Sanstha Limited,53,2621,2500,2621,4925,12440589,2570,51,2016-11-21
Deprosc Laghubitta Bittiya Sanstha Limited,4,2580,2569,2569,350,900450,2621,-52,2016-11-22
Deprosc Laghubitta Bittiya Sanstha Limited,25,2520,2400,2400,1931,4722279,2569,-169,2016-11-23
Deprosc Laghubitta Bittiya Sanstha Limited,59,2468,2160,2239,3994,9075961,2400,-161,2016-11-24
Deprosc Laghubitta Bittiya Sanstha Limited,31,2200,2016,2016,1936,4021810,2239,-223,2016-11-27
Deprosc Laghubitta Bittiya Sanstha Limited,30,2096,1815,2096,2010,3846820,2016,80,2016-11-28
Deprosc Laghubitta Bittiya Sanstha Limited,27,2227,1961,2227,2236,4554872,2096,131,2016-11-29
Deprosc Laghubitta Bittiya Sanstha Limited,17,2361,2200,2361,1302,2962610,2227,134,2016-11-30
Deprosc Laghubitta Bittiya Sanstha Limited,30,2520,2400,2448,2976,7352820,2361,87,2016-12-01
Deprosc Laghubitta Bittiya Sanstha Limited,28,2400,2301,2301,2120,4949535,2448,-147,2016-12-04
Deprosc Laghubitta Bittiya Sanstha Limited,5,2255,2232,2232,800,1796700,2301,-69,2016-12-05
Deprosc Laghubitta Bittiya Sanstha Limited,12,2255,2201,2255,985,2186955,2232,23,2016-12-06
Deprosc Laghubitta Bittiya Sanstha Limited,5,2300,2285,2300,321,734300,2255,45,2016-12-07
Deprosc Laghubitta Bittiya Sanstha Limited,3,2285,2260,2285,115,262400,2300,-15,2016-12-08
Deprosc Laghubitta Bittiya Sanstha Limited,9,2243,2195,2195,351,774235,2285,-90,2016-12-11
Deprosc Laghubitta Bittiya Sanstha Limited,4,2200,2152,2200,200,436560,2195,5,2016-12-12
Deprosc Laghubitta Bittiya Sanstha Limited,4,2161,2156,2156,90,194410,2200,-44,2016-12-14
Deprosc Laghubitta Bittiya Sanstha Limited,11,2331,2156,2331,575,1270830,2156,175,2016-12-15
Deprosc Laghubitta Bittiya Sanstha Limited,10,2285,2264,2280,700,1593090,2331,-51,2016-12-18
Deprosc Laghubitta Bittiya Sanstha Limited,12,2280,2241,2250,1670,3757900,2280,-30,2016-12-19
Deprosc Laghubitta Bittiya Sanstha Limited,18,2258,2222,2250,1609,3620960,2250,0,2016-12-20
Deprosc Laghubitta Bittiya Sanstha Limited,15,2285,2250,2275,1442,3260690,2250,25,2016-12-21
Deprosc Laghubitta Bittiya Sanstha Limited,9,2320,2270,2270,693,1586860,2275,-5,2016-12-22
Deprosc Laghubitta Bittiya Sanstha Limited,20,2225,2180,2200,1571,3457225,2270,-70,2016-12-26
Deprosc Laghubitta Bittiya Sanstha Limited,20,2198,2058,2058,1710,3607100,2200,-142,2016-12-27
Deprosc Laghubitta Bittiya Sanstha Limited,38,2263,2025,2125,4563,9827165,2058,67,2016-12-28
Deprosc Laghubitta Bittiya Sanstha Limited,37,2230,2140,2140,3796,8276850,2125,15,2016-12-29
Deprosc Laghubitta Bittiya Sanstha Limited,31,2220,2180,2180,2427,5348656,2140,40,2017-01-01
Deprosc Laghubitta Bittiya Sanstha Limited,30,2275,2180,2275,4830,10756350,2180,95,2017-01-02
Deprosc Laghubitta Bittiya Sanstha Limited,9,2320,2200,2200,1428,3180233,2275,-75,2017-01-03
Deprosc Laghubitta Bittiya Sanstha Limited,4,2200,2170,2199,420,915900,2200,-1,2017-01-04
Deprosc Laghubitta Bittiya Sanstha Limited,14,2225,2200,2225,1270,2804680,2199,26,2017-01-05
Deprosc Laghubitta Bittiya Sanstha Limited,12,2238,2200,2238,838,1863182,2225,13,2017-01-08
Deprosc Laghubitta Bittiya Sanstha Limited,25,2235,2200,2210,3367,7452424,2238,-28,2017-01-09
Deprosc Laghubitta Bittiya Sanstha Limited,19,2253,2215,2240,2900,6483510,2210,30,2017-01-10
Deprosc Laghubitta Bittiya Sanstha Limited,9,2245,2220,2220,789,1758020,2240,-20,2017-01-11
Deprosc Laghubitta Bittiya Sanstha Limited,2,2239,2220,2220,25,55690,2220,0,2017-01-12
Deprosc Laghubitta Bittiya Sanstha Limited,5,2255,2176,2255,290,646770,2220,35,2017-01-15
Deprosc Laghubitta Bittiya Sanstha Limited,8,2255,2200,2200,1250,2791500,2255,-55,2017-01-16
Deprosc Laghubitta Bittiya Sanstha Limited,9,2220,2200,2200,1229,2709960,2200,0,2017-01-17
Deprosc Laghubitta Bittiya Sanstha Limited,14,2258,2222,2258,760,1699400,2200,58,2017-01-18
Deprosc Laghubitta Bittiya Sanstha Limited,3,2250,2250,2250,100,225000,2258,-8,2017-01-19
Deprosc Laghubitta Bittiya Sanstha Limited,6,2250,2248,2249,950,2137100,2250,-1,2017-01-22
Deprosc Laghubitta Bittiya Sanstha Limited,50,2330,2235,2240,4747,10706511,2249,-9,2017-01-23
Deprosc Laghubitta Bittiya Sanstha Limited,31,2222,2176,2176,3270,7180780,2240,-64,2017-01-24
Deprosc Laghubitta Bittiya Sanstha Limited,18,2190,2061,2061,1841,3942870,2176,-115,2017-01-25
Deprosc Laghubitta Bittiya Sanstha Limited,36,2049,1941,2015,2470,4903930,2061,-46,2017-01-26
Deprosc Laghubitta Bittiya Sanstha Limited,31,1975,1818,1818,2690,5000090,2015,-197,2017-01-30
Deprosc Laghubitta Bittiya Sanstha Limited,22,1891,1790,1891,1100,2019440,1818,73,2017-01-31
Deprosc Laghubitta Bittiya Sanstha Limited,28,2045,1925,2045,1868,3704532,1891,154,2017-02-01
Deprosc Laghubitta Bittiya Sanstha Limited,28,2126,2000,2020,2088,4240073,2045,-25,2017-02-02
Deprosc Laghubitta Bittiya Sanstha Limited,194,2199,2060,2180,15266,32993283,2020,160,2017-02-05
Deprosc Laghubitta Bittiya Sanstha Limited,83,2165,2100,2120,5407,11558822,2180,-60,2017-02-06
Deprosc Laghubitta Bittiya Sanstha Limited,49,2150,2100,2121,3009,6358822,2120,1,2017-02-07
Deprosc Laghubitta Bittiya Sanstha Limited,63,2145,2078,2094,4190,8776330,2121,-27,2017-02-08
Deprosc Laghubitta Bittiya Sanstha Limited,113,2090,1995,2000,7123,14407197,2094,-94,2017-02-09
Deprosc Laghubitta Bittiya Sanstha Limited,216,2010,1926,1938,11467,22434562,2000,-62,2017-02-12
Deprosc Laghubitta Bittiya Sanstha Limited,50,873,785,873,3339,2673465,867,6,2017-02-13
Deprosc Laghubitta Bittiya Sanstha Limited,38,860,830,830,3173,2644569,873,-43,2017-02-14
Deprosc Laghubitta Bittiya Sanstha Limited,38,856,825,850,3840,3247580,830,20,2017-02-15
Deprosc Laghubitta Bittiya Sanstha Limited,50,892,846,890,3480,3039615,850,40,2017-02-16
Deprosc Laghubitta Bittiya Sanstha Limited,65,915,856,900,7081,6356220,890,10,2017-02-19
Deprosc Laghubitta Bittiya Sanstha Limited,83,950,900,907,6756,6238270,900,7,2017-02-20
Deprosc Laghubitta Bittiya Sanstha Limited,56,945,905,913,4514,4161917,907,6,2017-02-21
Deprosc Laghubitta Bittiya Sanstha Limited,19,910,882,910,1710,1536530,913,-3,2017-02-22
Deprosc Laghubitta Bittiya Sanstha Limited,38,925,895,918,1955,1781930,910,8,2017-02-23
Deprosc Laghubitta Bittiya Sanstha Limited,20,918,895,900,2390,2153680,918,-18,2017-02-26
Deprosc Laghubitta Bittiya Sanstha Limited,22,918,900,900,1965,1777465,900,0,2017-02-28
Deprosc Laghubitta Bittiya Sanstha Limited,14,918,901,905,1540,1407855,900,5,2017-03-01
Deprosc Laghubitta Bittiya Sanstha Limited,21,920,911,920,1100,1009750,905,15,2017-03-02
Deprosc Laghubitta Bittiya Sanstha Limited,33,957,938,945,3680,3487930,920,25,2017-03-05
Deprosc Laghubitta Bittiya Sanstha Limited,56,1056,960,1056,7628,7698161,960,96,2017-03-21
Deprosc Laghubitta Bittiya Sanstha Limited,24,961,949,949,1595,1518880,945,4,2017-03-06
Deprosc Laghubitta Bittiya Sanstha Limited,10,940,915,930,635,589925,949,-19,2017-03-07
Deprosc Laghubitta Bittiya Sanstha Limited,9,940,915,915,495,457685,930,-15,2017-03-09
Deprosc Laghubitta Bittiya Sanstha Limited,11,925,912,912,1103,1011845,915,-3,2017-03-13
Deprosc Laghubitta Bittiya Sanstha Limited,3,929,912,915,560,516030,912,3,2017-03-14
Deprosc Laghubitta Bittiya Sanstha Limited,7,921,920,921,860,791430,915,6,2017-03-15
Deprosc Laghubitta Bittiya Sanstha Limited,7,925,916,916,399,366875,921,-5,2017-03-16
Deprosc Laghubitta Bittiya Sanstha Limited,26,935,920,928,2742,2536540,916,12,2017-03-19
Deprosc Laghubitta Bittiya Sanstha Limited,38,963,939,960,6920,6610942,928,32,2017-03-20
Deprosc Laghubitta Bittiya Sanstha Limited,103,1161,1077,1135,11306,13045289,1056,79,2017-03-22
Deprosc Laghubitta Bittiya Sanstha Limited,98,1205,1150,1180,9603,11278124,1135,45,2017-03-23
Deprosc Laghubitta Bittiya Sanstha Limited,110,1274,1190,1274,13923,17285195,1180,94,2017-03-26
Deprosc Laghubitta Bittiya Sanstha Limited,88,1401,1299,1400,12518,17210158,1274,126,2017-03-28
Deprosc Laghubitta Bittiya Sanstha Limited,110,1497,1380,1409,12430,17908430,1400,9,2017-03-29
Deprosc Laghubitta Bittiya Sanstha Limited,57,1427,1359,1414,5600,7823123,1409,5,2017-03-30
Deprosc Laghubitta Bittiya Sanstha Limited,51,1555,1442,1555,6354,9364976,1414,141,2017-04-02
Deprosc Laghubitta Bittiya Sanstha Limited,49,1617,1470,1500,5027,7795398,1555,-55,2017-04-03
Deprosc Laghubitta Bittiya Sanstha Limited,26,1530,1461,1475,2510,3720530,1500,-25,2017-04-04
Deprosc Laghubitta Bittiya Sanstha Limited,36,1500,1422,1440,6095,8854345,1475,-35,2017-04-06
Deprosc Laghubitta Bittiya Sanstha Limited,51,1442,1400,1410,3237,4568419,1440,-30,2017-04-09
Deprosc Laghubitta Bittiya Sanstha Limited,73,1551,1382,1510,7995,11972937,1410,100,2017-04-10
Deprosc Laghubitta Bittiya Sanstha Limited,87,1586,1513,1555,10345,15909786,1510,45,2017-04-11
Deprosc Laghubitta Bittiya Sanstha Limited,88,1700,1570,1591,13513,21967560,1555,36,2017-04-12
Deprosc Laghubitta Bittiya Sanstha Limited,65,1637,1559,1590,5205,8272665,1591,-1,2017-04-13
Deprosc Laghubitta Bittiya Sanstha Limited,33,1575,1503,1505,3170,4873288,1590,-85,2017-04-16
Deprosc Laghubitta Bittiya Sanstha Limited,65,1510,1373,1460,6504,9345910,1505,-45,2017-04-18
Deprosc Laghubitta Bittiya Sanstha Limited,47,1560,1480,1560,4416,6757717,1460,100,2017-04-19
Deprosc Laghubitta Bittiya Sanstha Limited,34,1590,1535,1535,2035,3172150,1560,-25,2017-04-20
Deprosc Laghubitta Bittiya Sanstha Limited,38,1627,1565,1590,3975,6317075,1535,55,2017-04-23
Deprosc Laghubitta Bittiya Sanstha Limited,12,1605,1540,1540,824,1288840,1590,-50,2017-04-24
Deprosc Laghubitta Bittiya Sanstha Limited,14,1560,1540,1540,900,1392900,1540,0,2017-04-25
Deprosc Laghubitta Bittiya Sanstha Limited,11,1550,1520,1545,1450,2223250,1540,5,2017-04-26
Deprosc Laghubitta Bittiya Sanstha Limited,31,1550,1480,1530,2979,4525055,1545,-15,2017-04-27
Deprosc Laghubitta Bittiya Sanstha Limited,24,1530,1478,1505,1615,2417335,1530,-25,2017-04-30
Deprosc Laghubitta Bittiya Sanstha Limited,33,1530,1469,1530,3179,4764145,1505,25,2017-05-02
Deprosc Laghubitta Bittiya Sanstha Limited,17,1560,1530,1530,860,1325350,1530,0,2017-05-03
Deprosc Laghubitta Bittiya Sanstha Limited,17,1500,1480,1490,1040,1547850,1530,-40,2017-05-04
Deprosc Laghubitta Bittiya Sanstha Limited,11,1500,1472,1480,401,592954,1490,-10,2017-05-07
Deprosc Laghubitta Bittiya Sanstha Limited,18,1500,1480,1499,1422,2128450,1480,19,2017-05-08
Deprosc Laghubitta Bittiya Sanstha Limited,9,1501,1490,1499,630,943440,1499,0,2017-05-09
Deprosc Laghubitta Bittiya Sanstha Limited,17,1500,1480,1485,2630,3901090,1499,-14,2017-05-11
Deprosc Laghubitta Bittiya Sanstha Limited,15,1510,1480,1488,1275,1901360,1485,3,2017-05-15
Deprosc Laghubitta Bittiya Sanstha Limited,14,1490,1475,1480,1060,1572450,1488,-8,2017-05-16
Deprosc Laghubitta Bittiya Sanstha Limited,14,1480,1465,1476,735,1085065,1480,-4,2017-05-17
Deprosc Laghubitta Bittiya Sanstha Limited,15,1484,1475,1480,1318,1950782,1476,4,2017-05-18
Deprosc Laghubitta Bittiya Sanstha Limited,9,1488,1485,1485,390,579680,1480,5,2017-05-21
Deprosc Laghubitta Bittiya Sanstha Limited,9,1484,1462,1462,967,1426264,1485,-23,2017-05-22
Deprosc Laghubitta Bittiya Sanstha Limited,19,1495,1442,1442,1561,2282984,1462,-20,2017-05-23
Deprosc Laghubitta Bittiya Sanstha Limited,15,1460,1440,1450,1025,1481630,1442,8,2017-05-24
Deprosc Laghubitta Bittiya Sanstha Limited,22,1460,1450,1450,1930,2810270,1450,0,2017-05-28
Deprosc Laghubitta Bittiya Sanstha Limited,19,1450,1390,1390,1528,2173120,1450,-60,2017-05-30
Deprosc Laghubitta Bittiya Sanstha Limited,22,1430,1355,1430,1619,2245510,1390,40,2017-05-31
Deprosc Laghubitta Bittiya Sanstha Limited,34,1432,1422,1425,3407,4862785,1430,-5,2017-06-01
Deprosc Laghubitta Bittiya Sanstha Limited,19,1430,1410,1412,1996,2830360,1425,-13,2017-06-04
Deprosc Laghubitta Bittiya Sanstha Limited,15,1441,1420,1429,1320,1883530,1412,17,2017-06-05
Deprosc Laghubitta Bittiya Sanstha Limited,36,1474,1450,1472,2590,3791750,1429,43,2017-06-06
Deprosc Laghubitta Bittiya Sanstha Limited,28,1500,1450,1450,1953,2878040,1472,-22,2017-06-07
Deprosc Laghubitta Bittiya Sanstha Limited,4,1445,1426,1444,280,400940,1450,-6,2017-06-08
Deprosc Laghubitta Bittiya Sanstha Limited,30,1472,1400,1401,3708,5260619,1444,-43,2017-06-11
Deprosc Laghubitta Bittiya Sanstha Limited,25,1405,1390,1390,1820,2545450,1401,-11,2017-06-12
Deprosc Laghubitta Bittiya Sanstha Limited,4,1400,1375,1400,150,208650,1390,10,2017-06-13
Deprosc Laghubitta Bittiya Sanstha Limited,7,1401,1388,1400,435,607885,1400,0,2017-06-14
Deprosc Laghubitta Bittiya Sanstha Limited,4,1410,1390,1390,175,244750,1400,-10,2017-06-18
Deprosc Laghubitta Bittiya Sanstha Limited,13,1365,1351,1352,1180,1600755,1390,-38,2017-06-19
Deprosc Laghubitta Bittiya Sanstha Limited,29,1348,1300,1325,3401,4507781,1352,-27,2017-06-20
Deprosc Laghubitta Bittiya Sanstha Limited,39,1350,1300,1300,2624,3470510,1325,-25,2017-06-21
Deprosc Laghubitta Bittiya Sanstha Limited,44,1338,1300,1300,3435,4513630,1300,0,2017-06-22
Deprosc Laghubitta Bittiya Sanstha Limited,52,1330,1300,1300,2931,3827118,1300,0,2017-06-25
Deprosc Laghubitta Bittiya Sanstha Limited,36,1310,1280,1285,3145,4065895,1300,-15,2017-06-27
Deprosc Laghubitta Bittiya Sanstha Limited,35,1300,1280,1294,3617,4672970,1285,9,2017-06-28
Deprosc Laghubitta Bittiya Sanstha Limited,24,1294,1269,1269,1440,1837450,1294,-25,2017-07-02
Deprosc Laghubitta Bittiya Sanstha Limited,31,1300,1275,1275,5292,6798385,1269,6,2017-07-03
Deprosc Laghubitta Bittiya Sanstha Limited,26,1295,1250,1280,2198,2797416,1275,5,2017-07-04
Deprosc Laghubitta Bittiya Sanstha Limited,20,1277,1260,1277,1326,1675525,1280,-3,2017-07-05
Deprosc Laghubitta Bittiya Sanstha Limited,58,1312,1290,1310,5607,7314442,1277,33,2017-07-06
Deprosc Laghubitta Bittiya Sanstha Limited,62,1349,1295,1326,5249,6969903,1310,16,2017-07-09
Deprosc Laghubitta Bittiya Sanstha Limited,26,1310,1290,1300,1945,2521687,1326,-26,2017-07-10
Deprosc Laghubitta Bittiya Sanstha Limited,28,1319,1299,1299,1682,2197355,1300,-1,2017-07-11
Deprosc Laghubitta Bittiya Sanstha Limited,39,1310,1290,1300,2471,3217580,1299,1,2017-07-12
Deprosc Laghubitta Bittiya Sanstha Limited,33,1294,1280,1285,2997,3843545,1300,-15,2017-07-13
Deprosc Laghubitta Bittiya Sanstha Limited,17,1300,1285,1295,980,1264737,1285,10,2017-07-16
Deprosc Laghubitta Bittiya Sanstha Limited,61,1365,1328,1328,6140,8325705,1355,-27,2017-07-19
Deprosc Laghubitta Bittiya Sanstha Limited,29,1348,1321,1333,5085,6782895,1328,5,2017-07-20
Deprosc Laghubitta Bittiya Sanstha Limited,30,1330,1310,1312,3457,4575270,1302,10,2017-07-25
Deprosc Laghubitta Bittiya Sanstha Limited,141,1425,1320,1380,17873,24572833,1318,62,2017-07-27
Deprosc Laghubitta Bittiya Sanstha Limited,94,1410,1375,1400,11244,15714354,1380,20,2017-07-30
Deprosc Laghubitta Bittiya Sanstha Limited,172,1505,1430,1505,17602,25801246,1427,78,2017-08-01
Deprosc Laghubitta Bittiya Sanstha Limited,15,1390,1370,1376,753,1039907,1382,-6,2017-08-21
Deprosc Laghubitta Bittiya Sanstha Limited,31,1417,1365,1375,2224,3092436,1376,-1,2017-08-22
Deprosc Laghubitta Bittiya Sanstha Limited,54,1447,1401,1415,4735,6747205,1420,-5,2017-08-30
Deprosc Laghubitta Bittiya Sanstha Limited,36,1316,1297,1305,3904,5089981,1316,-11,2017-09-12
Deprosc Laghubitta Bittiya Sanstha Limited,25,1200,1180,1185,1857,2203310,1186,-1,2017-10-09
Deprosc Laghubitta Bittiya Sanstha Limited,4,1255,1245,1245,500,623400,1248,-3,2017-10-03
Deprosc Laghubitta Bittiya Sanstha Limited,18,1198,1193,1194,1430,1708375,1191,3,2017-10-12
Deprosc Laghubitta Bittiya Sanstha Limited,21,1250,1206,1250,2900,3549015,1230,20,2017-10-18
Deprosc Laghubitta Bittiya Sanstha Limited,6,1274,1250,1250,424,532186,1250,0,2017-10-22
Deprosc Laghubitta Bittiya Sanstha Limited,37,1030,999,1015,3690,3747025,1029,-14,2017-12-27
Deprosc Laghubitta Bittiya Sanstha Limited,34,883,870,871,4240,3708690,898,-27,2018-01-10
Deprosc Laghubitta Bittiya Sanstha Limited,12,855,841,841,935,790835,850,-9,2018-01-17
Deprosc Laghubitta Bittiya Sanstha Limited,14,856,835,845,1390,1170847,840,5,2018-01-29
Deprosc Laghubitta Bittiya Sanstha Limited,5,865,855,855,280,239780,850,5,2018-02-01
Deprosc Laghubitta Bittiya Sanstha Limited,16,866,846,852,1580,1343962,866,-14,2018-02-05
Deprosc Laghubitta Bittiya Sanstha Limited,18,835,820,831,1783,1476149,831,0,2018-02-08
Deprosc Laghubitta Bittiya Sanstha Limited,6,827,825,826,250,206635,828,-2,2018-02-25
Deprosc Laghubitta Bittiya Sanstha Limited,28,835,811,827,2000,1640565,820,7,2018-02-12
Deprosc Laghubitta Bittiya Sanstha Limited,13,840,825,840,1292,1074484,827,13,2018-02-14
Deprosc Laghubitta Bittiya Sanstha Limited,6,840,831,840,445,372790,835,5,2018-02-21
Deprosc Laghubitta Bittiya Sanstha Limited,23,845,828,828,2363,1965603,840,-12,2018-02-22
Deprosc Laghubitta Bittiya Sanstha Limited,26,817,803,806,1713,1388310,826,-20,2018-02-26
Deprosc Laghubitta Bittiya Sanstha Limited,26,795,766,787,1814,1412716,811,-24,2018-03-04
Deprosc Laghubitta Bittiya Sanstha Limited,31,790,760,765,2209,1696681,787,-22,2018-03-05
Deprosc Laghubitta Bittiya Sanstha Limited,13,760,755,760,1950,1477540,770,-10,2018-03-14
Deprosc Laghubitta Bittiya Sanstha Limited,16,765,750,750,1340,1012080,760,-10,2018-03-15
Deprosc Laghubitta Bittiya Sanstha Limited,21,750,737,737,1703,1264496,750,-13,2018-03-18
Deprosc Laghubitta Bittiya Sanstha Limited,28,726,718,720,1620,1167560,740,-20,2018-03-20
Deprosc Laghubitta Bittiya Sanstha Limited,15,710,707,709,753,532914,720,-11,2018-03-21
Deprosc Laghubitta Bittiya Sanstha Limited,40,734,695,698,3987,2808686,709,-11,2018-03-22
Deprosc Laghubitta Bittiya Sanstha Limited,25,702,661,680,1393,950668,705,-25,2018-04-01
Deprosc Laghubitta Bittiya Sanstha Limited,9,690,673,680,245,166410,680,0,2018-04-02
Deprosc Laghubitta Bittiya Sanstha Limited,9,680,670,675,710,480500,680,-5,2018-04-03
Deprosc Laghubitta Bittiya Sanstha Limited,16,879,862,867,990,860357,871,-4,2018-05-07
Deprosc Laghubitta Bittiya Sanstha Limited,40,875,835,870,4298,3617864,859,11,2018-05-21
Dev BikasBank Ltd. Promoter Share,3,160,160,160,18201,2912160,160,0,2016-06-28
Dev BikasBank Ltd. Promoter Share,4,160,160,160,60671,9707360,160,0,2016-07-27
Dev BikasBank Ltd. Promoter Share,4,170,170,170,4672,794240,170,0,2016-12-05
Dev BikasBank Ltd. Promoter Share,7,181,172,181,36674,6592406,170,11,2016-12-18
Dev BikasBank Ltd. Promoter Share,4,181,181,181,9795,1772895,181,0,2016-12-22
Dev BikasBank Ltd. Promoter Share,1,105,105,105,11532,1210860,105,0,2018-05-07
Deva Bikas Bank Limited,25,261,246,250,10063,2553419,247,3,2016-06-07
Deva Bikas Bank Limited,141,332,308,315,45076,14415216,302,13,2016-06-23
Deva Bikas Bank Limited,19,255,246,252,13156,3303966,250,2,2016-06-08
Deva Bikas Bank Limited,18,258,248,252,7852,1988615,252,0,2016-06-09
Deva Bikas Bank Limited,29,260,250,250,7658,1952678,252,-2,2016-06-12
Deva Bikas Bank Limited,21,260,250,256,10579,2708283,250,6,2016-06-13
Deva Bikas Bank Limited,86,281,261,281,53777,15012786,256,25,2016-06-14
Deva Bikas Bank Limited,167,309,280,309,77294,23036946,281,28,2016-06-15
Deva Bikas Bank Limited,62,320,294,294,35457,10876642,309,-15,2016-06-16
Deva Bikas Bank Limited,56,313,294,300,22773,6869265,294,6,2016-06-19
Deva Bikas Bank Limited,25,303,288,290,6082,1790516,300,-10,2016-06-20
Deva Bikas Bank Limited,22,298,290,297,7323,2164991,290,7,2016-06-21
Deva Bikas Bank Limited,48,307,294,302,20841,6318244,297,5,2016-06-22
Deva Bikas Bank Limited,49,320,311,316,15153,4780586,315,1,2016-06-26
Deva Bikas Bank Limited,74,322,303,313,33705,10475035,316,-3,2016-06-27
Deva Bikas Bank Limited,33,314,305,309,10962,3378587,308,1,2016-06-29
Deva Bikas Bank Limited,34,315,308,308,9672,2996159,309,-1,2016-06-30
Deva Bikas Bank Limited,39,312,308,310,13364,4140869,308,2,2016-07-03
Deva Bikas Bank Limited,50,316,306,315,9873,3083914,310,5,2016-07-04
Deva Bikas Bank Limited,69,325,315,324,26852,8563670,315,9,2016-07-05
Deva Bikas Bank Limited,62,336,325,330,22996,7606475,324,6,2016-07-06
Deva Bikas Bank Limited,62,341,328,338,19259,6515955,330,8,2016-07-10
Deva Bikas Bank Limited,51,345,333,338,12824,4329602,338,0,2016-07-11
Deva Bikas Bank Limited,16,337,330,331,4541,1515005,338,-7,2016-07-12
Deva Bikas Bank Limited,13,329,320,321,3787,1227507,321,0,2016-07-14
Deva Bikas Bank Limited,19,333,325,329,6046,1996717,321,8,2016-07-17
Deva Bikas Bank Limited,27,335,322,329,10481,3437757,329,0,2016-07-18
Deva Bikas Bank Limited,78,346,326,345,43554,14654675,329,16,2016-07-19
Deva Bikas Bank Limited,71,363,346,360,24916,8872702,350,10,2016-07-21
Deva Bikas Bank Limited,62,396,366,396,23816,9299833,360,36,2016-07-25
Deva Bikas Bank Limited,200,435,403,435,84958,35749682,396,39,2016-07-26
Deva Bikas Bank Limited,279,457,408,457,101129,45263144,416,41,2016-07-28
Deva Bikas Bank Limited,136,458,435,435,34785,15342146,457,-22,2016-07-31
Deva Bikas Bank Limited,87,433,410,420,17638,7383581,435,-15,2016-08-01
Deva Bikas Bank Limited,96,418,408,414,23506,9679179,420,-6,2016-08-02
Deva Bikas Bank Limited,75,422,402,410,12251,5038438,414,-4,2016-08-03
Deva Bikas Bank Limited,74,410,380,380,15735,6259167,410,-30,2016-08-04
Deva Bikas Bank Limited,68,418,387,395,17423,6972181,380,15,2016-08-07
Deva Bikas Bank Limited,31,395,368,368,10429,3952638,395,-27,2016-08-08
Deva Bikas Bank Limited,3,384,370,384,320,118610,368,16,2016-08-09
Deva Bikas Bank Limited,129,420,384,405,45039,18007307,384,21,2016-08-10
Deva Bikas Bank Limited,190,438,412,415,60596,25797623,405,10,2016-08-11
Deva Bikas Bank Limited,80,411,395,405,21323,8633104,415,-10,2016-08-14
Deva Bikas Bank Limited,57,414,384,395,14224,5605268,405,-10,2016-08-15
Deva Bikas Bank Limited,15,384,375,384,2534,963644,382,2,2016-08-31
Deva Bikas Bank Limited,54,410,391,402,11331,4533212,395,7,2016-08-16
Deva Bikas Bank Limited,86,410,389,402,23442,9424585,402,0,2016-08-17
Deva Bikas Bank Limited,37,400,383,390,13372,5205488,402,-12,2016-08-21
Deva Bikas Bank Limited,56,383,359,368,14289,5206147,390,-22,2016-08-22
Deva Bikas Bank Limited,34,382,356,369,8539,3130833,368,1,2016-08-23
Deva Bikas Bank Limited,18,380,366,376,6444,2395232,369,7,2016-08-24
Deva Bikas Bank Limited,24,370,360,362,6985,2521120,376,-14,2016-08-28
Deva Bikas Bank Limited,44,385,355,367,8680,3218036,362,5,2016-08-29
Deva Bikas Bank Limited,53,382,365,382,18588,6920150,367,15,2016-08-30
Deva Bikas Bank Limited,51,402,385,402,14319,5627878,384,18,2016-09-01
Deva Bikas Bank Limited,42,413,385,403,8968,3561691,402,1,2016-09-04
Deva Bikas Bank Limited,37,407,392,403,15724,6270572,403,0,2016-09-05
Deva Bikas Bank Limited,50,405,389,395,11758,4684409,403,-8,2016-09-06
Deva Bikas Bank Limited,49,396,383,385,14729,5709536,395,-10,2016-09-07
Deva Bikas Bank Limited,36,392,379,385,7356,2833561,385,0,2016-09-08
Deva Bikas Bank Limited,21,390,380,386,5297,2025324,385,1,2016-09-11
Deva Bikas Bank Limited,37,393,379,388,11994,4640153,386,2,2016-09-12
Deva Bikas Bank Limited,45,399,382,385,9892,3869756,388,-3,2016-09-14
Deva Bikas Bank Limited,25,390,380,387,5292,2024392,385,2,2016-09-18
Deva Bikas Bank Limited,35,380,373,376,3842,1441658,387,-11,2016-09-20
Deva Bikas Bank Limited,16,375,367,372,3100,1151333,376,-4,2016-09-21
Deva Bikas Bank Limited,19,375,366,371,4246,1574999,372,-1,2016-09-22
Deva Bikas Bank Limited,38,375,358,360,7974,2914236,371,-11,2016-09-25
Deva Bikas Bank Limited,36,379,360,371,7058,2606379,360,11,2016-09-26
Deva Bikas Bank Limited,35,372,355,365,5003,1821677,371,-6,2016-09-27
Deva Bikas Bank Limited,23,372,361,365,5336,1959382,365,0,2016-09-28
Deva Bikas Bank Limited,4,368,358,358,656,240448,375,-17,2016-10-02
Deva Bikas Bank Limited,28,377,360,366,5634,2066999,358,8,2016-10-03
Deva Bikas Bank Limited,15,372,366,368,4797,1779296,366,2,2016-10-04
Deva Bikas Bank Limited,15,370,361,361,3937,1441080,368,-7,2016-10-05
Deva Bikas Bank Limited,34,385,368,381,9337,3508204,361,20,2016-10-06
Deva Bikas Bank Limited,12,380,370,379,1565,590537,381,-2,2016-10-16
Deva Bikas Bank Limited,15,383,374,375,2682,1015116,379,-4,2016-10-17
Deva Bikas Bank Limited,12,378,371,371,2629,984751,375,-4,2016-10-18
Deva Bikas Bank Limited,19,375,373,373,2460,919362,371,2,2016-10-19
Deva Bikas Bank Limited,30,387,373,382,5545,2109171,373,9,2016-10-20
Deva Bikas Bank Limited,18,385,377,380,4335,1652040,382,-2,2016-10-23
Deva Bikas Bank Limited,18,380,375,375,3362,1269400,380,-5,2016-10-24
Deva Bikas Bank Limited,15,380,371,380,3976,1505242,375,5,2016-10-25
Deva Bikas Bank Limited,16,380,373,380,5360,2012589,380,0,2016-10-26
Deva Bikas Bank Limited,22,380,368,368,7068,2630426,380,-12,2016-10-27
Deva Bikas Bank Limited,3,366,366,366,264,96624,368,-2,2016-11-03
Deva Bikas Bank Limited,9,370,361,364,1215,446382,366,-2,2016-11-07
Deva Bikas Bank Limited,15,363,358,360,2736,984771,364,-4,2016-11-08
Deva Bikas Bank Limited,37,360,346,347,8326,2929141,360,-13,2016-11-09
Deva Bikas Bank Limited,25,353,341,343,3718,1278311,347,-4,2016-11-10
Deva Bikas Bank Limited,31,363,349,357,10529,3769939,343,14,2016-11-13
Deva Bikas Bank Limited,10,354,350,351,2667,937656,357,-6,2016-11-14
Deva Bikas Bank Limited,25,355,345,347,4033,1406938,350,-3,2016-11-16
Deva Bikas Bank Limited,15,347,340,342,2432,831069,347,-5,2016-11-17
Deva Bikas Bank Limited,17,340,327,334,4365,1448557,342,-8,2016-11-20
Deva Bikas Bank Limited,24,329,317,323,5099,1658046,334,-11,2016-11-21
Deva Bikas Bank Limited,13,325,317,320,3645,1165420,323,-3,2016-11-22
Deva Bikas Bank Limited,31,315,299,299,5489,1674261,320,-21,2016-11-23
Deva Bikas Bank Limited,28,310,300,307,3801,1157703,299,8,2016-11-24
Deva Bikas Bank Limited,16,301,280,280,2254,643954,307,-27,2016-11-27
Deva Bikas Bank Limited,37,290,252,285,5717,1513683,280,5,2016-11-28
Deva Bikas Bank Limited,36,313,275,313,11650,3368915,285,28,2016-11-29
Deva Bikas Bank Limited,61,330,311,326,13062,4208011,313,13,2016-11-30
Deva Bikas Bank Limited,62,335,319,323,19174,6205691,326,-3,2016-12-01
Deva Bikas Bank Limited,35,320,309,309,10840,3386550,316,-7,2016-12-05
Deva Bikas Bank Limited,54,316,305,310,24386,7547742,309,1,2016-12-06
Deva Bikas Bank Limited,118,322,308,318,89401,27951736,310,8,2016-12-07
Deva Bikas Bank Limited,24,323,309,314,6138,1944742,318,-4,2016-12-08
Deva Bikas Bank Limited,53,313,306,312,25403,7874134,314,-2,2016-12-11
Deva Bikas Bank Limited,49,313,304,304,13436,4139515,312,-8,2016-12-12
Deva Bikas Bank Limited,22,311,303,309,5580,1716014,304,5,2016-12-14
Deva Bikas Bank Limited,25,319,309,310,2958,936859,309,1,2016-12-15
Deva Bikas Bank Limited,36,320,307,315,14941,4634668,310,5,2016-12-18
Deva Bikas Bank Limited,14,314,311,314,2879,900827,315,-1,2016-12-19
Deva Bikas Bank Limited,23,314,307,308,5311,1636284,314,-6,2016-12-20
Deva Bikas Bank Limited,48,308,298,298,9508,2865439,308,-10,2016-12-21
Deva Bikas Bank Limited,40,301,293,300,10522,3152145,298,2,2016-12-22
Deva Bikas Bank Limited,59,299,286,288,6663,1946131,300,-12,2016-12-26
Deva Bikas Bank Limited,58,299,284,285,14091,4054958,288,-3,2016-12-27
Deva Bikas Bank Limited,90,297,285,295,17716,5156659,285,10,2016-12-28
Deva Bikas Bank Limited,44,307,295,296,6452,1926826,295,1,2016-12-29
Deva Bikas Bank Limited,266,318,296,315,47805,14621245,296,19,2017-01-01
Deva Bikas Bank Limited,28,235,215,228,5040,1117956,223,5,2017-01-02
Deva Bikas Bank Limited,8,228,214,217,2380,515960,228,-11,2017-01-03
Deva Bikas Bank Limited,13,219,210,215,2472,528582,217,-2,2017-01-04
Deva Bikas Bank Limited,18,220,210,210,6318,1337160,215,-5,2017-01-05
Deva Bikas Bank Limited,19,209,202,208,3882,799680,210,-2,2017-01-08
Deva Bikas Bank Limited,32,211,204,208,4814,1004758,208,0,2017-01-09
Deva Bikas Bank Limited,4,214,206,214,1300,271800,208,6,2017-01-10
Deva Bikas Bank Limited,7,214,211,211,1400,295800,214,-3,2017-01-11
Deva Bikas Bank Limited,15,210,206,206,1827,378317,211,-5,2017-01-12
Deva Bikas Bank Limited,12,214,209,211,2220,472421,206,5,2017-01-15
Deva Bikas Bank Limited,13,215,207,207,970,204770,211,-4,2017-01-16
Deva Bikas Bank Limited,10,207,200,203,1571,320319,207,-4,2017-01-17
Deva Bikas Bank Limited,10,212,207,212,1110,234490,203,9,2017-01-18
Deva Bikas Bank Limited,89,225,216,217,18698,4129586,212,5,2017-01-19
Deva Bikas Bank Limited,48,222,214,214,11764,2551063,217,-3,2017-01-22
Deva Bikas Bank Limited,27,214,211,214,4500,956136,214,0,2017-01-23
Deva Bikas Bank Limited,58,214,204,209,11324,2372574,214,-5,2017-01-24
Deva Bikas Bank Limited,27,208,201,205,7366,1499910,209,-4,2017-01-25
Deva Bikas Bank Limited,35,205,195,203,5410,1082038,205,-2,2017-01-26
Deva Bikas Bank Limited,35,200,186,189,4852,936703,203,-14,2017-01-30
Deva Bikas Bank Limited,20,205,186,200,2945,585641,189,11,2017-01-31
Deva Bikas Bank Limited,33,213,204,212,3790,792226,200,12,2017-02-01
Deva Bikas Bank Limited,38,219,208,210,12514,2646250,212,-2,2017-02-02
Deva Bikas Bank Limited,5,211,207,207,788,165476,210,-3,2017-02-05
Deva Bikas Bank Limited,12,207,199,202,2341,478235,207,-5,2017-02-06
Deva Bikas Bank Limited,35,203,199,200,6497,1302319,202,-2,2017-02-07
Deva Bikas Bank Limited,17,200,195,198,1797,355423,200,-2,2017-02-08
Deva Bikas Bank Limited,39,200,191,191,7627,1495792,198,-7,2017-02-09
Deva Bikas Bank Limited,28,191,185,190,4396,822802,191,-1,2017-02-12
Deva Bikas Bank Limited,57,198,172,198,11755,2145652,190,8,2017-02-13
Deva Bikas Bank Limited,33,200,190,197,9943,1936662,198,-1,2017-02-14
Deva Bikas Bank Limited,48,202,195,201,4726,945782,197,4,2017-02-15
Deva Bikas Bank Limited,54,205,198,201,9287,1860856,201,0,2017-02-16
Deva Bikas Bank Limited,49,201,194,200,12137,2405087,201,-1,2017-02-19
Deva Bikas Bank Limited,37,204,193,200,8864,1762316,200,0,2017-02-20
Deva Bikas Bank Limited,46,209,190,198,10047,1987930,200,-2,2017-02-21
Deva Bikas Bank Limited,8,199,194,194,2120,416480,198,-4,2017-02-22
Deva Bikas Bank Limited,12,198,191,193,1731,338673,194,-1,2017-02-23
Deva Bikas Bank Limited,17,193,190,193,4400,839540,193,0,2017-02-26
Deva Bikas Bank Limited,18,195,190,190,2391,461975,193,-3,2017-02-28
Deva Bikas Bank Limited,18,194,190,190,5217,995518,190,0,2017-03-01
Deva Bikas Bank Limited,39,193,187,190,9537,1805230,190,0,2017-03-02
Deva Bikas Bank Limited,27,198,191,193,6286,1219504,190,3,2017-03-05
Deva Bikas Bank Limited,69,214,196,209,15006,3051643,200,9,2017-03-21
Deva Bikas Bank Limited,23,199,195,198,5691,1117129,193,5,2017-03-06
Deva Bikas Bank Limited,6,196,194,194,1050,204600,198,-4,2017-03-07
Deva Bikas Bank Limited,23,197,191,191,4840,933670,194,-3,2017-03-09
Deva Bikas Bank Limited,9,194,191,192,2501,483449,191,1,2017-03-13
Deva Bikas Bank Limited,11,195,190,192,2178,417946,192,0,2017-03-14
Deva Bikas Bank Limited,3,195,192,192,456,88252,192,0,2017-03-15
Deva Bikas Bank Limited,34,195,187,190,3211,615949,192,-2,2017-03-16
Deva Bikas Bank Limited,30,193,190,191,7115,1363490,190,1,2017-03-19
Deva Bikas Bank Limited,35,204,194,200,13626,2699974,191,9,2017-03-20
Deva Bikas Bank Limited,150,229,210,214,40150,8962736,209,5,2017-03-22
Deva Bikas Bank Limited,43,223,210,215,12644,2741225,214,1,2017-03-23
Deva Bikas Bank Limited,84,231,215,224,23827,5402529,215,9,2017-03-26
Deva Bikas Bank Limited,56,242,228,237,15017,3538680,224,13,2017-03-28
Deva Bikas Bank Limited,78,242,228,228,16875,3929778,237,-9,2017-03-29
Deva Bikas Bank Limited,40,232,221,225,9799,2198150,228,-3,2017-03-30
Deva Bikas Bank Limited,34,242,222,242,13217,3006901,225,17,2017-04-02
Deva Bikas Bank Limited,75,256,228,228,26825,6588472,242,-14,2017-04-03
Deva Bikas Bank Limited,74,240,225,232,24542,5702615,228,4,2017-04-04
Deva Bikas Bank Limited,49,236,228,232,12372,2868456,232,0,2017-04-06
Deva Bikas Bank Limited,49,237,230,230,13694,3177349,232,-2,2017-04-09
Deva Bikas Bank Limited,35,240,230,237,14189,3316358,230,7,2017-04-10
Deva Bikas Bank Limited,57,242,237,240,20122,4802459,237,3,2017-04-11
Deva Bikas Bank Limited,116,264,244,254,44966,11653644,240,14,2017-04-12
Deva Bikas Bank Limited,137,275,245,270,36337,9513857,254,16,2017-04-13
Deva Bikas Bank Limited,122,285,261,265,32245,8751282,270,-5,2017-04-16
Deva Bikas Bank Limited,95,270,245,259,32694,8507489,265,-6,2017-04-18
Deva Bikas Bank Limited,101,278,255,278,21172,5731536,259,19,2017-04-19
Deva Bikas Bank Limited,114,289,273,276,54352,15287837,278,-2,2017-04-20
Deva Bikas Bank Limited,197,303,281,296,71844,21255754,276,20,2017-04-23
Deva Bikas Bank Limited,161,304,286,298,50707,15043384,296,2,2017-04-24
Deva Bikas Bank Limited,68,295,285,288,21608,6279267,298,-10,2017-04-25
Deva Bikas Bank Limited,62,293,282,284,18261,5209725,288,-4,2017-04-26
Deva Bikas Bank Limited,23,287,280,283,4228,1199870,284,-1,2017-04-27
Deva Bikas Bank Limited,46,288,274,276,9352,2610480,283,-7,2017-04-30
Deva Bikas Bank Limited,44,285,270,278,14910,4134511,276,2,2017-05-02
Deva Bikas Bank Limited,21,283,277,277,5688,1584544,278,-1,2017-05-03
Deva Bikas Bank Limited,33,280,270,275,8321,2270766,277,-2,2017-05-04
Deva Bikas Bank Limited,19,270,260,265,4404,1173080,275,-10,2017-05-07
Deva Bikas Bank Limited,21,270,260,265,4957,1310044,265,0,2017-05-08
Deva Bikas Bank Limited,15,270,265,269,1937,516802,265,4,2017-05-09
Deva Bikas Bank Limited,25,275,268,271,4361,1184350,269,2,2017-05-11
Deva Bikas Bank Limited,19,276,268,268,3571,978775,271,-3,2017-05-15
Deva Bikas Bank Limited,24,266,260,262,4629,1217324,268,-6,2017-05-16
Deva Bikas Bank Limited,38,268,257,261,3615,954721,262,-1,2017-05-17
Deva Bikas Bank Limited,19,275,256,275,6055,1603258,261,14,2017-05-18
Deva Bikas Bank Limited,41,275,267,269,8926,2418610,275,-6,2017-05-21
Deva Bikas Bank Limited,32,274,265,274,9721,2609266,269,5,2017-05-22
Deva Bikas Bank Limited,31,276,267,270,4993,1349123,274,-4,2017-05-23
Deva Bikas Bank Limited,8,275,266,275,3207,866158,270,5,2017-05-24
Deva Bikas Bank Limited,17,275,267,272,3570,964760,275,-3,2017-05-28
Deva Bikas Bank Limited,37,277,265,269,5393,1446861,272,-3,2017-05-30
Deva Bikas Bank Limited,15,275,263,270,1946,520039,269,1,2017-05-31
Deva Bikas Bank Limited,17,272,261,264,2918,775478,270,-6,2017-06-01
Deva Bikas Bank Limited,21,262,256,262,9093,2352811,264,-2,2017-06-04
Deva Bikas Bank Limited,12,277,262,272,1911,507655,262,10,2017-06-05
Deva Bikas Bank Limited,43,279,265,277,12658,3447191,272,5,2017-06-06
Deva Bikas Bank Limited,39,281,267,267,11162,3032308,277,-10,2017-06-07
Deva Bikas Bank Limited,16,273,262,270,4275,1148000,267,3,2017-06-08
Deva Bikas Bank Limited,47,280,265,267,18328,4945319,270,-3,2017-06-11
Deva Bikas Bank Limited,25,268,259,261,4177,1104097,267,-6,2017-06-12
Deva Bikas Bank Limited,16,270,261,264,3432,911607,261,3,2017-06-13
Deva Bikas Bank Limited,13,269,262,265,2245,591886,264,1,2017-06-14
Deva Bikas Bank Limited,19,270,262,262,5035,1342425,273,-11,2017-06-18
Deva Bikas Bank Limited,41,264,258,259,6665,1731146,262,-3,2017-06-19
Deva Bikas Bank Limited,19,260,250,255,9695,2487865,259,-4,2017-06-20
Deva Bikas Bank Limited,20,261,258,261,4306,1118300,258,3,2017-06-22
Deva Bikas Bank Limited,38,275,270,275,7497,2038769,274,1,2017-06-27
Deva Bikas Bank Limited,46,279,270,272,10572,2898569,275,-3,2017-06-28
Deva Bikas Bank Limited,31,267,259,260,5773,1511511,272,-12,2017-07-02
Deva Bikas Bank Limited,21,265,258,260,6475,1689662,260,0,2017-07-03
Deva Bikas Bank Limited,18,267,258,258,2287,595741,260,-2,2017-07-04
Deva Bikas Bank Limited,12,265,254,265,3563,918654,258,7,2017-07-05
Deva Bikas Bank Limited,24,270,260,264,4242,1113630,265,-1,2017-07-06
Deva Bikas Bank Limited,39,272,261,261,8642,2297712,264,-3,2017-07-09
Deva Bikas Bank Limited,41,269,262,262,22376,5898892,268,-6,2017-07-12
Deva Bikas Bank Limited,59,271,257,259,13386,3503137,262,-3,2017-07-13
Deva Bikas Bank Limited,34,266,255,266,6856,1779813,259,7,2017-07-16
Deva Bikas Bank Limited,13,261,259,261,2766,719364,262,-1,2017-08-21
Deva Bikas Bank Limited,3,258,257,258,1300,335200,263,-5,2017-10-03
Deva Bikas Bank Limited,18,263,257,259,6497,1696931,262,-3,2017-10-22
Deva Bikas Bank Limited,28,181,178,180,7894,1415860,181,-1,2018-02-05
Deva Bikas Bank Limited,29,180,177,177,3221,574031,181,-4,2018-02-25
Deva Bikas Bank Limited,56,183,178,180,11380,2052886,183,-3,2018-02-21
Deva Bikas Bank Limited,76,184,178,181,16723,3047180,180,1,2018-02-22
Deva Bikas Bank Limited,52,149,138,141,10498,1495000,149,-8,2018-03-04
Deva Bikas Bank Limited,14,144,140,144,918,129754,142,2,2018-03-14
Deva Bikas Bank Limited,12,145,143,144,2010,289930,144,0,2018-03-15
Deva Bikas Bank Limited,28,145,140,140,8040,1140830,144,-4,2018-03-18
Deva Bikas Bank Limited,16,140,138,140,3741,520349,140,0,2018-03-20
Dibyashwori Hydropower Ltd.,1,348,348,348,11,3828,0,348,2017-02-13
Dibyashwori Hydropower Ltd.,6,342,314,314,62,20282,348,-34,2017-02-14
Dibyashwori Hydropower Ltd.,10,308,283,283,101,29263,314,-31,2017-02-15
Dibyashwori Hydropower Ltd.,31,278,255,255,324,86501,283,-28,2017-02-16
Dibyashwori Hydropower Ltd.,77,250,230,230,823,190875,255,-25,2017-02-19
Dibyashwori Hydropower Ltd.,35,234,225,230,359,82871,230,0,2017-02-20
Dibyashwori Hydropower Ltd.,40,238,231,232,421,98614,230,2,2017-02-21
Dibyashwori Hydropower Ltd.,55,233,224,228,567,129804,232,-4,2017-02-22
Dibyashwori Hydropower Ltd.,51,237,228,232,523,122182,228,4,2017-02-23
Dibyashwori Hydropower Ltd.,16,235,233,233,174,40848,232,1,2017-02-26
Dibyashwori Hydropower Ltd.,26,237,235,235,273,64384,233,2,2017-02-28
Dibyashwori Hydropower Ltd.,25,234,229,230,267,62183,235,-5,2017-03-01
Dibyashwori Hydropower Ltd.,48,230,226,230,512,116396,230,0,2017-03-02
Dibyashwori Hydropower Ltd.,7,236,232,233,95,22274,230,3,2017-03-05
Dibyashwori Hydropower Ltd.,12,265,244,245,951,238900,250,-5,2017-03-21
Dibyashwori Hydropower Ltd.,17,243,234,235,194,46044,233,2,2017-03-06
Dibyashwori Hydropower Ltd.,14,236,231,234,147,34340,235,-1,2017-03-07
Dibyashwori Hydropower Ltd.,43,235,226,235,460,105392,234,1,2017-03-09
Dibyashwori Hydropower Ltd.,10,239,236,239,108,25581,235,4,2017-03-13
Dibyashwori Hydropower Ltd.,6,239,235,239,62,14634,239,0,2017-03-14
Dibyashwori Hydropower Ltd.,7,239,234,239,161,38280,239,0,2017-03-15
Dibyashwori Hydropower Ltd.,9,255,246,246,1084,267094,246,0,2017-03-19
Dibyashwori Hydropower Ltd.,3,250,249,250,30,7490,246,4,2017-03-20
Dibyashwori Hydropower Ltd.,3,241,241,241,200,48200,245,-4,2017-03-22
Dibyashwori Hydropower Ltd.,16,237,229,234,1064,246161,241,-7,2017-03-23
Dibyashwori Hydropower Ltd.,22,242,234,238,1426,339113,234,4,2017-03-26
Dibyashwori Hydropower Ltd.,18,249,242,249,2809,687631,238,11,2017-03-28
Dibyashwori Hydropower Ltd.,21,254,247,247,855,214749,249,-2,2017-03-29
Dibyashwori Hydropower Ltd.,13,245,241,242,150,36590,247,-5,2017-03-30
Dibyashwori Hydropower Ltd.,1,240,240,240,10,2400,242,-2,2017-04-02
Dibyashwori Hydropower Ltd.,3,244,240,240,30,7280,240,0,2017-04-03
Dibyashwori Hydropower Ltd.,25,240,230,235,271,63777,240,-5,2017-04-04
Dibyashwori Hydropower Ltd.,10,235,230,230,105,24293,235,-5,2017-04-06
Dibyashwori Hydropower Ltd.,13,236,231,235,353,82716,230,5,2017-04-09
Dibyashwori Hydropower Ltd.,16,239,235,239,172,40636,235,4,2017-04-10
Dibyashwori Hydropower Ltd.,1,239,239,239,10,2390,239,0,2017-04-11
Dibyashwori Hydropower Ltd.,21,240,235,240,328,78213,239,1,2017-04-12
Dibyashwori Hydropower Ltd.,12,240,236,237,169,40201,240,-3,2017-04-16
Dibyashwori Hydropower Ltd.,16,248,237,244,583,141752,237,7,2017-04-18
Dibyashwori Hydropower Ltd.,8,240,240,240,86,20640,244,-4,2017-04-20
Dibyashwori Hydropower Ltd.,10,239,223,223,107,24581,240,-17,2017-04-24
Dibyashwori Hydropower Ltd.,26,230,223,230,569,129806,223,7,2017-04-25
Dibyashwori Hydropower Ltd.,17,234,228,234,266,61012,230,4,2017-04-26
Dibyashwori Hydropower Ltd.,14,235,230,231,270,62769,230,1,2017-04-30
Dibyashwori Hydropower Ltd.,11,227,221,227,116,26022,224,3,2017-05-03
Dibyashwori Hydropower Ltd.,21,225,217,221,218,48129,227,-6,2017-05-04
Dibyashwori Hydropower Ltd.,14,220,216,216,183,39701,221,-5,2017-05-07
Dibyashwori Hydropower Ltd.,16,220,214,220,1160,254780,216,4,2017-05-08
Dibyashwori Hydropower Ltd.,20,233,224,226,1493,345353,220,6,2017-05-09
Dibyashwori Hydropower Ltd.,66,248,227,248,1479,348101,226,22,2017-05-11
Dibyashwori Hydropower Ltd.,47,270,247,268,2306,586442,248,20,2017-05-15
Dibyashwori Hydropower Ltd.,38,271,250,250,746,196060,268,-18,2017-05-16
Dibyashwori Hydropower Ltd.,26,252,250,250,343,86087,250,0,2017-05-17
Dibyashwori Hydropower Ltd.,12,245,233,233,548,132539,250,-17,2017-05-18
Dibyashwori Hydropower Ltd.,13,229,224,229,136,30742,225,4,2017-05-23
Dibyashwori Hydropower Ltd.,11,229,225,225,105,23750,229,-4,2017-05-24
Dibyashwori Hydropower Ltd.,17,225,218,222,185,40958,229,-7,2017-05-30
Dibyashwori Hydropower Ltd.,11,224,220,224,115,25350,222,2,2017-05-31
Dibyashwori Hydropower Ltd.,13,224,220,222,136,30222,222,0,2017-06-04
Dibyashwori Hydropower Ltd.,5,225,222,225,53,11870,225,0,2017-06-06
Dibyashwori Hydropower Ltd.,43,231,224,225,949,215308,225,0,2017-06-07
Dibyashwori Hydropower Ltd.,25,225,223,223,272,60775,225,-2,2017-06-08
Dibyashwori Hydropower Ltd.,32,223,220,222,350,77693,223,-1,2017-06-11
Dibyashwori Hydropower Ltd.,20,221,213,218,210,45924,222,-4,2017-06-12
Dibyashwori Hydropower Ltd.,14,224,215,218,422,93404,217,1,2017-06-19
Dibyashwori Hydropower Ltd.,10,220,215,220,107,23261,218,2,2017-06-20
Dibyashwori Hydropower Ltd.,10,224,216,224,105,23024,220,4,2017-06-22
Dibyashwori Hydropower Ltd.,8,215,211,214,85,18129,215,-1,2017-06-28
Dibyashwori Hydropower Ltd.,9,214,210,210,93,19640,215,-5,2017-07-03
Dibyashwori Hydropower Ltd.,18,215,211,215,184,39034,210,5,2017-07-04
Dibyashwori Hydropower Ltd.,5,219,211,211,52,11246,215,-4,2017-07-05
Dibyashwori Hydropower Ltd.,22,210,204,207,235,48316,208,-1,2017-07-12
Dibyashwori Hydropower Ltd.,45,226,202,226,475,98467,207,19,2017-07-13
Dibyashwori Hydropower Ltd.,5,149,145,149,73,10749,147,2,2017-10-03
Dibyashwori Hydropower Ltd.,1,120,120,120,11,1320,121,-1,2018-03-14
Everest Bank Limited,47,2876,2800,2845,5674,16048381,2805,40,2016-06-07
Everest Bank Limited,151,3350,3140,3260,20966,67243065,3144,116,2016-06-23
Everest Bank Limited,45,2900,2790,2860,7116,20391675,2845,15,2016-06-08
Everest Bank Limited,52,2895,2830,2895,6427,18361199,2860,35,2016-06-09
Everest Bank Limited,272,3300,3090,3157,48112,152770041,3060,97,2016-06-13
Everest Bank Limited,55,3100,3075,3075,9532,29407535,3100,-25,2016-06-20
Everest Bank Limited,62,3100,3070,3100,8824,27261433,3075,25,2016-06-21
Everest Bank Limited,107,3183,3060,3144,26271,81685954,3100,44,2016-06-22
Everest Bank Limited,106,3404,3300,3300,16300,54735460,3410,-110,2016-06-30
Everest Bank Limited,105,3350,3300,3320,18147,60257434,3300,20,2016-07-03
Everest Bank Limited,90,3400,3300,3379,20483,68114084,3320,59,2016-07-04
Everest Bank Limited,77,3585,3430,3450,15435,53705568,3450,0,2016-07-26
Everest Bank Limited,77,3434,3390,3410,8326,28351441,3450,-40,2016-08-01
Everest Bank Limited,67,3409,3382,3383,9838,33378452,3410,-27,2016-08-02
Everest Bank Limited,39,3383,3310,3370,4866,16316143,3383,-13,2016-08-03
Everest Bank Limited,186,3345,3251,3251,26557,87477683,3300,-49,2016-08-07
Everest Bank Limited,75,3339,3125,3125,9279,29539827,3251,-126,2016-08-08
Everest Bank Limited,49,3350,3187,3250,12894,41739943,3125,125,2016-08-09
Everest Bank Limited,96,3315,3176,3225,14898,48350819,3250,-25,2016-08-10
Everest Bank Limited,71,3250,3206,3248,7389,23910437,3225,23,2016-08-11
Everest Bank Limited,77,3238,3126,3190,13860,44375238,3248,-58,2016-08-14
Everest Bank Limited,126,3180,3050,3098,18180,56208008,3190,-92,2016-08-15
Everest Bank Limited,40,3395,3319,3380,6118,20568925,3319,61,2016-08-31
Everest Bank Limited,88,3159,3052,3115,13220,41164364,3098,17,2016-08-16
Everest Bank Limited,41,3243,3177,3215,4167,13378788,3115,100,2016-08-17
Everest Bank Limited,49,3250,3195,3200,9996,32164473,3215,-15,2016-08-21
Everest Bank Limited,60,3175,3117,3135,6953,21789546,3200,-65,2016-08-22
Everest Bank Limited,65,3150,3081,3110,12313,38383145,3135,-25,2016-08-23
Everest Bank Limited,88,3300,3150,3240,9665,31235358,3110,130,2016-08-24
Everest Bank Limited,80,3380,3236,3298,14333,46791897,3240,58,2016-08-28
Everest Bank Limited,74,3325,3270,3290,9159,30106302,3298,-8,2016-08-29
Everest Bank Limited,84,3333,3300,3319,9259,30679427,3290,29,2016-08-30
Everest Bank Limited,101,3414,3375,3406,12798,43481469,3380,26,2016-09-01
Everest Bank Limited,167,3510,3430,3500,23527,82224429,3406,94,2016-09-04
Everest Bank Limited,179,3639,3500,3587,24630,87825074,3500,87,2016-09-05
Everest Bank Limited,213,3655,3500,3562,29535,106373378,3587,-25,2016-09-06
Everest Bank Limited,149,3540,3480,3500,20993,73556039,3562,-62,2016-09-07
Everest Bank Limited,128,3535,3480,3529,23972,83964184,3500,29,2016-09-08
Everest Bank Limited,97,3599,3500,3542,12588,44521689,3529,13,2016-09-11
Everest Bank Limited,72,3542,3500,3531,11721,41307499,3542,-11,2016-09-12
Everest Bank Limited,76,3540,3515,3516,10423,36735102,3531,-15,2016-09-14
Everest Bank Limited,74,3502,3462,3480,6427,22430519,3516,-36,2016-09-18
Everest Bank Limited,74,3510,3395,3400,8919,30662951,3480,-80,2016-09-20
Everest Bank Limited,63,3405,3348,3380,8355,28221986,3400,-20,2016-09-21
Everest Bank Limited,71,3400,3350,3360,10922,36838411,3380,-20,2016-09-22
Everest Bank Limited,216,3490,3350,3450,34094,116867683,3360,90,2016-09-25
Everest Bank Limited,371,3599,3460,3599,63817,227758243,3450,149,2016-09-26
Everest Bank Limited,259,3700,3542,3595,32067,115450844,3599,-4,2016-09-27
Everest Bank Limited,87,3601,3536,3551,8891,31621899,3595,-44,2016-09-28
Everest Bank Limited,76,3600,3530,3535,11942,42341057,3540,-5,2016-10-02
Everest Bank Limited,130,3610,3552,3585,18674,67133381,3535,50,2016-10-03
Everest Bank Limited,151,3640,3540,3640,26741,96264719,3585,55,2016-10-04
Everest Bank Limited,189,3750,3642,3750,28172,103940712,3640,110,2016-10-05
Everest Bank Limited,148,3824,3700,3721,17078,63852001,3750,-29,2016-10-06
Everest Bank Limited,45,3750,3650,3666,6479,23844453,3721,-55,2016-10-16
Everest Bank Limited,44,3700,3621,3649,6978,25383709,3666,-17,2016-10-17
Everest Bank Limited,63,3660,3600,3640,6897,24988221,3649,-9,2016-10-18
Everest Bank Limited,38,3650,3611,3629,4630,16805630,3640,-11,2016-10-19
Everest Bank Limited,129,3718,3630,3689,17133,63036700,3629,60,2016-10-20
Everest Bank Limited,118,3718,3666,3679,14551,53735841,3689,-10,2016-10-23
Everest Bank Limited,117,3680,3596,3601,21299,77128373,3679,-78,2016-10-24
Everest Bank Limited,93,3648,3546,3550,14256,50890489,3601,-51,2016-10-25
Everest Bank Limited,60,3600,3505,3556,10118,35780206,3550,6,2016-10-26
Everest Bank Limited,48,3600,3550,3573,5858,20926651,3556,17,2016-10-27
Everest Bank Limited,53,3665,3530,3665,9483,34271275,3573,92,2016-11-03
Everest Bank Limited,87,3698,3626,3650,12995,47616175,3665,-15,2016-11-07
Everest Bank Limited,54,3650,3562,3565,5245,18819169,3650,-85,2016-11-08
Everest Bank Limited,102,3595,3456,3550,10521,36825570,3565,-15,2016-11-09
Everest Bank Limited,80,3650,3500,3544,10249,36128354,3550,-6,2016-11-10
Everest Bank Limited,355,3665,3522,3650,56342,204343584,3544,106,2016-11-13
Everest Bank Limited,304,3797,3674,3690,33381,123533480,3650,40,2016-11-14
Everest Bank Limited,595,3900,3706,3795,102479,389501586,3706,89,2016-11-16
Everest Bank Limited,1294,3920,3622,3629,139771,517060689,3795,-166,2016-11-17
Everest Bank Limited,524,3630,3381,3510,53221,186596977,3629,-119,2016-11-20
Everest Bank Limited,304,3570,3470,3523,36457,128039620,3510,13,2016-11-21
Everest Bank Limited,306,3515,3400,3460,26354,91359323,3523,-63,2016-11-22
Everest Bank Limited,441,3470,3340,3340,52025,176075468,3460,-120,2016-11-23
Everest Bank Limited,384,3450,3230,3285,39182,129504345,3340,-55,2016-11-24
Everest Bank Limited,338,3350,3090,3155,35330,111240578,3285,-130,2016-11-27
Everest Bank Limited,392,3249,2985,3215,52678,160786069,3155,60,2016-11-28
Everest Bank Limited,399,3275,3050,3230,47939,153562330,3215,15,2016-11-29
Everest Bank Limited,436,3320,3215,3299,61472,201528438,3230,69,2016-11-30
Everest Bank Limited,296,3364,3270,3270,28521,93944021,3299,-29,2016-12-01
Everest Bank Limited,155,3300,3235,3235,13458,43779532,3275,-40,2016-12-05
Everest Bank Limited,127,3265,3220,3249,14036,45492374,3235,14,2016-12-06
Everest Bank Limited,129,3260,3238,3248,11330,36785532,3249,-1,2016-12-07
Everest Bank Limited,132,3260,3230,3249,11310,36695206,3248,1,2016-12-08
Everest Bank Limited,106,3260,3210,3212,9818,31723057,3249,-37,2016-12-11
Everest Bank Limited,302,3250,3161,3230,30050,95977582,3160,70,2016-12-14
Everest Bank Limited,308,3299,3220,3283,25459,83093914,3230,53,2016-12-15
Everest Bank Limited,466,3299,3280,3299,46640,153478643,3283,16,2016-12-18
Everest Bank Limited,559,3310,3266,3271,50053,164287807,3299,-28,2016-12-19
Everest Bank Limited,1170,3268,3182,3190,90630,291768925,3271,-81,2016-12-20
Everest Bank Limited,221,1840,1770,1800,21562,38865091,1876,-76,2016-12-21
Everest Bank Limited,173,1806,1692,1700,20191,35497487,1810,-110,2016-12-26
Everest Bank Limited,151,1699,1640,1655,14804,24573216,1700,-45,2016-12-27
Everest Bank Limited,150,1690,1645,1672,13808,23066508,1655,17,2016-12-28
Everest Bank Limited,132,1750,1685,1710,14961,25654166,1672,38,2016-12-29
Everest Bank Limited,144,1820,1740,1805,15605,28040992,1710,95,2017-01-01
Everest Bank Limited,195,1849,1807,1849,16816,30864653,1805,44,2017-01-02
Everest Bank Limited,145,1850,1800,1825,15101,27704983,1849,-24,2017-01-03
Everest Bank Limited,120,1820,1800,1800,10676,19256910,1825,-25,2017-01-04
Everest Bank Limited,97,1840,1810,1825,8780,16030048,1800,25,2017-01-05
Everest Bank Limited,82,1835,1820,1835,8118,14843375,1825,10,2017-01-08
Everest Bank Limited,50,1860,1830,1850,4900,9050807,1835,15,2017-01-09
Everest Bank Limited,125,1957,1925,1925,12013,23326292,1919,6,2017-01-11
Everest Bank Limited,86,1950,1925,1925,5513,10651749,1925,0,2017-01-12
Everest Bank Limited,39,1939,1920,1939,3244,6272694,1925,14,2017-01-15
Everest Bank Limited,38,1944,1915,1915,3338,6442249,1939,-24,2017-01-16
Everest Bank Limited,60,1905,1887,1900,3601,6834295,1915,-15,2017-01-17
Everest Bank Limited,25,1900,1880,1896,1478,2804182,1900,-4,2017-01-18
Everest Bank Limited,53,1910,1891,1894,4481,8501150,1896,-2,2017-01-19
Everest Bank Limited,30,1900,1880,1900,2075,3916345,1894,6,2017-01-22
Everest Bank Limited,37,1900,1870,1885,4996,9390941,1900,-15,2017-01-23
Everest Bank Limited,130,1780,1695,1740,9888,17134520,1780,-40,2017-01-26
Everest Bank Limited,129,1730,1651,1685,9403,15713957,1740,-55,2017-01-30
Everest Bank Limited,88,1780,1661,1715,6676,11419094,1685,30,2017-01-31
Everest Bank Limited,91,1800,1749,1770,7105,12630254,1715,55,2017-02-01
Everest Bank Limited,73,1820,1760,1763,7053,12551045,1770,-7,2017-02-02
Everest Bank Limited,28,1763,1700,1750,1854,3225376,1763,-13,2017-02-05
Everest Bank Limited,47,1765,1745,1745,3036,5325039,1750,-5,2017-02-06
Everest Bank Limited,63,1750,1725,1725,7305,12674130,1745,-20,2017-02-07
Everest Bank Limited,125,1730,1686,1698,11861,20153194,1725,-27,2017-02-08
Everest Bank Limited,110,1699,1665,1665,9545,16032775,1698,-33,2017-02-09
Everest Bank Limited,117,1660,1600,1615,8855,14425357,1665,-50,2017-02-12
Everest Bank Limited,114,1650,1566,1641,8331,13297859,1615,26,2017-02-13
Everest Bank Limited,82,1670,1610,1655,6617,10862226,1641,14,2017-02-14
Everest Bank Limited,82,1750,1706,1745,6419,11137046,1726,19,2017-02-19
Everest Bank Limited,97,1805,1740,1763,8380,14821760,1745,18,2017-02-20
Everest Bank Limited,87,1820,1735,1740,5584,9886059,1763,-23,2017-02-21
Everest Bank Limited,36,1765,1706,1719,2555,4424540,1740,-21,2017-02-22
Everest Bank Limited,65,1730,1696,1710,6117,10410768,1710,0,2017-02-26
Everest Bank Limited,73,1700,1680,1681,6173,10413125,1710,-29,2017-02-28
Everest Bank Limited,40,1746,1700,1700,3305,5639818,1681,19,2017-03-01
Everest Bank Limited,42,1720,1700,1714,3316,5663977,1700,14,2017-03-02
Everest Bank Limited,40,1751,1725,1740,3347,5843943,1714,26,2017-03-05
Everest Bank Limited,77,1809,1750,1800,7666,13630403,1758,42,2017-03-21
Everest Bank Limited,47,1730,1709,1727,2926,5035855,1742,-15,2017-03-07
Everest Bank Limited,36,1735,1730,1730,2681,4642662,1727,3,2017-03-09
Everest Bank Limited,26,1740,1730,1740,2385,4132665,1730,10,2017-03-13
Everest Bank Limited,31,1740,1715,1716,3337,5759263,1740,-24,2017-03-14
Everest Bank Limited,48,1730,1700,1723,3733,6402634,1716,7,2017-03-15
Everest Bank Limited,50,1730,1710,1723,5127,8805388,1715,8,2017-03-19
Everest Bank Limited,59,1760,1745,1758,5197,9108750,1723,35,2017-03-20
Everest Bank Limited,134,1890,1815,1835,12493,23159221,1800,35,2017-03-22
Everest Bank Limited,73,1850,1810,1850,8004,14683168,1835,15,2017-03-23
Everest Bank Limited,125,1892,1835,1876,17283,32342889,1850,26,2017-03-26
Everest Bank Limited,80,1989,1900,1989,9601,18534856,1876,113,2017-03-28
Everest Bank Limited,85,1999,1900,1945,9238,17869456,1960,-15,2017-03-30
Everest Bank Limited,67,2014,1950,2014,9308,18359013,1945,69,2017-04-02
Everest Bank Limited,153,2140,1990,2000,15591,32153501,2014,-14,2017-04-03
Everest Bank Limited,95,2010,1940,1994,13813,27270121,2000,-6,2017-04-04
Everest Bank Limited,176,2010,1975,2000,18388,36767327,1994,6,2017-04-06
Everest Bank Limited,141,2060,1990,2045,20148,40456249,2000,45,2017-04-09
Everest Bank Limited,116,2100,2030,2075,16618,34501765,2045,30,2017-04-10
Everest Bank Limited,131,2142,2085,2100,17207,36319161,2075,25,2017-04-11
Everest Bank Limited,86,2100,2000,2080,7507,15529578,2082,-2,2017-04-13
Everest Bank Limited,86,2100,2030,2049,6466,13255141,2080,-31,2017-04-16
Everest Bank Limited,145,1960,1853,1871,15995,30394218,1925,-54,2017-04-20
Everest Bank Limited,96,1950,1892,1910,13822,26519295,1871,39,2017-04-23
Everest Bank Limited,71,1948,1881,1890,5702,10822451,1910,-20,2017-04-24
Everest Bank Limited,39,1899,1848,1851,2862,5340102,1885,-34,2017-04-30
Everest Bank Limited,63,1826,1806,1812,4127,7490529,1820,-8,2017-05-08
Everest Bank Limited,28,1829,1810,1820,2569,4681530,1812,8,2017-05-09
Everest Bank Limited,79,1700,1650,1690,8459,14168195,1665,25,2017-05-31
Everest Bank Limited,98,1392,1365,1365,7852,10857812,1400,-35,2017-06-28
Everest Bank Limited Con. Pref.,4,1640,1608,1610,154,251516,1665,-55,2016-06-20
Everest Bank Limited Con. Pref.,1,1790,1790,1790,36,64440,1804,-14,2016-08-03
Everest Bank Limited Con. Pref.,7,1892,1754,1892,288,530592,1720,172,2016-08-11
Everest Bank Limited Con. Pref.,3,1892,1892,1892,600,1135200,1892,0,2016-08-14
Everest Bank Limited Con. Pref.,3,1928,1855,1928,95,179608,1892,36,2016-08-15
Everest Bank Limited Con. Pref.,3,1862,1794,1794,86,156156,1900,-106,2016-08-17
Everest Bank Limited Con. Pref.,1,1759,1759,1759,12,21108,1794,-35,2016-08-21
Everest Bank Limited Con. Pref.,5,1733,1724,1724,228,394638,1759,-35,2016-08-22
Everest Bank Limited Con. Pref.,4,1730,1700,1700,520,893300,1724,-24,2016-08-23
Everest Bank Limited Con. Pref.,4,1803,1705,1803,202,352644,1700,103,2016-08-24
Everest Bank Limited Con. Pref.,2,1839,1803,1803,323,589569,1803,0,2016-08-28
Everest Bank Limited Con. Pref.,1,1803,1803,1803,110,198330,1803,0,2016-08-29
Everest Bank Limited Con. Pref.,7,1927,1853,1853,568,1059560,1900,-47,2016-09-06
Everest Bank Limited Con. Pref.,2,1927,1890,1927,76,144232,1853,74,2016-09-08
Everest Bank Limited Con. Pref.,1,1900,1900,1900,50,95000,1927,-27,2016-09-11
Everest Bank Limited Con. Pref.,2,1900,1863,1863,260,491780,1900,-37,2016-09-20
Everest Bank Limited Con. Pref.,2,1826,1826,1826,116,211816,1863,-37,2016-09-21
Everest Bank Limited Con. Pref.,28,2008,1862,2008,2269,4454579,1826,182,2016-09-22
Everest Bank Limited Con. Pref.,6,1968,1850,1850,416,780681,2008,-158,2016-09-25
Everest Bank Limited Con. Pref.,10,1963,1815,1963,739,1392979,1850,113,2016-09-26
Everest Bank Limited Con. Pref.,17,1919,1845,1919,984,1843163,1921,-2,2016-09-28
Everest Bank Limited Con. Pref.,5,1695,1600,1600,368,597376,1728,-128,2016-10-02
Everest Bank Limited Con. Pref.,1,1568,1568,1568,100,156800,1600,-32,2016-10-03
Everest Bank Limited Con. Pref.,2,1567,1536,1536,50,77327,1598,-62,2017-04-06
Everest Insurance Co. Ltd.,7,2012,1862,1862,990,1880100,1935,-73,2016-08-08
Everest Insurance Co. Ltd.,5,2048,1899,2048,50,98700,1862,186,2016-08-09
Everest Insurance Co. Ltd.,15,2008,1890,1890,2590,5000890,2048,-158,2016-08-10
Everest Insurance Co. Ltd.,24,1850,1785,1800,5334,9637213,1880,-80,2016-08-14
Everest Insurance Co. Ltd.,14,1790,1729,1790,1831,3224718,1800,-10,2016-08-15
Everest Insurance Co. Ltd.,8,1850,1805,1805,1653,3028697,1825,-20,2016-08-21
Everest Insurance Co. Ltd.,12,1824,1745,1745,1070,1902610,1805,-60,2016-08-22
Everest Insurance Co. Ltd.,15,1770,1701,1701,1177,2018880,1745,-44,2016-08-23
Everest Insurance Co. Ltd.,28,2200,2145,2194,2725,5965355,2180,14,2016-09-12
Everest Insurance Co. Ltd.,12,2130,2070,2079,973,2031205,2150,-71,2016-09-18
Everest Insurance Co. Ltd.,10,2065,2000,2065,2160,4408100,2075,-10,2016-09-21
Everest Insurance Co. Ltd.,8,2020,1987,1996,986,1977483,2010,-14,2016-09-28
Everest Insurance Co. Ltd.,6,2008,1980,2005,903,1804760,1983,22,2016-10-02
Everest Insurance Co. Ltd.,11,2070,2025,2030,1570,3222320,2020,10,2016-10-04
Everest Insurance Co. Ltd.,4,2050,2035,2050,233,476905,2030,20,2016-10-05
Everest Insurance Co. Ltd.,2,2010,2010,2010,250,502500,2050,-40,2016-10-16
Everest Insurance Co. Ltd.,1,2000,2000,2000,20,40000,2010,-10,2016-10-17
Everest Insurance Co. Ltd.,11,2012,1963,2012,1471,2937580,2000,12,2016-10-18
Everest Insurance Co. Ltd.,10,2012,2000,2000,853,1710200,2012,-12,2016-10-19
Everest Insurance Co. Ltd.,9,2039,2010,2025,1268,2565590,2000,25,2016-10-20
Everest Insurance Co. Ltd.,9,2050,2015,2050,1057,2141780,2025,25,2016-10-23
Everest Insurance Co. Ltd.,10,2050,2016,2016,1206,2467133,2050,-34,2016-10-24
Everest Insurance Co. Ltd.,3,2037,2020,2030,330,669600,2016,14,2016-10-25
Everest Insurance Co. Ltd.,6,2040,2010,2035,966,1959910,2030,5,2016-10-26
Everest Insurance Co. Ltd.,3,2050,2035,2035,285,580950,2035,0,2016-10-27
Everest Insurance Co. Ltd.,1,2035,2035,2035,50,101750,2035,0,2016-11-03
Everest Insurance Co. Ltd.,3,2005,1965,1995,400,793000,2035,-40,2016-11-07
Everest Insurance Co. Ltd.,12,2028,1922,1922,1912,3753272,1970,-48,2016-11-09
Everest Insurance Co. Ltd.,12,1960,1901,1920,1598,3067902,1922,-2,2016-11-10
Everest Insurance Co. Ltd.,3,1940,1930,1939,501,969740,1920,19,2016-11-13
Everest Insurance Co. Ltd.,8,2002,1925,2002,1050,2030570,1939,63,2016-11-14
Everest Insurance Co. Ltd.,11,1940,1906,1910,957,1843842,1955,-45,2016-11-16
Everest Insurance Co. Ltd.,4,1945,1920,1925,73,140610,1910,15,2016-11-17
Everest Insurance Co. Ltd.,3,1812,1800,1812,110,198720,1777,35,2016-11-21
Everest Insurance Co. Ltd.,3,1802,1776,1802,310,550820,1812,-10,2016-11-22
Everest Insurance Co. Ltd.,23,1766,1650,1680,2140,3650600,1802,-122,2016-11-23
Everest Insurance Co. Ltd.,35,1560,1342,1560,3188,4495801,1491,69,2016-11-28
Everest Insurance Co. Ltd.,27,1736,1573,1736,2783,4553497,1605,131,2016-11-30
Everest Insurance Co. Ltd.,17,1600,1520,1550,1710,2646600,1545,5,2016-12-06
Everest Insurance Co. Ltd.,14,1530,1500,1530,2727,4117260,1511,19,2016-12-14
Everest Insurance Co. Ltd.,14,1745,1622,1654,1609,2681460,1715,-61,2016-12-19
Everest Insurance Co. Ltd.,14,1639,1547,1600,990,1571960,1610,-10,2016-12-21
Everest Insurance Co. Ltd.,17,1600,1538,1538,1410,2213030,1615,-77,2016-12-26
Everest Insurance Co. Ltd.,14,1519,1432,1500,2975,4467710,1490,10,2016-12-28
Everest Insurance Co. Ltd.,10,1648,1529,1648,693,1097720,1500,148,2016-12-29
Everest Insurance Co. Ltd.,7,1600,1523,1523,769,1214196,1580,-57,2017-01-03
Everest Insurance Co. Ltd.,2,1530,1500,1530,393,595500,1530,0,2017-01-08
Everest Insurance Co. Ltd.,12,1560,1550,1550,2020,3141750,1550,0,2017-01-12
Everest Insurance Co. Ltd.,11,1550,1519,1550,1558,2405562,1550,0,2017-01-15
Everest Insurance Co. Ltd.,5,1549,1519,1549,510,781290,1550,-1,2017-01-16
Everest Insurance Co. Ltd.,4,1544,1521,1521,420,639350,1549,-28,2017-01-17
Everest Insurance Co. Ltd.,5,1548,1525,1548,600,922900,1521,27,2017-01-18
Everest Insurance Co. Ltd.,4,1560,1550,1560,510,792500,1548,12,2017-01-19
Everest Insurance Co. Ltd.,7,1545,1501,1545,720,1100040,1560,-15,2017-01-23
Everest Insurance Co. Ltd.,11,1455,1426,1426,957,1383262,1453,-27,2017-01-26
Everest Insurance Co. Ltd.,6,1398,1292,1292,720,978160,1426,-134,2017-01-30
Everest Insurance Co. Ltd.,7,1404,1380,1380,570,789820,1377,3,2017-02-02
Everest Insurance Co. Ltd.,2,1375,1375,1375,200,275000,1380,-5,2017-02-05
Everest Insurance Co. Ltd.,1,1350,1350,1350,100,135000,1375,-25,2017-02-06
Everest Insurance Co. Ltd.,16,1323,1215,1215,768,953631,1350,-135,2017-02-09
Everest Insurance Co. Ltd.,2,1191,1168,1168,150,176350,1215,-47,2017-02-12
Everest Insurance Co. Ltd.,8,1314,1288,1288,970,1254980,1340,-52,2017-02-28
Everest Insurance Co. Ltd.,12,1335,1290,1335,2040,2655650,1288,47,2017-03-01
Everest Insurance Co. Ltd.,13,1390,1350,1370,1008,1383910,1356,14,2017-03-05
Everest Insurance Co. Ltd.,55,1715,1601,1689,5740,9514680,1683,6,2017-03-21
Everest Insurance Co. Ltd.,3,1387,1387,1387,210,291270,1360,27,2017-03-09
Everest Insurance Co. Ltd.,42,1530,1415,1530,3618,5326607,1391,139,2017-03-19
Everest Insurance Co. Ltd.,56,1683,1550,1683,5573,8998645,1530,153,2017-03-20
Everest Insurance Co. Ltd.,31,1722,1635,1636,3040,5094930,1689,-53,2017-03-22
Everest Insurance Co. Ltd.,32,1679,1571,1679,3260,5347368,1636,43,2017-03-23
Everest Insurance Co. Ltd.,79,1846,1675,1823,12293,21773050,1679,144,2017-03-26
Everest Insurance Co. Ltd.,70,1938,1800,1876,10104,18966451,1860,16,2017-03-30
Everest Insurance Co. Ltd.,6,2063,1913,2063,370,734970,1876,187,2017-04-02
Everest Insurance Co. Ltd.,93,2269,2104,2269,13376,29993019,2063,206,2017-04-03
Everest Insurance Co. Ltd.,37,2277,2188,2219,4131,9155942,2232,-13,2017-04-11
Everest Insurance Co. Ltd.,51,2220,2123,2185,5166,11288318,2166,19,2017-04-13
Everest Insurance Co. Ltd.,51,2340,2230,2250,4919,11139830,2215,35,2017-04-20
Excel Development Bank Ltd.,5,778,754,754,285,218603,784,-30,2016-08-15
Excel Development Bank Ltd.,4,741,737,737,2034,1505158,735,2,2016-09-12
Excel Development Bank Ltd.,6,720,720,720,723,520560,720,0,2016-10-06
Excel Development Bank Ltd.,2,710,710,710,526,373460,720,-10,2016-10-17
Excel Development Bank Ltd.,6,705,691,700,1426,999794,710,-10,2016-10-20
Excel Development Bank Ltd.,10,700,677,700,1257,876438,700,0,2016-10-23
Excel Development Bank Ltd.,5,695,693,695,518,359906,700,-5,2016-10-24
Excel Development Bank Ltd.,7,695,685,690,2754,1897760,695,-5,2016-10-25
Excel Development Bank Ltd.,6,685,680,680,3636,2485660,690,-10,2016-10-26
Excel Development Bank Ltd.,5,685,680,685,5300,3628400,680,5,2016-10-27
Excel Development Bank Ltd.,3,686,685,686,340,233220,685,1,2016-11-07
Excel Development Bank Ltd.,2,667,667,667,694,462898,680,-13,2016-11-09
Excel Development Bank Ltd.,5,680,665,665,339,226880,667,-2,2016-11-10
Excel Development Bank Ltd.,2,671,662,671,120,79620,675,-4,2016-11-16
Excel Development Bank Ltd.,3,661,660,660,269,177607,671,-11,2016-11-17
Excel Development Bank Ltd.,7,613,599,613,713,429333,612,1,2016-11-21
Excel Development Bank Ltd.,4,605,584,584,1787,1052765,613,-29,2016-11-22
Excel Development Bank Ltd.,10,518,498,518,2108,1066100,528,-10,2016-11-28
Excel Development Bank Ltd.,3,589,578,585,700,406400,580,5,2016-12-19
Excel Development Bank Ltd.,3,581,573,581,403,233743,570,11,2016-12-29
Excel Development Bank Ltd.,2,576,575,576,249,143185,565,11,2017-01-18
Excel Development Bank Ltd.,3,599,588,599,822,485600,584,15,2017-01-22
Excel Development Bank Ltd.,1,542,542,542,19,10298,541,1,2017-01-30
Excel Development Bank Ltd.,2,540,540,540,152,82080,539,1,2017-02-06
Excel Development Bank Ltd.,11,545,506,545,1602,848187,515,30,2017-03-21
Excel Development Bank Ltd.,5,522,515,515,1800,930200,520,-5,2017-03-20
Excel Development Bank Ltd.,19,644,600,644,3723,2312935,613,31,2017-04-02
Excel Development Bank Ltd.,12,669,643,643,2320,1520880,644,-1,2017-04-03
Excel Development Bank Ltd. Promoter Share,1,295,295,295,5000,1475000,301,-6,2017-01-30
First Micro Finance Development Bank Ltd.,2,1832,1797,1832,20,36290,1762,70,2016-08-09
First Micro Finance Development Bank Ltd.,67,1663,1550,1586,7459,11728493,1696,-110,2016-08-14
First Micro Finance Development Bank Ltd.,4,1503,1502,1503,1000,1502900,1474,29,2016-10-16
First Micro Finance Development Bank Ltd.,1,1510,1510,1510,800,1208000,1503,7,2016-10-17
First Micro Finance Development Bank Ltd.,17,1480,1392,1415,1560,2209910,1510,-95,2016-10-18
First Micro Finance Development Bank Ltd.,9,1410,1396,1400,1051,1473000,1415,-15,2016-10-19
First Micro Finance Development Bank Ltd.,3,1400,1390,1390,650,906500,1400,-10,2016-10-23
First Micro Finance Development Bank Ltd.,6,1372,1350,1358,820,1115710,1390,-32,2016-10-24
First Micro Finance Development Bank Ltd.,2,1389,1362,1362,1820,2525280,1370,-8,2016-11-07
First Micro Finance Development Bank Ltd.,8,1302,1275,1275,948,1224640,1322,-47,2016-11-10
First Micro Finance Development Bank Ltd.,4,1071,1050,1071,200,211580,1090,-19,2016-12-07
First Micro Finance Development Bank Ltd.,17,876,794,876,978,812998,810,66,2017-02-05
First Micro Finance Development Bank Ltd.,12,809,793,809,988,795984,809,0,2017-02-07
First Micro Finance Development Bank Ltd.,76,861,780,861,12682,10455021,783,78,2017-03-20
First Micro Finance Development Bank Ltd.,104,1492,1377,1492,18102,25772588,1380,112,2017-04-02
Garima Bikas Bank Limited,132,400,380,385,25427,9973581,396,-11,2016-11-23
Garima Bikas Bank Limited,157,390,370,375,25174,9601807,386,-11,2017-01-30
Garima Bikas Bank Limited,50,343,316,329,6519,2117663,337,-8,2017-02-05
Garima Bikas Bank Limited,19,324,315,317,3335,1065466,312,5,2017-02-07
Garima Bikas Bank Limited,76,465,440,465,23222,10521286,435,30,2017-04-02
Global IME Bank Limited,40,565,526,542,15077,8281583,516,26,2016-08-09
Global IME Bank Limited,55,515,504,512,27775,14128516,513,-1,2016-10-17
Global IME Bank Limited,80,515,504,515,24871,12637089,512,3,2016-10-18
Global IME Bank Limited,60,510,501,509,18541,9383513,510,-1,2016-10-23
Global IME Bank Limited,58,509,501,505,19073,9601456,509,-4,2016-10-24
Global IME Bank Limited,61,499,490,495,20951,10317509,495,0,2016-11-07
Global IME Bank Ltd. Promoter Share,1,261,261,261,1919,500859,261,0,2016-10-18
Global IME Laghubitta Bittiya Sanstha Ltd.,38,2458,2279,2458,563,1379434,2235,223,2016-10-24
Global IME Samunnat Scheme-1,2,11.85,11.75,11.75,6000,70600,12,-0.25,2016-10-24
Goodwill Finance Co. Ltd.,2,473,464,473,20,9370,455,18,2016-08-09
Grameen Bikas Laghubitta Bittiya Sanstha Ltd.,4,908,857,908,300,266450,841,67,2016-08-09
Guheshowori Merchant Bank Finance Co. Ltd.,3,424,408,424,2100,880800,400,24,2016-08-09
Gurans Life Insurance Company Ltd.,2,881,864,881,374,328236,848,33,2016-08-09
